Táto otázka môže byť konečne vyriešená vďaka jasnejším definíciám spánku a bdenia a citlivejším nástrojom na ich meranie.	Armed with a less black-and-white definition of sleep and wakefulness, and more sensitive tools for measuring them, that question might finally be resolved.	0.37218
V roku 1988 bol 23-ročný Kanaďan Kenneth Parks súdený za vraždu a pokus o vraždu svojich svokrovcov.	In 1988 a 23-year-old Canadian man named Kenneth Parks went on trial for the murder and attempted murder of his parents-in-law.	2.55216
Počas jednej noci minulého roka sadol do auta a prešiel cez mesto 23 kilometrov až k ich domu, kde ich napadol s nožom a montážnou pákou na pneumatiky.	One night in the previous year, he drove 23 kilometres across town to their home and attacked them with a tire iron and a knife.	1.74286
Bol úplne zbavený viny na základe tvrdenia, že v danom čase bol námesačný.	He was acquitted on all counts, on the grounds that he was sleepwalking at that time.	0.261905
Odvtedy sa mnohí obhajcovia odvolávajú na parasomniu – starší názov pre poruchy týkajúce sa čiastočného prebudenia počas spánku. ~~~ Tento termín je v súčasnosti využívaný zväčša v oblasti práva.	Since then, numerous defendants have pleaded parasomnias – an old- fashioned term for disorders involving partial arousal during sleep that is now mostly used in law.	0.0387688
Mark Pressman z Nemocnice Lankenau vo Wynnewood v Pennsylvánií odhaduje, že každoročne je tento dôvod použitý na obranu v piatich až desiatich prípadoch po celom svete.	Mark Pressman, at the Lankenau Hospital in Wynnewood, Pennsylvania, estimates that they are used as a defence in between five and ten cases worldwide each year.	0.504575
Zložitosť celej situácie ohľadom trestnej zodpovednosti týmto len narastá a je zdrojom neutíchajúcich sporov medzi právnikmi.	This raises tough issues about criminal responsibility and has been a source of ongoing dispute among lawyers.	0.425944
Jedna z najspornejších oblastí sa týka mužov obvinených zo sexuálneho napadnutia, ktorí sa odvolávajú na nevedomú sexuálnu aktivitu počas spánku, tzv. sexomniu (New Scientist, 28. október 2006, s. 40).	One of the most contentious areas concerns men charged with sexual assault who claim sleep-related sexual behaviour, or sexsomnia, as a defence (New Scientist, 28 October 2006, p 40).	0.665385
Sexomnia je kolísanie medzi námesačnosťou a vedomým stavom.	Sexsomnia is a variation on sleepwalking and a recognised condition.	0.593711
K rozporu dochádza vtedy, keď sa títo násilníci odvolávajú na požitie veľkého množstva alkoholu, ktoré vyvolalo sexomniu.	The controversy arises when these men claim – sometimes successfully that heavy alcohol consumption provoked their sexsomnia.	0.288679
V niektorých prípadoch s takýmito alibi na súde skutočne obstoja.		-0.3
Spolu s mojimi kolegami sme zásadne proti ospravedlňovaniu týchto činov, a to z toho dôvodu, že neexistuje žiaden vedecký dôkaz o tom, že ťažká intoxikácia vyvoláva námesačnosť, tvrdí Pressman.	My colleagues and I have been actively opposing this defence on the grounds there is no scientific evidence that severe intoxication causes sleepwalking, Pressman says.	0.256552
Zároveň pripúšťa, že táto oblasť práva je veľmi zložitá najmä preto, lebo nie je možné na základe výskumu objasniť, čo sa odohrávalo v hlave násilníka počas jednej noci v minulosti.	But he admits that it is a fiendishly difficult area of law, not least because no sleep study can shed light on what happened in a single individual's brain on a single night in the past.	0.3
Piloti komerčných letov a iní profesionáli, ktorých práca si vyžaduje vysokú ostražitosť, musia občas prejsť testom udržiavania bdelosti.	Every so often, commercial pilots and other professionals, whose jobs require them to be highly vigilant have to take something called the maintenance of wakefulness test.	0.235537
Musia sedieť v pohodlnom kresle s tlmeným osvetlením a zotrvať v bdelosti po dobu 40 minút. ~~~ Táto procedúra sa opakuje štyrikrát v priebehu ôsmich hodín.	They must sit in a comfy chair in a dimly lit room and stay awake for 40 minutes, a procedure that is repeated four times over the course of 8 hours.	0.0927044
Ak by zaspali, EEG by zachytil pohyb očí a uvoľnenie čeľuste.	If they should drop off, this is detected by EEG, eye movement and jaw slackness.	0.457692
Sú to však len čiastočné opatrenia a v každom prípade ľudia s takouto profesiou majú vysokú motiváciu nezaspať.	However, these are fairly crude measures and anyway people whose job is on the line tend to be highly motivated to stay awake.	0.426316
Odborníci na spánok pripúšťajú, že je potrebné vykonať citlivejší test a David Dinges z Pennsylvánskej univerzity vo Filadelfií tvrdí, že takýto test má.	Sleep scientists acknowledge that a more sensitive test is required, and David Dinges at the University of Pennsylvania, Philadelphia, believes he has one.	0.795455
Je ním jeho test časovej reakcie, v ktorom dotyčné osoby musia opakovane reagovať na blikanie svetla stláčaním tlačidla.	His is a test of reaction time in which subjects have to repeatedly press a button in response to a light going on.	0.42598
Dinges Tvrdí, že toto psychomotorické testovanie stavu bdelosti je neuveriteľne citlivé na zistenie nestability v rozoznávaní hraníc medzi bdením a spánkom.	This psychomotor vigilance test is unbelievably sensitive to instability in the boundaries between wakefulness and sleep, Dinges claims.	0.415395
Skrátená verzia bola v júli vyslaná do Medzinárodnej vesmírnej stanice ISS, kde ju astronauti mohli otestovať.	A shortened version went up to the International Space Station in July, so that the astronauts could put it through its paces.	0.26875
Ak sa potvrdí, že tento test dokáže presne odhaliť ich schopnosť vykonávať danú prácu, čoskoro môže byť aplikovaný na pilotov, pracovníkov jadrových elektrární a ostatných pracovníkov, ktorí majú v rukách osudy druhých ľudí.	If it accurately reflects their ability to do their job, it may soon be routinely applied to pilots, nuclear power station operators and others in life-or-death jobs.	0.189362
Bežný spôsob rozoznávania bdelého stavu od ortodoxného a paradoxného spánku je hľadanie charakteristických vzorcov mozgovej aktivity pomocou prístroja EEG, ktorý meria elektrickú aktivitu v niekoľkomilimetrovej vonkajšej vrstve kortexu.	The traditional way of distinguishing wakefulness from non-REM and REM sleep is to look for characteristic patterns of brain activity using an EEG, which measures electrical activity in the outer few millimetres from the cortex.	0.380371
Laura Spinneyová je švajčiarska spisovateľka z Lausanne. ~~~ Je prekvapivo ľahké stratiť počas mimotelového zážitku kontakt s vaším fyzickým bytím, hovorí Anil Ananthaswamy.	Laura Spinney is a writer in Lausanne, SwitzerlandIt's surprisingly easy for your sense of self to lose touch with your physical being in an out-of-body experience, says Anil Ananthaswamy.	0.177566
Muž sa zobudil a cítil sa slabo.	The young man woke feeling dizzy.	0.277778
Keď vstal a otočil sa, videl svoje telo ležať na posteli.	He got up and turned around, only to see himself still lying in bed.	0.25
Zakričal na svoje spiace telo, zatriasol ním a skočil naňho.	He shouted at his sleeping body, shook it, and jumped on it.	0.288
Neskôr cítil, že opäť leží v posteli, no teraz videl seba ako stojí pri posteli a trasie svojím telom.	The next thing he knew he was lying down again, but now seeing himself standing by the bed and shaking his sleeping body.	0.247059
Šokovaný vyskočil z okna.	Stricken with fear, he jumped out of the window.	0.0652174
Jeho izba bola na treťom poschodí.	His room was on the third floor.	0.266667
Neskôr ho našli ťažko zraneného.	He was found later, badly injured.	0.289655
To, čo prežil tento 21-ročný mladík bol mimotelový zážitok, jeden z najzvláštnejších stavov vedomia.	What this 21-year-old had just experienced was an out-of-body experience, one of the most peculiar states of consciousness.	0.235227
Spúšťačom bola zrejme jeho epilepsia (Journal of Neurology, Neurosurgery and Psychiatry, roč. 57, s. 838).	It was probably triggered by his epilepsy (Journal of Neurology, Neurosurgery and Psychaitry, vol 57, p 838).	1.60927
Nechcel spáchať samovraždu, hovorí neuropsychológ Peter Brugger zo švajčiarskej univerzitnej nemocnice v Zürichu.	He didn't want to commit suicide, says Peter Brugger, the young man's neuropsychologist at University Hospital Zurich in Switzerland.	0.473109
Vyskočil preto, aby našiel spojku medzi jeho telom a svojím ja.	He jumped to find a match between body and self.	0.467727
Zrejme konal skratovo.	He must have been having a seizure.	0.171429
V priebehu 15 rokov po uplynutí tohto dramatického incidentu Brugger spolu s ostatnými prešli dlhú cestu cestu k pochopeniu mimotelových zážitkov.	In the 15 years since that dramatic incident, Brugger and others have come a long way towards understanding out-of-body experiences.	1.98008
Presnejšie určili príčiny nesprávneho fungovania špecifickej oblasti mozgu a teraz riešia otázku, ako môžu tieto poruchy viesť k takmer nadprirodzeným zážitkom, kedy opustíme vlastné telo a sledujeme ho zvonka.	They have narrowed down the cause to malfunctions in a specific brain area and are now working out how these lead to the almost supernatural experience of leaving your own body and observing it from afar.	0.377059
Tiež využívajú mimotelové zážitky v súvislosti s riešením dlhodobého problému: ako dokážeme vytvoriť a udržať si zmysel pre svoje vlastné ja.	They are also using out-of-body experiences to tackle a long- standing problem: how we create and maintain a sense of self.	0.384441
Celú situáciu zdramatizovali aj autori ako Dostojevský, Wilde, de Maupassant and Poe, z ktorých niektorí písali o mimotelových zážitkoch z vlastnej skúsenosti ako o zážitkoch väčšinou spojených s epilepsiou, migrénou, mŕtvicou, nádorom v mozgu, užívaním drog alebo dokonca zážitkom blízko smrti.	Dramatised to great effect by such authors as Dostoevsky, Wilde, de Maupassant and Poe – some of whom wrote first-hand-knowledge – out-of-body experiences are usually associated with epilepsy, migraines, strokes, brain tumours, drug use and even near-death experiences.	0.578079
Zároveň je však bežné, že mimotelový zážitok môžu mať aj ľudia bez akýchkoľvek zreteľných neurologických porúch.	It is clear, though, that people with no obvious neurological disorders can have an out-of-body experience.	0.283871
Takýto stav zažije počas svojho života odhadom asi 5 % zdravých ľudí.	By some estimates, about 5 percent of healthy people have one at some point in their lives.	2.75202
Ako presne môžeme definovať mimotelový stav?	So what exactly is an out-of-body experience?	0.3
Nedávna definícia odhalila, že daný stav zahŕňa niekoľko nezvyčajných skúseností.	A definition has recently emerged that involves a set of increasingly bizarre perceptions.	0.275342
Najmenej závažná z nich je doppelgänger (dvojník): cítite prítomnosť osoby, alebo vidíte osobu, o ktorej viete, že ste to vy, hoci vy ste stále vo svojom tele.	The least severe of these is a doppelgänger experience: your sense the presence of or see a person you know to be yourself, though you remain rooted in your own body.	0.507569
Tento stav často prechádza do ďalšieho štádia, kedy váš zmysel pre vaše vlastné ja putuje medzi vaším skutočným telom a vaším dvojníkom.	This often progresses to stage 2, where your sense of self moves back and forth between your real body and your doppelgänger.	0.268571
Presne to sa prihodilo Bruggerovmu mladému pacientovi.	This was what Brugger's young patient experienced.	0.273333
Nakoniec vaše druhé ja celkom opúšťa vaše telo a sleduje ho zvonka, často z vyvýšenej polohy, akou je napríklad strop.	Finally, your self leaves your body altogether and observes it from outside, often an elevated position such as the ceiling.	0.282
Takéto odlúčenie je najzvláštnejší prejav mimotelového zážitku, hovorí Olaf Blanke, neurológ zo Švajčiarskeho federálneho technologického inštitútu v Lausanne.	This split is the most striking feature of an out- of-body experience, says Olaf Blanke, a neurologist at the Swiss Federal Institute of Technology in Lausanne.	0.758243
Prekvapivo príjemné	Surprisingly pleasant	0.268421
Niektoré mimotelové zážitky zahŕňajú len jedno z týchto štádií, iné všetky tri postupne.	Some out-of-body experiences involve just one of these stages: some all three, in progression.	0.280519
Je zvláštne, že mnohí ľudia tieto zážitky opísali ako príjemné.	Bizarrely, many people who have one report it as a pleasant experience.	0.267273
Čo sa teda mohlo diať v mozgu, ktorý vytvoril tak zdanlivo nemožný vnem?	So what could be going on in the brain to create such a seemingly impossible sensation?	0.240984
Prvá hmatateľná stopa sa objavila v roku 2002, kedy Blankov výskumný tím náhodne prišiel na to, ako privodiť úplný mimotelový zážitok.	The first substantial clues came in 2002, when Blankes team stumbled across a way to induce a full-blown out-of-body experience.	0.429221
Práve vykonávali operáciu mozgu 43-ročnej ženy s vážnou epilepsiou, aby určili, ktorú časť jej mozgu musia za účelom liečby odstrániť.	They were performing exploratory brain surgery on a 43-year-old woman with severe epilepsy to determine which part of her brain to remove in order to cure her.	0.253448
Po stimulácií tzv. temporoparietálneho spojenia v oblasti pri temene hlavy žena oznámila, že sa vznášala nad jej vlastným telom a pozerala sa naň.	When they stimulated a region near the back of the brain called the temporoparietal junction (TPJ), the woman reported that she was floating above from her own body and looking down on herself.	0.3362
Táto situácia má neurologický význam.	This makes some kind of neurological sense.	0.264706
Temporoparietálne spojenie spracováva zrakové a hmatové signály, rovnováhu a priestorové informácie z vnútorného ucha a proprioceptívne vnemy z kĺbov, šliach a svalov, vďaka ktorým vieme rozlíšiť vzájomnú polohu jednotlivých častí nášho tela.	The TPJ processes visual and touch signals, balance and spatial information from the inner ear, and the proprioceptive sensations from joints, tendons and muscles that tell us where our body parts are in relation to one another.	0.270466
Jeho úlohou je spojiť tieto informácie, aby vytvorili pocit sebauvedomenia: zmysel pre vnímanie polohy svojho tela, schopnosť odlíšiť ho od okolia a rozlíšiť, kde sa končí a kde začína zvyšok sveta.	Its job is to meld these together to create a feeling of embodiment: a sense of where your body is, and where it ends and the rest of the world begins.	0.371926
Blanke a jeho kolegovia predpokladali, že mimotelový stav nastáva vtedy, keď z akéhosi dôvodu temporoparietálne spojenie zlyhá a prestane správne fungovať (Nature, roč. 419, s. 269).	Blanke and colleagues hypothesised that out-of-body experiences arise when, for whatever reason, the TPJ fails to do this properly (Nature, vol 419, p 269).	0.726269
Neskôr väčšie množstvo dôkazov ukázalo, že nesprávne fungovanie temporoparietálneho spojenia tvorí gro mimotelového stavu.	More evidence later emerged that a malfunctioning TPJ was at the heart of the out- of-body experience.	0.22069
V roku 2007 sa napríklad Dirk De Ridder z belgickej Univerzitnej nemocnice v Antwerpách snažil pomôcť 63-ročnému mužovi s ťažkou formou tinitu.	In 2007, for example, Dirk De Ridder of University Hospital Antwerp in Belgium was trying to help a 63-year-old man with intractable tinnitus.	0.686346
Tento pocit trval viac než 15 sekúnd, čo je dostatočne dlho na zachytenie PET snímky jeho mozgu.	The feeling would last more than 15 seconds, long enough to carry out PET scans of his brain.	2.28442
Tím samozrejme zistil, že temporoparietálne spojenie bolo počas tejto skúsenosti aktivované.	Sure enough, the team found that TPJ was activated during the experiences.	0.210938
Poznatky o neurologických poruchách či operáciách sú síce široké, avšak nemožno ich brať relevantne, keďže takéto prípady sú ojedinelé.	Insights from neurological disorders or brain surgery can only take you so far, however, not least because cases are rare.	0.259615
Požiadavka rozsiahlejších štúdií viedla Blanka a jeho tím používať techniku zvanú úlohy transformácie vlastného tela, aby prinútili mozog pracovať tak, ako počas mimotelového stavu.	Larger-scale studies are required, and to achieve this Blanke and others have used a technique called own-body transformation tasks to force the brain to do things that is seemingly does during an out-of-body experience.	0.365283
V týchto experimentoch sú účastníkom zobrazované záblesky postavičiek s rukavicou na jednej ruke.	In these experiments, subjects are shown a sequence of brief glimpses of cartoon figures wearing a glove on one hand.	0.254651
Niektoré z týchto postavičiek sú otočené k účastníkovi tvárou, iné chrbtom (všimnite si diagram nižšie).	Some of the figures face the subject, others have their back turned (see diagram, below).	0.240789
Úlohou je predstaviť si seba v pozícií kreslenej postavičky a cvičiť s tou rukou, na ktorej je rukavica.	The task is to imagine yourself in the position of the cartoon figure in order to work out with hand the glove is on.	0.276136
Môže sa vám stať, že sa v mysli otáčate spolu so striedajúcimi sa postavičkami.	To do this, you may have to mentally rotate you own body as one image succeeds another.	0.277612
Počas vykonávania týchto úloh výskumníci mapovali u dobrovoľníkov mozgovú aktivitu s EEG prístrojom a zistili, že temporoparietálne spojenie sa aktivovalo vtedy, keď si dobrovoľníci predstavili samých seba v mimotelovej pozícií, a teda pozícií inej, než sa v danej chvíli nachádzali.	As volunteers performed these tasks, the researches mapped their brain activity with an EEG and found that the TPJ was activated when the volunteers imagined themselves in a position different from their actual orientation – an out-of- body position.	0.40493
Tím tiež aktivoval temporoparietálne spojenie pomocou transkraniálnej magnetickej stimulácie, neinvazívnej techniky, ktorá dočasne vyradí z funkcie niektoré časti mozgu.	The team also zapped the TPJ with transcranial magnetic stimulation, a non- invasive technique that can temporarily disable parts of the brain.	0.229268
Dobrovoľníkom s porušeným temporoparietálnym spojením trvalo omnoho dlhšie vykonávať úlohy transformácie vlastného tela (The Journal of Neuroscience, roč. 25, s. 550).	With a disrupted TPJ, volunteers took significantly longer to do the own-body transformation task (The Journal of Neuroscience, vol 25, p 550).	1.05721
Ostatné časti v mozgu, vrátane častí blízko temporoparietálneho spojenia, tiež preukazujú aktivitu.	Other brain regions have been implicated too, including ones close to the TPJ.	0.201493
Všeobecná zhoda nastáva vtedy, keď tieto oblasti fungujú správne a cítime sa ako vo svojom tele.	The emerging consensus is that when these regions are working well, we feel at one with our body.	0.296296
No akonáhle sa porušia, náš cit pre vnímanie vlastného tela sa vytráca.	But disrupt them, and our sense of embodiment can float away.	0.248077
To však nevysvetľuje zvláštnu záhadu mimotelového zážitku.	This does not, however, explain the most striking feature of out-of-body experiences.	0.175472
Je veľkou hádankou, prečo si ľudia v mimotelovej pozícií predstavujú nielen ich vlastné telo, ale aj veci okolo nich, ako napríklad druhých ľudí, hovorí Brugger.	It's a great puzzle why people, from their out-of-body locations, visualise not only their bodies but things around them, such as other people, says Brugger.	0.406429
Odkiaľ pochádza táto informácia?	Where does this information come from?	0.26
Jedna skupina dôkazov súvisí s tzv. spánkovou paralýzou, kedy sa zdravý človek nemôže hýbať, akoby práve spal, a to aj napriek tomu, že nespí (Pozri Zóna šera).	One line of evidence comes from the condition known as sleep paralysis, in which healthy people find their body immobilised as in sleep despite being conscious (See The twilight zone).	0.253333
Allan Cheyne z kanadskej Univerzity of Waterloo v Ontáriu počas prieskumu na vzorke takmer 12 000 ľudí so spánkovou paralýzou zistil, že mnohí z nich nahlásili dojmy podobné mimotelovým zážitkom.	In a survey of nearly 12, 000 people who had experienced sleep paralysis, Allan Cheyne of the University of Waterloo in Ontario, Canada, found that many reported sensations similar to out-of-body experiences.	0.76411
Medzi nimi boli javy ako vznášanie sa nad vlastným telom, sledovanie ho a otáčanie sa za ním.	These included floating of of their body and turning back to look at it.	0.21
Cheyne tvrdí, že príčinou môže byť rozpor medzi informáciami v mozgu.	Cheyne suggests that this might be the result of conflicts of information in the brain.	0.48
Počas spánkovej paralýzy je možné dosiahnuť stav podobný REM spánku, kedy sa v snoch hýbete alebo lietate.	During sleep paralysis, it is possible to enter a REM-like state in which you dream of moving or flying.	0.286207
Za týchto okolností vnímate pohyb, no mozog si uvedomuje, že vaše telo sa nemôže hýbať.	Under these circumstances you are conscious of a sensation of movement, yet your brain is aware that your body cannot move.	0.178378
Mozog v snahe vyriešiť tento spor medzi zmyslami pozastaví cit pre vnímanie nášho vlastného ja (Cortex, roč. 45, s. 201).	In an attempt to resolve this sensory conflict, the brain cuts the sense of self loose (Cortex, vol 45, p 201).	0.692702
Mozog to rieši tak, že rozdelí naše ja od tela.	It resolvess by splitting the self from its body, says Cheyne.	0.192308
Zdá sa, že naše ja ide s pohybom, zatiaľ čo telo zostáva v úzadí, hovorí Cheyne.	The self seems to go with the movement and the body gets left behind.	0.252632
Možno sú podobné zmyslové rozpory príčinou klasického mimotelového zážitku.	Perhaps similar sensory conflicts cause classic out-of-body experiences.	0.290909
Medzitým Brugger na základe tvrdení jedného z jeho pacientov, ktorý zažil mimotelový stav, upozorňuje na fakt, že niekto dokáže vidieť veci aj vtedy, keď má zavreté oči.	Brugger, meanwhile, has a suggestion for how someone might see things even though their eyes are shut, based on one of his patients who reported an out-of-body experience.	0.297917
Pacientov otec, ktorý sedel pri jeho posteli, tvrdí, že chlapec mal zavreté oči.	According to this patient's father, who was sitting by the bedside, he had his eyes closed.	0.265217
Mladík neskôr povedal, že videl z perspektívy nad posteľou, ako ide otec do kúpeľne, vracia sa s vlhkým uterákom a utiera mu čelo.	Yet he later reported seeing, from a perspective above his bed, his father going to the bathroom, returning with a wet towel and towelling his forehead.	0.372706
Pacient zrejme počul svojho otca odkráčať do kúpeľne, kde púšťal vodu a musel cítiť na hlave vlhký uterák.	The patient presumably heard his father walk to the bathroom and run some water, and must have felt the wet towel on his head.	0.253333
Nie je jasné, ako to mozog vytvára, hovorí kognitívny filozof Thomas Metzinger z nemeckej Univerzity Johannesa Gutenberga v Mainze.	Its not clear how the brain constructs that, says cognitive philosopher Thomas Metzinger of the Johannes Gutenberg University in Mainz, Germany.	0.571053
Metzinger uvádza teóriu.	Metzinger does have a suggestion.	0.958696
Spomeňte si na nejaký zážitok z nedávnej dovolenky.	Imagine an episode from a recent holiday.	0.225
Predstavujete si ju z pohľadu prvej osoby alebo z pohľadu tretej osoby s vami na scéne?	Do you visualise it from a first-person perspective, or from a third-person perspective with yourself in the scene?	0.193151
Pre väčšinu z nás prekvapivo platí druhá možnosť.	Surprisingly, most of us do the latter.	0.220588
Pri kódovaní vizuálnych spomienok používa mozog vonkajšiu perspektívu, hovorí Metzinger.	In encoding visaul memories, the brain already uses an external perspective, says Metzinger.	0.568977
Nevieme povedať prečo a ako, ale ak mozog počas mimotelovej skúsenosti čerpá z takejto databázy, môže byť prostriedkom pre vnímanie seba z vonkajšej perspektívy.	We don't know much about why and how, but if something is extracted from such a database (during an out-of-body experience), there may be material for seeing oneself from the outside.	0.387626
Bez ohľadu na tento mechanizmus skúmanie mimotelových skúseností so sebou prináša prísľub pomoci s riešením vážnej otázky z oblasti neurovedy a filozofie: ako sa vytvára vedomie vlastného ja?	Whatever the mechanism, the study of out-of-body experiences promises to help answer a profound question in neuroscience and philosophy: how does self- consciousness emerge?	0.392185
Je viac než jasné, že máme zmysel pre vlastné ja, ktoré väčšinu času prebýva v našom tele.	Its abundantly clear to us that we have a sense of self that resides, most of the time, in our bodies.	0.268
No z mimotelových skúseností je tiež jasné, že zmysel pre ja sa môže zdanlivo oddeliť od nášho fyzického bytia.	Yet it is also clear from out-of-body experiences that the sense of self can seemingly detach from your physical body.	0.280851
Ako sú teda naše ja a naše telo prepojené?	So how are the self and the body related?	0.291176
Na zodpovedanie tejto otázky začal Metzinger spolupracovať s Blankom a jeho kolegami na experimente súvisiacom s mimotelovými zážitkami.	To address that question, Metzinger has teamed up with Blanke and his colleagues in an experiment that induces an out-of-body experience in healthy volunteers.	0.415395
Experiment vykonávali na zdravých dobrovoľníkoch. ~~~ Každého dobrovoľníka natáčali zozadu a obraz im premietali na obrazovke pripevnenej k ich hlave v dvojmetrovej vzdialenosti.	They film each volunteer from behind and project the image into a head- mounted display worn by the volunter so that they see an image of themselves standing about 2 metres in front.	0.0255352
Experimentátori ich potom udreli do chrbta, čo u nich vyvolalo pocit, akoby udreli ich virtuálne ja.	The experimenters then stroke the volunteers back – which the volunteers see being done to their virtual self.	0.272093
To spôsobilo zmyslový konflikt a viacerí mali pocit, že ich zmysel pre vlastné ja prechádza z fyzického tela do virtuálneho ja (Science, roč. 317, s. 1096).	This creates sensory conflict, and many reported feeling their sense of self migrating out of their physical bodies and towards the virtual one (Science, vol 317, p 1096).	0.603788
Pre Metzingera sú tieto experimenty dôkazom, že vedomie vlastného ja je späté s pocitom vlastnenia tela, no je v tom viac než len o obyčajný pocit stelesnenia.	To Metzinger, these experiments demonstrate that self-consciousness begins with the feeling of owning a body, but there is more to self – consciousness than the mere feelings of emodiment.	0.239552
Pocit vlastného ja má mnoho zložiek, hovorí Metzinger.	Selfhood has many components, says Metzinger.	0.677352
Snažíme sa ich postupne poskladať, staviame tehlu po tehle.	We are trying to fill them in, building block by building block.	0.288462
Toto je len začiatok.	This is just the beginning.	0.221053
V úlohách transformácie vlastného tela sú účastníkom na obrazovke premietané záblesky kreslených postavičiek, ktoré sa každú sekundu striedajú vždy po jednej v náhodnom poradí.	In an own-body transformation task, cartoon figures are flashed onto a screen, one at a time, at random, every second.	0.138
Úlohou dobrovoľníkov je predstaviť si seba v pozícií kreslenej postavičky a cvičiť s tou rukou, na ktorej je rukavica.	Volunteers are asked to put themselves in the position of the character to work out which hand the glove is on.	0.270652
Úloha si vyžaduje, že účastníci sa musia akoby otáčať v priestore a tým vzniká obraz mozgovej aktivity podobný obrazu mimotelového stavu.	The task requires them to mentally rotate their body in space and causes patterns of brain activity similar to that of an out-of-body experience.	0.287288
Anil Ananthaswamy je prispievajúci redaktor časopisu New Scientist.	Anil Ananthaswamy is a contributing editor for New Scientist.	1.59444
Hypnóza Pozrite sa mi do očí môže odhaliť nezvyčajné spôsoby zlého fungovania nášho mozgu, hovorí Nicola Jonesová.	Look into my eyes Hypnosis can reveal the bizzare ways in which our brains misbehave, says Nicola Jones.	0.429167
Práve mi idú znehybniť ľavú nohu, neznáma sila prevezme kontrolu nad mojím ramenom a je dosť možné, že oslepnem.	I am about to have my left leg paralysed, my arm taken over by an alien force and, quite possibly, be made blind.	0.290217
Tieto ujmy na mojom tele nespôsobí skalpel, ale hypnóza.	These insults to my body will not be inflicted with a scalpel, but instead induced using hypnosis.	0.0918367
Môj hypnotizér David Oakley ma uisťuje, že ak sa objavia účinky, budú len dočasné.	The effects, if they occur, will only be temporary, my hypnotist, David Oakley, reassures me.	0.457143
Toto všetko sa vykonáva v záujme vedy.	Its all being done in the interest of science.	0.245455
Oakley je bývalý profesor Londýnskej univerzity.	Oakley is an emeritus professor at University College London.	0.66039
Ako jeden z mála výskumníkov dúfa, že ak ľudia začnú brať hypnózu vážne, prestane sa vnímať ako akási šarlatánska veda (Pozri Čo je hypnóza?).	He is one of a handful of researchers who hope that by taking hypnosis seriously, they will help to dispel its quackerytainted image (see What's hypnosis?).	0.27
Myslím si, že hypnóza je všeobecne odmietaná a podceňovaná, hovorí Irvin Kirsch, psychológ z Univerzity v Hulle, Spojené Kráľovstvo.	I think hypnosis is underaccepted and undervalued, says psychologist Irving Kirsch at the University of Hull, UK.	0.247959
Čiastočne za to môžu strašné príbehy zverejnené v knihách a filmoch, vďaka ktorým ľudia vnímajú hypnózu ako čudný a neuveriteľný jav, z ktorého si ešte stále mnoho ľudí robí posmech.	Partly because of lurid tales published in books and movies, which lead to views of hypnosis as a strange and unbelievable state.Still many pepole scoff.	0.475385
Oakley sa snaží nielen napraviť reputáciu hypnózy, ale aj zlepšiť chápanie niektorých najzvláštnejších neurologických otázok.	Aside from improving the reputation of hypnosis, Oakley also aims to better understand some of the strangest neurological conditions out there.	0.455357
Pointou je privodiť pomocou hypnózy symptómy inak zdravým ľuďom.	The idea is to use hypnosis to induce symptoms in otherwise healthy people.	0.263158
To umožňuje, že sa symptómy u tzv. virtuálnych pacientov spúšťajú a miznú doslova lusknutím prstov, vďaka čomu sa ľahšie skúma abnormálna mozgová aktivita zodpovedná za ich vznik.	This creates virtual patients with symptoms that can literally be switched on and off with a snap of the fingers, making it easier to study the abnormal brain activity that causes them.	0.405195
Je to ako spätné inžinierstvo, hovorí Peter Halligan, neuropsychológ z Cardiffskej univerzity (Spojené Kráľovstvo), ktorý pracuje s Oakleym.	It's like reverse engineering, says Peter Halligan, a neuropsychologist at Cardiff University, UK, who works with Oakley.	0.58239
Až keď sa veci pokazia, začnete si vážiť príslušný mechanizmus.	It's only when things break down that you appreciate the mechanism involved.	0.24
Výskumníci veria, že všetky tieto stavy môžu byť u zdravých ľudí navodené pomocou hypnózy.	These are all conditions that the researchers believe can be recreated in healthy people using hypnosis.	0.253846
Mnohé z nich sú somatoformné poruchy, kedy sa u ľudí rozvíjajú fyzické symptómy bez zjavných fyzických príčin.	Many of them are somatoform disorders, in which people develop physical symptoms in the absence of an identifiable physical cause.	0.246316
Všetky tieto prípady sú ojedinelé a často sa objavujú u ľudí trpiacich inými problémami, akými sú depresia či schizofrénia, čo sťažuje výskum.	All are rare, and when they occur it is often in peopole with other problems, such as depression or schizophrenia, making them hard to study.	0.289831
Aby som zistila, aké sú tieto stavy a aký je to pocit byť zhypnotizovaný, prišla som, hoci trocha znepokojená, až na psychologickú fakultu University College London.	To get a sense of what these conditions are like and how it feels to be hypnotised I have come, with some trepidation, to University College London's psychology department.	0.735934
Kým sedíme v obyčajnej kancelárií, Oakley ma oboznamuje s relaxačnou procedúrou. ~~~ Začína sa tým, že mi povie, aby som si predstavila známe, obľúbené miesto.	As we sit in an ordinary office, Oakley guides me through a relaxation procedure, starting by asking me to imagine that I am in a happy familiar place.	0.0109155
Onedlho sa cítim presne ako na konci hodiny jogy – uvoľnená a pokojná.	I soon feel much as I do at the end of a yoga class – calm and relaxed.	0.706753
Myslela som si, že sa budem cítiť slabá a omámená, alebo že možno zabudnem, kde som, no stále počujem ruch z ulice a cítim sa normálne.	I expected to feel dizzy or drunk, or perhaps to forget where I was, but the street traffic is still audible and I feel normal.	0.279808
Potom Oakley prikáže, aby moja ľavá noha znehybnela a ja v nej naozaj cítim mravčenie, začína mi tŕpnuť.	Then Oakley suggests that my left leg is unable to move, and my leg starts to tingle with pins and needles.	0.457895
Som prekvapená, ale poddám sa tomu.	I am surprised by this, but go with it.	0.290323
Keď ma požiada, aby som zdvihla nohu, dokážem ju zdvihnúť ale iba pomaly, nemotorne a s ťažkosťou.	When he asks me to lift my leg, I can do it, but only slowly, awkwardly and with difficulty.	0.268
Znamená to, že metóda čiastočne zabrala, pravdepodobne som tesne nad priemernou hranicou zhypnotizovania, hovorí Oakley (pozri Do akej miery ste zhypnotizovateľný?).	This means the procedure has partially worked, I'm probably slightly above average on the hypnotisability scale, says Oakley (see How hypnotisable are you?).	0.414305
Ak by som patrila medzi tých 10 % ľudí s vysokou mierou zhypnotizovania, prestala by som vnímať zvuky z ulice a nedokázala by som vôbec zdvihnúť nohu.	Had I been in the 10 percent of people who are highly hypnotisable I would have ceased to hear the traffic and been unable to lift my leg at all.	1.45806
Hypnotická elita Julia Russellová, učiteľka v škole a Oakleyho bývalá študentka, je jednou z hypnotickej elity.	Hypnotic elite Julia Russell, a schoolteacher and former student of Oakley's, is one of the hypnotic elite.	0.636637
Russellová sa zúčastnila jedného z Oakleyho nedávnych experimentov týkajúcich sa syndrómu cudzej končatiny.	Russell participated in one of Oakleys recent alien limb experiments.	0.127869
Jeden zážitok opisuje ako dosť nevšedný.	She describes one experience as quite extraordinary.	0.208333
Počas hypnózy hýbali jej rukou, spočiatku manuálne.	During hypnosis, Russells arm was moved in a number of ways, first manually.	0.176087
Potom jej vnukli myšlienku, že v miestnosti sa zjaví experimentátorka, ktorá chce, aby sa jej ruka pohla.	Then the idea was suggested to her that an experimenter would enter the room who wanted her arm to move.	0.286047
Keď sa experimentátorka objavila, Russelova údajne zažila celkom zvláštny pocit.	When the experimenter appeared, Russell says she felt a bizarre sensation.	0.267692
Išlo to úplne mimo mňa.	I was being bypassed.	0.284211
Chcela, aby sa moja ruka pohla, tak sa pohla, pričom ja som sa vôbec na tomto pohybe nepodieľala, hovorí.	She wanted my hand to move, so it did, and I wasnt involved in the movement at all, she says.	0.248
Akoby jej myšlienky priamo ovplyvňovali moje správanie, bez môjho zásahu.	It was as if her thoughts were affecting my behaviour directly, without my thoughts intervening.	0.216923
Môže aktivita zhypnotizovaného mozgu naozaj napodobňovať stavy, ktoré prebiehajú počas skutočných porúch?	Can the activity in a hypnotised brain really mimic what's going on in someone with a real disorder?	0.260714
Ak aj áno, čo sa z toho môžeme naučiť?	And, if it can, what can it teach us?	0.29
Oakley a Halligan sú presvedčení, že ich virtuálni pacienti prežívajú podobné zmeny v mozgu ako ľudia so skutočnými poruchami.	Oakley and Halligan are convinced their virtual patients are experiencing some of the same brain changes as people with genuine disorders.	0.572477
Halligan rozpráva o tom, ako raz pomocou sugescie privodili u dobrovoľníka stav obmedzenosti zrakovej vnímavosti, kedy ľavá časť jeho zrakového poľa prestala existovať.	Halligan tells how they once induced a case of visual neglect in a volunteer by suggesting that the left side of his visual field would cease to exist.	0.3722
Potom ho požiadali, aby opísal obraz pomocou niekoľkých predmetov rozptýlených po strane.	They then asked him to copy a picture with a dozen objects scattered on the page.	0.246269
Väčšina zhypnotizovaných ľudí by po týchto inštrukciách opísala iba predmety z pravej časti strany, tak ako to robí aj väčšina skutočných pacientov trpiacich obmedzenosťou zrakovej vnímavosti.	Most hypnotised pepole given this instruction would copy only the objects on the right hand side of the page, as most people with visual neglect do.	0.193548
Tento dobrovoľník však nakreslil pravú stranu každého predmetu na strane.	But this volunteer drew the right-hand side of every object on the page.	0.280328
Niečo také by ste nečakali, hoci sa to stáva aj skutočným pacientom, hovorí Halligan.	That's not something you would intuitively expect, says Halligan, but it is also seen in real patients.	0.238356
V mozgu podľa jeho slov vzniká podobnosť.	The similarities reach into brain, he says.	0.283333
Halligan spolu s kolegami uspal 12 vysoko zhypnotizovateľných študentov.	Halligan and colleagues put 12 highly hypnotisable students under an then either suggested that their left leg was paralysed, or told them to merely pretend that their left leg was paralysed, with the promise of a reward if they managed to fool an investigator, unaware of which group the participants were in, couldn't tell who was faking paralysis – until they saw scans of the volunteers brains.	2.66308
Niektorým študentom vsugerovali, že ich ľavá noha ostane paralyzovaná, druhí to mali iba predstierať.	There were clear differences in brain activity.	-0.0357143
Sľúbili im odmenu, ak dokážu obalamutiť vyšetrovateľa, ktorý nevedel, v ktorej skupine dobrovoľníkov sa nachádza. ~~~ Nevedel teda, kto paralýzu iba predstiera, až kým neuvidel obrazy mozgovej aktivity dobrovoľníkov, ktoré sa jednoznačne líšili.	One of the brain areas that was highly active, or lit up, in the hypnotically paralysed volunteers was the right orbifrontal cortex – a region thought to be involved with emotional inhibition, and which has also been seen to light up in hysterical paralysis.	-0.00211268
U jedincov pod hypnotickou paralýzou bol pravý orbitofrontálny kortex jednou z vysoko-aktívnych, až rozsvietených oblastí mozgu.		-0.3
Táto oblasť je považovaná za oblasť zadržiavania emócií a podľa záznamov sa aktivuje aj pri hysterickej paralýze.		-0.3
Yann Cojan zo ženevskej univerzity vo Švajčiarsku sa nedávno pokúšal o podobný experiment, kedy bola ľavá ruka dobrovoľníkov paralyzovaná za pomoci hypnózy.	Yann Cojan at the University of Geneva in Switzerland recently tried a similar experiment where volunteers left hands were paralysed by hypnosis.	0.53447
Spolu s kolegami zistili, že mozgové snímky u dobrovoľníkov, ktorí hypnózu len predstierali, sú odlišné.	He and his colleagues also found that brain scans distinguished those under hypnotic suggestion from the fakers.	0.28022
Rovnaký, no zároveň iný	Same, but different	0.25
Určité rozdiely boli zaznamenané v oboch skupinách – ako u ľudí pod hypnotickou paralýzou, tak aj a u ľudí trpiacich skutočnou hysterickou paralýzou.	However, both groups also saw some differences in brain activity between hypnotic paralysis and people with genuine cases of hysterival paralysis.	0.297638
Cojan, ktorý zaznamenal väčšie rozdiely než Halligan, si myslí, že hoci je tento fakt z pohľadu výskumu zaujímavý, je len malá pravdepodobnosť, že hypnóza poskytne ľuďom so skutočnými poruchami lekársky relevantné výsledky.	Cojan – who saw greater differences than Halligan – thinks this means that, while interesting as a research tool, hypnosis is unlikely to produce clinically relevant results for people with real disorders.	0.269143
Aj napriek tomu ich výskumy viedli k niekoľkým zaujímavým záverom.	Nevertheless, their studies have lead them to some interesting conclusions.	0.253448
Napríklad sa zistilo, že tie mozgové aktivity, ktoré sú väčšinou spojené s úmyselným zákazom pohybu, sa neaktivizujú u ľudí s hysterickou paralýzou a rovnako ani u zhypnotizovaných dobrovoľníkov. ~~~ Tento fakt svedčí o tom, že v tomto prípade sa naozaj nehýbu preto, lebo nemôžu a nie preto, lebo nechcú.	For example, the work suggests that brain areas normally associated with the intentional inhibition of movement are not active in people with hysterical paralysis nor hypnotised volunteers, suggesting that it really is the case that they cannot, rather than will not, move.	-0.0154506
Zatiaľ je otázne, či podobné výskumy pomôžu v rozvoji liečby pre pacientov.	Whether such studies will help to develop treatments for patients remains to be seen.	0.263077
Najúčinnejšie by zrejme bolo jednoducho ľudí presvedčiť, že dané stavy sú reálne.	Perhaps the biggest impact will simply be to convince people that the conditions are real.	0.274648
Títo pacienti sa môžu v zdravotníctve stretnúť s rôznymi pejoratívnymi vyjadreniami typu - všetko je len vo vašej hlave, hovorí Antony Feinstein zo zdravotníckeho centra Sunnybrook Health Sciences Centre v Toronte, Kanade.	These patients can run into aspects of the healthcare system that are very pejorative – theyre constantly told it's all in your head, says Antony Feinstein of the Sunnybrook Health Sciences Center in Toronto, Canada.	0.739791
Hovoríme: áno, všetko je vo vašej hlave, pretože aj váš mozog je vo vašej hlave.	We say yes, it's all in your head, because your brain is in your head.	0.247368
Máme možnosť ukázať doktorom aj pacientom, ako vážne treba tieto stavy brať a práve to je dôležitý krok vpred.	Being able to show both doctors and patients that the conditions are being taken seriously is a big step forward.	0.593548
V súčasnosti liečba porúch zahŕňa terapiu rozprávaním, hypnotickú sugesciu na uľavenie od symptómov či dokonca psychoterapiu, čo niekedy funguje pre človeka ako dôvod na to, aby sa cítil lepšie.	At present, treatments for the disorders include talking therapy, hypnotic suggestion to relieve symptoms and even physiotherapy - which sometimes gives a person an excuse to get better.	0.286875
V mnohých prípadoch sú tieto postupy bezúspešné.	In many cases, these approaches are unsuccessful.	0.293023
Dôležité je lepšie porozumieť tým mozgovým štruktúram, ktoré prestali správne fungovať, čo by mohlo priamo ovplyvniť smer budúcej terapie.	A better understanding of the pathways in the brain that have gone away should help to direct future therapies.	0.21383
Až keď pochopíme systém fungovania, pochopíme i to, ako s ním zaobchádzať, hovorí Halligan.	If we understand how to treat it, says Halligan.	0.321951
Moje zápästie sa trocha nadvihne.	My wrist inches upwards.	0.190909
Neskôr mi prikáže, že ak otvorím oči, nebudem vidieť nič z ľavej časti zrakového poľa, čím chcel navodiť obmedzenosť zrakového poľa.	He next suggests that when I open my eyes, I will not be able to see anyting on in the left of my visaul field, an analogue of visual neglect.	0.297345
So zvedavosťou pomaly otváram oči, no vidím celkom normálne.	I open them slowly, fascinated to see what this will be like, but my vision is normal.	0.198113
Som trocha sklamaná, no Oakley mi hovorí, že dokonca vysoko zhypnotizovateľní ľudia zriedkakedy zažijú tento úkaz.	I feel strangely disappointed, but Oakley tells me that even highly hypnotisable people only rarely experience this effect.	0.455471
Zdá sa, že čas je to jediné, o čo som prišla. Keď sa ma Oakley opýta, ako dlho som podľa mňa bola pod vplyvom hypnózy, odpovedám, okolo 20 minút.	The only thing I seem to have lost permanently is a little bit of time, when Oakley asks me how long I think I have been under, I reply, about 20 minutes.	1.58475
Usmeje sa a povie, že to trvalo viac než hodinu.	He grins when he tells me it was over an hour.	0.275676
Hovorí, že časová kompresia je normálny vedľajší účinok hypnózy.	Time compression is a commmon side effect of hypnosis, he says.	0.283333
Hoci som nezažila úplný syndróm cudzej končatiny ani obmedzenosť zrakovej vnímavosti, môj názor na hypnózu sa zmenil.	Although I failed to experience full alien limb syndrome or visual neglect, my thinking on hypnosis has been changed.	0.294
Po tom, čo som ju zažila na vlastnej koži, som viac presvedčená o jej sile.	I am more convinced of the power of the phenomenon after experiencing it for myself.	0.256452
Hoci nevylučujem, že mi Oakley túto myšlienku vsugeroval, kým som bola Nicolou Jonesovou - kanadskou spisovateľkou so sídlom vo Vancouvri.	Though I can't help suspecting that Oakley planted the thought in my head while I was under Nicola Jones is a writer based in Vancouver, Canada What is hypnosis?	0.407857
Čo je hypnóza? ~~~ Niektorí hovoria, že hypnóza nie je nič viac než naprogramované chovanie.	Some say hypnosis is nothing more than people acting how the think they are meant to act when hypnotised.	-0.0192308
V niektorých prípadoch to môže byť pravda, no odmietaním hypnózy sa značne podceňuje jej sila, tak ako sa podceňuje aj placebo efekt tvrdením, že je to len tabletka cukru, pričom sa zabúda na fakt, že niekomu môže pomôcť.	In some instances this may be true, but to dismiss hypnosis vastly underestimates its power, much like dismissing a plaebo as just a sugar pill glosses over the fact that it can help someone get better.	0.350724
David Oakley, bývalý profesor z Londýnskej univerzity hovorí, že pacienti s vážnymi popáleninami, z ktorých niektorých dohnala bolesť aj napriek podaniu morfia až k psychotickým stavom, sa upokojili práve počas hypnózy.	Severe burn patients, some of whom are driven psychotic from pain even when given morphine, have been made calm through hypnosis, says David Oakley, an emeritus professor at University College London.	0.454167
Keď ide psychológ Michael Nash z Univerzity Tennessee v Knoxville k zubárovi kvôli malému vŕtaniu, vyhýba sa anestézii a radšej uprednostní autohypnózu.	When Michael Nash, a psychologist at the University of Tennessee in Knoxville, goes to the dentist for some minor drilling work, he shuns anaesthesia in favour of self-hypnosis.	0.648123
Môj zubár je vždy unesený, hovorí.	The dentist is always impresssed, he says.	0.23
Od roku 1996 Národný ústav zdravia v Bethesde (Maryland) považuje hypnózu za efektívnu metódu tlmenia bolesti, a nedávne metaanalýzy potvrdili jej využitie v chirurgií.	Since 1996, the US National Institutes of Health in Bethesda, Maryland, have deemed hypnosis an effective method of pain relief, and more recent meta-analyses have confirmed its usefulness in surgery.	0.246575
Niektoré štúdie ukázali, že hypnóza môže pôsobiť proti bolesti účinnejšie než placebo tabletky.	Some studies have shown that hypnosis can have a greater pain-relief effect than placebo pills.	0.506969
Amir Raz z kanadskej Univerzity McGill v Montreale preukázal ďalší významný účinok hypnózy, ktorý často umlčí kritikov presvedčených o tom, že zhypnotizovaní dobrovoľníci to iba predstierajú.	Amir Raz of McGill University in Montreal, Canada, has demonstrated another powerful effect, which often silences critics who say hypnotised volunteers are just faking it.	0.60764
Vo všeobecnosti platí, že ak niekomu ukážete názov farby napísaný inou farbou, napríklad červenú napísanú modrou, a následne sa ich opýtate na farbu atramentu, na chvíľu zaváhajú.	In general, if you show somebody the name of a colour written in a different colour – red written in blue, for example – and ask them the colour of the ink, they pause.	0.367437
Tento jav je v človeku hlboko zakorenený, no Raz dokázal, že ak dobrovoľníkovi počas hypnózy vsugerujú, že nevie čítať, táto oneskorená reakcia môže vymiznúť.	This is a very deeply ingrained effect, but Razhas showed that using hypnosis to suggest a volunteer cannot read can eliminate this delay.	0.251282
Je veľmi dôležité, aby sa vedci pri sledovaní týchto zaujímavých javov riadili objektívnymi kritériami, hovorí Raz.	When scientists try to measure these funky things, its really important to have objective measures, says Raz.	0.45413
Je stále diskutabilné, či existuje vzorec mozgovej aktivity charakteristický pre hypnózu.	Wherher there is a pattern of brain activity characteristic of hypnosis is still up for debate.	0.29625
Výsledky niektorých nedávnych výskumov naznačujú, že zhypnotizovaní jedinci v stave odpočinku menej fantazírujú.	Some recent research hints that hypnotised volunteers have less mind wander when in a resting state.	0.247674
Ťažko však povedať, či je tento stav navodený pomocou hypnózy alebo relaxačných techník.	But it's hard to say whether this is due to hypnosis or the relaxation techniques to instigate it.	0.280519
Do akej miery ste zhypnotizovateľný?		-0.3
Predpažte ruky dlaňami k sebe.	How hypnotisable are you?	0.247826
Potom zavrite oči a predstavte si, že magnetické pole tlačí vaše ruky k sebe.	Hold your arms out straight in front of you, palms facing each other.	0.263793
Poriadne sa na minútu koncentrujte a predstavte si ten pocit.	Then close your eyes and imagien a magnetic force pulling your hands together, and really concentrate for a minute on what that might feel like.	0.187822
Teraz otvorte oči.	Now open your eyes.	0.3
Pohli sa vaše ruky smerom k sebe?	Have your arms moved together?	0.288889
Priblíži sa približne 70 % ľudí.	They do for about 70 percent of people.	4.96071
Táto skupina ľudí je považovaná za sugestibilných, a teda pravdepodobne aj ľahko zhypnotizovateľných.	This group is considered suggestible, and so probably hypnotisable.	0.15
Najlepší spôsob, ako u niekoho otestovať náchylnosť podľahnúť hypnóze, je jednoducho ho zhypnotizovať a sledovať, čo sa stane.	The best way to assess someone's susceptibility to hypnotism is simply to hypnotise them and see what happens.	0.248936
Existujú rôzne miery, ako napríklad Standfordova hypnotická miera citlivosti, ktorá meria stupeň zhypnotizovateľnosti u jedincov. ~~~ Meria sa na základe ich reakcií na rôzne sugescie pod vplyvom hypnózy, počnúc od pocitu rúk ťahaných k sebe ako magnety, až po pocity, že vaša ruka je dvíhaná za pomoci balóna.	There are various defined scales – such as the Stanford hypnotic susceptibility scale – that rank a person's hypnotisability based on their response to a dozen suggested tasks under hypnosis – from feeling your hands being drawn together as if by magnets, to feeling your arm being lifted by a balloon.	-0.00592885
Miera, ako ľahko je človek ovplyvniteľný za normálnych okolností, môže priamo súvisieť s tým, ako bude vykonávať tieto úlohy.	A strong indicator of how someone will perform on such tests is simply how susceptible they are to suggestion under normal circumstances.	0.275
Ľahko zvyčajne podliehajú hypnóze tí ľudia, ktorí sa nechávajú uniesť dejom vo filmoch alebo knihách a veria, že postavy sú skutočné, rovnako ľudia, ktorí sa dostávajú do akéhosi tranzu počas vykonávania vytrvalostných športov alebo tí, ktorí mali ako deti imaginárnych priateľov.	People who lose themselves so completely in movies or books that they believe the characters to be real, who go into a kind of trance when doing endurance sports, or who had imiginary friends as children, are usually hypnotisable.	0.300389
Tiež pomáha, ak ľudia jednoducho chcú byť zhypnotizovaní.	The motivation to be hypnotised also helps.	0.197368
Niektoré štúdie naznačujú, že naša miera zhypnotizovania je v nás hlboko zakorenená.	Some studies hint that our hypnotisability is deeply ingrained.	0.203571
Keď 50 ľudí po 25 rokoch opakovane prešlo testami podľa Standfordovej mierky, ich výsledky zostali napodiv rovnaké.	When 50 people were re-tested on the Stanford scale after a 25-year gap, their scores stayed remarkably consistent.	0.463636
James Horton z Virginskej univerzity v Charlottesville zaznamenal dokonca fyzické rozdiely v mozgu: vysoko zhypnotizovateľní účastníci mali o 30 percent väčšie rostrum, časť mozgu slúžiacu na sústreďovanie sa.	James Horton at the University of Virginia in Charlottesville has even found physical brain differences: highly hypnotisable participants had a 30 percent bigger rostrum, a part of hte brain thought to help focus attention.	1.94206
Na základe niektorých štúdií je vidieť, že miera zhypnotizovateľnosti môže byť dedičná. ~~~ Niektorí výskumníci vrátane Amira Raza z Univerzity McGill hľadajú gény, ktoré sú za to zodpovedné.	A few studies have shown that hypnotisability may be hereditary, and some researches – including Amir Raz of McGill University in Montreal, Canada – are trying to track the genes involved.	0.0601744
Prekvapivo sa väčšina výskumníkov počas rozhovoru zaradila na stupnici zhypnotizovateľnosti do skupiny priemerných ľudí.	Curiously, most of the scientists interviewed for this piece categorised themselves as only mediocre on the scale of hypnotisability.	0.277778
Vo všeobecnosti platí, že výskumníci problém rozoberajú, posudzujú a opakovane zhodnocujú, čo nie je práve hypnotický stav mysle, hovorí výskumník hypnózy David Spiegel zo Standfordovej univerzity v Kalifornií.	In general, researchers tend to dissect and criticise and re-evaluate, says hypnosis researcher David Spiegel of Stanford University, California. And that's not a very hypnotic state of mind.	0.575799
Upálenie mojej sestry nebolo ani zďaleka také, ako keď fénix po troch dňoch povstane z popola.	There was nothing phoenix-like in my sister’s immolation.	0.129412
Po tom, ako sa vyparila, zanechala po sebe len zápach spálenej kože, neznesiteľné teplo, kakofonický zvuk posledného srdcervúceho výkriku a prázdne stopy vypálené do púštneho piesku.	Just the scent of charred skin, unbearable heat, the inharmonious sound of her last, grief-raw scream as she evaporated, leaving glass footprints seared into the desert sand.	0.281879
Ak by boli moji rodičia stále nažive, aj keď možno sú v nejakom inom paralelnom vesmíre, tak by mi povedali, že to nebola moja chyba, a nikto nemohol vedieť, čo sa stane.	If my parents were still alive—although they are, probably, in some iteration of the universe; maybe even this one—they would tell me that it wasn’t my fault, that no one could have seen it coming.	0.248571
Že si za to môže sama.	That she did this to herself.	0.611905
Takto však na niekoho zvaľovať vinu nie je podľa mňa správne.	But that kind of blame doesn’t suit me.	0.127273
Navyše odjakživa prehliadali záležitosti týkajúce sa Melanie.	Besides, they had always been exceptionally blind to matters regarding Melanie.	0.6
Dokonca si ani nevšimli, keď sme sa spolu vzniesli k oblohe. ~~~ Melanie fúkala prúdy sem a tam pod našimi telami a preplietala ich hrejivým teplom ako veniec zo sedmokrások.	They didn’t even notice when the two of us would take to the sky together, Melanie blowing currents back and forth beneath our bodies, weaving thermals like daisy chains.	-0.00169779
Na stole sme robievali tanec s iskrami a mama sa k tomu nikdy nejako nevyjadrovala. ~~~ Akurát nám povedala, že je neslušné pred inými ľuďmi stvárať veci, ktoré oni sami nedokážu, a že sa musíme naučiť hovoriť aj s inými ľuďmi.	We used to make sparks dance at the table, and our mom never said a word about it, except that it was rude to do things that other people couldn’t in front of them, and also that we needed to learn to talk to people other than each other.	0.0544838
Melanie vždy vo všetkom vynikala. No bola trochu búrlivá a utáraná.	Melanie was better at everything than I was, the stormy bit and the talking bit both.	0.482759
Keby chcela, tak by mohla rozdeliť horizont na dve časti, roztvoriť ho vo švíkoch tak šikovne ako krajčírka a prinútiť blesk, aby sa jej skrútil v ruke ako mačka a dokonca by pre ňu priadol.	She could split the horizon in two if she wanted, opening it at the seams as deftly as a tailor, and make the lightning curl catlike at her wrist and purr for her.	0.331417
To isté by dokázala s ľuďmi. ~~~ Mel vyžarovala tlmené svetlo.	She could do that with people too; Mel glowed, soft, luminescent.	0.138889
Bolo ťažké odvrátiť od nej pohľad a také ľahké stratiť sa v jej tieni.	It was hard to look away from her, and so easy to disappear into her shadow.	0.27931
Keď sa však udalosti neuberali správnym smerom, Melanie zaliezla do izby a nechcela vyjsť.	But when things got too bad to ignore, the air in the house dark and crackling with ugly energy like the sky before a monsoon, she dug in and refused to leave.	0.303846
Ja som bola tá, ktorá odišla na druhé pobrežie, a sľubovala, že budem čoskoro späť.	I was the one who abandoned our coast for another, promising I’d be back soon.	0.276923
A nakoniec som to bola ja, kto sa už nevrátil.	And then I was the one who stayed away.	0.24375
Deň, keď moja sestra zničila svet, sa obloha po prvýkrát za celé tie roky roztvorila v daždi a zaplavila púštne kroviny za naším domom.	The day my sister ended the world, the sky opened up in rain for the first time in years, flooding the desert wash behind our house.	0.286111
Hady sa utopili vo svojich dierach a diviaky sa rozutekali po prúde rieky. ~~~ Avšak voda bola mocnejšia a zmietla ich so sebou.	The snakes drowned in their holes and the javelinas stampeded downstream, but the water overtook them, and the air filled with their screaming as they were swept away.	-0.0495283
Vzduchom sa šírilo žalostné kvíkanie. ~~~ Snažila som sa dostať taxíkom domov, lenže cesty sa stratili v náhlej povodni.	I’d tried to take a taxi home, but the roads disappeared in the flash flood, so I struggled out of the swamped cab and slogged the last two miles.	-0.025
Vydrala som sa zo zaplaveného auta a brodila ďalšie tri kilometre. ~~~ Melanie, malá suchá postava, stála vonku pred zrúcaninou domu našich rodičov.	Melanie was outside, a small, dry figure in front of the ruined shell of our parents’ house.	0.0723684
Mala na sebe jediné šaty, ktoré jej zostali. ~~~ Zvyšné spálila mama, keď ich našla.	She wore the only dress she had left—the rest our mother had burned when she’d found them.	-0.0107143
Prúd dažďa sa ohýbal okolo mojej sestry do tvaru zvona a v rukách jej ako pri hre spletené motúziky tancovali záblesky energie.	The rain bent around my sister in a bell shape, and electricity danced in her hands, growing bigger and bigger like a ravenous cat’s cradle.	0.402397
Prednedávnom blesk rozštiepil kaktusy na dvore, rozdelil na dve polovice a spálil ich na kosť a kožu.	Some time ago, lightning had shattered the cacti in the yard, splitting them in two and searing them bone-bare.	0.272093
Ostali po nich iba sčerneté kostry, ktoré sa drali z vody nahor ako žalujúce prsty.	Only their blackened skeletons were left, clawing upward out of the water like accusing fingers.	0.244286
Určite cítila, že prídem.	I know she felt me coming.	0.286364
Možno to bolo chvením na suchej zemi pod jej nohami či vlniacou sa energiou, ktorá prechádzala po vode a narážala do mňa.	Maybe it was a tremble in the dry ground beneath her feet, or a ripple of energy through the water that crashed around my waist.	0.418554
Zdvihla zrak a vypleštila oči, pod ktorými sa jej usadili tmavé kruhy.	She glanced up, her eyes wide, bruised circles.	0.160976
Spomínam si, že som na ňu jačala.	I remember that I yelled something at her.	0.214286
Mohlo to byť jej meno.	That time around, it could have been her name.	-0.0157895
Mohla to byť prosba, v ktorej som ju žiadala, aby prestala.	It could have been a plea, begging her not to do what I could see was about to happen.	0.436
Alebo to možno bolo iba: "Čo si, dofrasa, myslíš, že robíš?"	Or maybe it was just "What the fuck do you think you’re doing?”	0.294118
Svet sa zasekol, zvlnil sa do fialova, vetvy elektriny sa ma dotýkali, hrýzli vo vlasoch a pálili všetko živé, čo ostalo pod vodou.	The world hiccupped, warping violet, legs of electricity touching down around me, biting at my hair, singeing anything still alive beneath the water.	0.250909
Sotva som to cítila.	I barely felt it.	0.24
"Prečo si sa vrátila?" boli jej posledné slová než zmizla v plameňoch a vzala so sebou zvyšok vesmíru. ~~~ Bolo to jednoduché.	"Why did you come back?” were the last words she said to me before she went up in flames, taking the rest of the universe with her.	-0.00142857
Melanie mi raz povedala: "Tak, Hannah, dávaj pozor a naučím ťa, ako funguje budúcnosť."	It was simple, Melanie had once told me. "Here, Hannah. Pay attention, and I’ll teach you how the future works.”	0.424
Vo vzduchu mi nakreslila obrázok, mapu žiarivých budúcností, konštantných a variabilných, uzavretý kruh možností prepojených navzájom, ktoré preskakovali z jednej časovej osi na druhú.	She drew the picture for me in the air, a map of sparkling futures, constants, and variables; closed circuits of possibilities looped together, arcing from one timeline to another.	0.402353
Pochopila som, dokonca viac než len to. ~~~ Po prvýkrát som vnímala jej schopnosť v podobe premenlivej energie.	I saw and understood; but more than that, for the first time, I saw her power as a single, mutable shape.	-0.0139535
"To je nádhera," zhíkla som.	"That’s beautiful,” I said.	0.3
"Však?"	"Isn’t it?”	0.1875
Melanie obkreslila prstom vzduch a poklepala na jeden žiariaci bod.	Melanie traced the air with her finger, tapping a single glowing point.	0.835285
"Pozri, to sme my.	"Look, that’s us.	0.3
A tu je to, čo sa môže stať v závislosti od, nuž, v závislosti od mnohých vecí."	And here’s what could happen, depending on well, depending on a lot of things."	0.290769
Možnosti sa spojili pred mojimi očami ako údery bleskov a rástli im vetvy, akoby vnímali.	Options chained like lightning strikes before my eyes, possibilities growing legs like sentient things.	0.240789
"Ak je to také ľahké, prečo to nezmeníš?" vyhŕkla som.	"If it’s that easy, why don’t you change it?” I blurted out.	0.273913
"Chcem povedať, zariaď to tak, aby sme sa mali lepšie."	"Shape it to make it better for us, I mean."	0.481061
Odvrátila odo mňa zrak.	Her eyes slid away from me.	0.271429
"Nedá sa to len tak, lusknutím prstov."	"It’s not that easy to get it right,” she said.	0.630882
Deň, keď moja sestra zničila svet, som sedela v lietadle a po rokoch bola na ceste domov.	The day my sister ended the world, I was on a plane home for the first time in years.	0.440196
Väčšinu cesty sa mi podarilo prespať, čo sa mi nestávalo často, a zobudila som sa, keď lietadlo pristávalo. ~~~ Mierne mi pískalo v ušiach.	I’d managed to sleep most of the way, which was unusual, and I woke up as the plane was descending, a faint popping in my ears.	0.0591671
Slnko zapadalo, rovinaté mesto popretkávané diaľnicami sa ešte len začínalo mihotať v záplave elektrických svetiel a civilizácia pulzovala po zemi na hlavných ťahoch.	It was sunset, and the flat, highway-veined city was just beginning to glimmer with electric light, civilization pulsing across the ground in arteries, in fractals.	0.291489
Táto krása ma však neuchvátila.	But the beauty was lost on me.	0.264
Vonku boli ťažké mračná a srdce v mojej hrudi neprestávalo bubnovať.	The clouds outside felt heavy, and my heart wouldn’t stop drumming in my chest.	0.259322
Niečo nebolo v poriadku, len som nevedela čo.	Something was wrong, but I didn’t know what.	0.292105
Mala som déjà vu.	I felt like I’d seen this before.	0.04
Čas sa vliekol a vonku začalo pršať.	Time stuttered, and outside, it began to rain.	0.212903
Keby som ti mohla upliesť korunu potenciálnych budúcností, ako si ty pre mňa v detstve zapletala sedmokrásky do venca, tak by som neváhala ani sekundu.	If I could knit you a crown of potential futures like the daisies you braided together for me when we were young, I would.	0.216
Žiadna z nich by neskončila tým, že by ťa opití vysokoškoláci upálili zaživa na našom pozemku, či zmlátili do bezvedomia v krovinách za naším domom. ~~~ A naši rodičia, ktorí ťa chceli mať podľa svojich predstáv, by ťa pomaly neroztrhali na márne kúsky.	None of them would end with you burning to death at the edge of our property, beaten senseless in the wash behind the house by drunken college boys, slowly cut to pieces at home by parents who wanted you only in one shape, the one crafted in their image.	0.0804348
Dala by som ti čokoľvek.	I would give you only the best things.	0.142857
Dobrosrdečnosť, ktorú si si zaslúžila; telo, ktoré si chcela; východisko, ktoré by sa neskončilo roztrhnutím horizontu; možnosti, ktoré by sa sypali jedna za druhou. ~~~ Zrútil sa mi svet.	The kindness you deserved, the body you wanted, a way out that didn’t end with the horizon line ripped open, possibilities pouring out like loose stuffing, my world shrieking to a halt.	-0.00483871
Všetko by som napravila.	I would have fixed everything.	0.231818
Deň, keď moja sestra Nie!	The day my sister— No.	0.252632
Deň, keď som ja úplne po prvýkrát zničila svet, moje lietadlo pristálo skôr, a tak som uháňala, aby som chytila taxík, kým blížiaci sa monzún nezmetie mesto.	The day I ended the world, the very first time, my plane touched down early and I sprinted to catch a cab before the impending monsoon swept the city.	0.385192
Tentoraz mi chýbalo asi šesť kilometrov do cieľa, keď zrazilo šesť áut a zápcha zastavili celú premávku.	This time around, I made it four miles from the house before a six-car pileup—tires slick, drivers panicked in the storm—stopped traffic entirely.	0.345318
Dalo mi zabrať, aby som pred všetkými nerozrazila vodu, nespadla do prúdov vysokých po kolená a udržala svoje nohy na asfalte.	It took everything in me not to shunt the water aside in front of everyone else, to stumble into neck-deep currents and anchor my feet to the asphalt below.	0.238318
