To som dnes robil v práci.	That’s what I did at work today.	0.231818
Keď som Jacka spoznal, ešte nebol Jackom.	When I met Jack he wasn’t Jack yet.	0.227586
Môj šéf je majster remeselník.	My boss, he’s the master craftsman.	0.255556
Biotvorca.	Bio- thaumaturge.	0.136364
On vytvoril hlinenú kožu, on spravil tú prácu.	It was him did the clayflesh, who went to work.	0.292308
To on vzal Jackovi pravú ruku.	It was him took off Jack’s right hand.	0.230769
Ale ja som bol ten, kto mu pri tom držal femur.	But it was me held the claw.	0.104348
Tú obrovskú, prerastenú modlivkovskú končatinu s chitínovými čepeľami dlhými ako moje predlaktie.	That great, outsized mantis limb, hinging chitin blades the length of my forearm.	0.227143
Držal som ju na Jackovom kýpti, kým môj šéf do seba zlieval kožu a štít.	I held it on Jack’s stump while my boss made the flesh and scute run together and alloy.	0.233898
To on pretvoril Jacka, ale ja som bol súčasťou toho celého a na to budem navždy hrdý.	It was him Remade Jack, but I was part of it, and that’ll always make me proud.	0.271875
Ako som dnes kráčal domov z práce mestom, ktoré mám tú česť chrániť, premýšľal som o menách.	I was thinking about names as I knocked off today, as I walked home through this cityit’s my honour to protect.	0.241558
Viem, že je veľa ľudí, ktorí nechápu, že niektoré veci sa proste musia spraviť a ak im meno Chrobák Jack robí radosť, ja ich za to nesúdim.	I know there are plenty who don’t understand what has to be done sometimes, and if the name of Jack Half-a-Prayer gives them pleasure, I don’t grudge them that.	0.464286
Jack, muž, ktorého som stvoril.	Jack, the man I made.	0.633333
Teraz mu patrí toto meno, nech sa predtým volal akokoľvek.	It’s his name, now, whatever he was called before.	0.251163
Ako som už povedal, v tom krátkom čase, čo som ho poznal, predtým aj potom, ako som ho stvoril, nikdy som ho neoslovil jeho menom a ani on mňa mojím.	Like I say, in the short time I knew him, before I made him and after, I never called Jack by his name nor he me.	0.192135
Nemohli sme, nie v tejto brandži.	We couldn’t, not in this line of work.	0.268966
Jacka som vždy oslovoval "väzeň", a keď mi odpovedal, oslovoval ma "pane".	Whenever I spoke to Jack, I called him "Prisoner, ” and answering, he called me "Sir.”	0.2625
Automat s kolou, automat so sladkosťami a fritéza už museli odísť.	They had to go. The Coke machine, the snack machine, the deep fryer.	0.3
Zdvihli sa, vliekli po chodbách a potom vyšli von k obrubníku. Spolu s ďalšími vecami, ktoré negatívne pôsobia na zdravie študentov, si sadli pod sivú, pochmúrnu oblohu za základnou školou Kirkpatrick, jednou z mála základných škôl mesta Clarksdale v štáte Mississippi.	Hoisted and dragged through the halls and out to the curb, they sat with other trash beneath gray, forlorn skies behind Kirkpatrick Elementary, one of a handful of primary schools in Clarksdale, Mississippi.	0.384425
Už pred siedmimi rokmi si riaditelia prvýkrát uvedomili vážnosť problému.	That was seven years ago, when administrators first recognized the magnitude of the problem.	0.230769
Clarksdale je známe mesto pri ústí rieky Mississippi. ~~~ Prinieslo rozkvet hudobného štýlu Delta blues a ponúklo výhľad na bavlníkové plantáže, stále krásne panské sídla vo viktoriánskom štýle a roviny, ktoré sa tiahnu ku rieke.	Clarksdale, a storied delta town that gave us the golden age of the Delta blues, its cotton fields and flatlands rolling to the river, its Victorian mansions still beautiful, is at the center of a colossal American health crisis.	0.120748
Clarksdale sa pasuje s mnohými zdravotnými problémami ako je cukrovka, vysoký krvný tlak, ochorenia srdca a vysoká miera obezity. ~~~ Niektorí odborníci si myslia, že ich spôsobil cukor.	High rates of obesity, diabetes, high blood pressure, heart disease: the legacy, some experts say, of sugar, a crop that brought the ancestors of most Clarksdale residents to this hemisphere in chains.	0.0709821
Na našu pologuľu túto plodinu postupne priniesli prevažne predkovia obyvateľov mesta Clarksdale.		-0.3
Vedeli sme, že musíme niečo urobiť, povedala SuzAnne Waltonová, riaditeľka základnej školy Kirkpatrick.	We knew we had to do something, Kirkpatrick principal SuzAnne Walton told me.	0.396104
Waltonová sa v meste Clarksdale narodila a vyrástla. ~~~ Previedla ma po budove školy a porozprávali sme sa o spôsoboch, akými sa učiteľský zbor snaží poradiť študentom so stravovaním.	Walton, Clarksdale born and bred, was leading me through the school, discussing ways the faculty is trying to help students—baked instead of fried, fruit instead of candy—most of whom have two meals a day in the lunchroom.	0.0416209
Väčšina z nich v jedálni konzumuje denne dve jedlá. ~~~ Namiesto vyprážaného jedla a sladkostí sa v školskej jedálni ponúka pečené jedlo a ovocie.	She was wearing scrubs—standard Monday dress for teachers, to reinforce the school’s commitment to health and wellness.	-0.0274038
Waltonová mala oblečený biely lekársky plášť, ktorý učitelia nosievajú v pondelok, aby zdôraznili, že škola bojuje za zdravie a zdravý životný štýl.		-0.3
Z celkového počtu študentov tvoria 91 % Afroameričania, 7 % belosi a zvyšné 2 % predstavujú traja Hispánci.	The student body is 91 percent African American, 7 percent white, and three Latinos—the remaining 2 percent.	2.46007
Tieto deti zjedia to, čo im dajú, a veľmi často ide o najsladšie a najlacnejšie jedlo: koláče, krémové dezerty v kelímku a cukríky.	These kids eat what they’re given, and too often it’s the sweetest, cheapest foods: cakes, creams, candy.	0.233333
To sa muselo zmeniť.	It had to change.	0.24
Išlo o zdravie študentov, vysvetlila Waltonová.	It was about the students, she explained.	0.241667
Napríklad Nicholas Scurlock začal nedávno chodiť do prvej triedy.	Take, for example, Nicholas Scurlock, who had recently begun his first year at Oakhurst Middle School.	0.444828
Nick bol dosť vysoký na to, aby už mohol jazdiť na horskej dráhe vo väčších zábavných parkoch.	Nick, just tall enough to ride the coaster at the bigger amusement parks, had been 135 pounds going into fifth grade.	0.227848
Keď išiel do piateho ročníka, vážil 61 kg.	He was terrified of gym, Principal Walton told me.	0.241667
Mal strach z telesnej výchovy, povedala riaditeľka Waltonová.	There was trouble running, trouble breathing—the kid had it all.	0.294545
Chlapec mal problémy s behom aj s dýchaním.		-0.3
Viem, že som tá posledná, ktorá by ho mala súdiť, dodala Waltonová a rozosmiala sa.	Of course, I’m not one to judge, Walton added, laughing, slapping her thighs.	0.281818
Veď aj ja mám väčšie rozmery.	I’m a big woman myself.	0.225
Raz, keď som stretla Nicka v jedálni, sedel vedľa svojej očarujúcej 38-ročnej matky Warkeyie Jonesovej.	I met Nick in the lunchroom, where he sat beside his mother, Warkeyie Jones, a striking 38-year-old.	0.469853
Priznala sa mi, že zmenila svoje stravovacie návyky, aby pomohla sebe a bola príkladom pre Nicka.	Jones told me she had changed her own eating habits to help herself and to serve as an example for Nick.	0.292771
Jedávala som sladkosti celý deň, pretože mám sedavé zamestnanie. ~~~ Čo iné som mala robiť?	I used to snack on sweets all day, ’cause I sit at a desk, and what else are you going to do?	-0.00821918
Ale prešla som na zeler, povedala.		-0.3
Ľudia mi hovoria: Robíš to kvôli priateľovi.	But I’ve switched to celery, she told me.	0.640714
A ja im vždy odpoviem: Nie, robím to, pretože chcem žiť a byť zdravá.	People say, ‘You’re doing it ’cause you’ve got a boyfriend.’	0.543881
Do šálky nalejete vodu, pridáte cukor až po okraj a necháte päť hodín odstáť.	And I say, ‘No, I’m doing it ’cause I want to live and be healthy. ’	0.238889
Keď sa vrátite, zbadáte na dne pohára usadené kryštáliky.	Take a cup of water, add sugar to the brim, let it sit for five hours.	0.264
Clarksdale je veľké mesto, ktoré sa nachádza v jednom z krajov s najvyššou mierou obezity, v štáte a zároveň priemyselne najrozvinutejšej krajine na svete, kde trpí obezitou najviac ľudí.		-0.3
Toto mesto sa považuje za tzv. dno amerického nápoja.	When you return, you’ll see that the crystals have settled on the bottom of the glass.	0.130435
Cukor, ktorý tento nápoj obsahuje, sa usádza v telách takých detí ako je Nick Scurlock. ~~~ Na postave chlapca zanechal sladený nápoj stopu.	Clarksdale, a big town in one of the fattest counties, in the fattest state, in the fattest industrialized nation in the world, is the bottom of the American drink, where the sugar settles in the bodies of kids like Nick Scurlock—the legacy of sweets in the shape of a boy.	-0.136017
Marcipánové mešity	Mosques of Marzipan	0.3
Pred asi 10 000 rokmi domestikovali cukrovú trstinu na ostrove Nová Guinea. ~~~ Ľudia ju najprv pozbierali a potom ju surovú jedli. ~~~ Stonku prežúvali až dovtedy, kým sa jej chuť nerozplynula na jazyku ako mäkký karamelový cukrík.	In the beginning, on the island of New Guinea, where sugarcane was domesticated some 10, 000 years ago, people picked cane and ate it raw, chewing a stem until the taste hit their tongue like a starburst.	-0.0767133
Už mýty zo starovekej Novej Guiney zobrazovali cukor ako istý všeliek, liek na každú chorobu aj náladu.	A kind of elixir, a cure for every ailment, an answer for every mood, sugar featured prominently in ancient New Guinean myths.	0.238636
Jeden z nich je o mužovi, ktorý sa miluje so stonkou cukrovej trstiny, čo bolo prínosom pre ľudstvo.	In one the first man makes love to a stalk of cane, yielding the human race.	0.193548
Počas náboženských obradov si kňazi uchlipkávali zo škrupiny kokosového orecha sladenú vodu. Neskôr tento nápoj vystriedali plechovky koly.	At religious ceremonies priests sipped sugar water from coconut shells, a beverage since replaced in sacred ceremonies with cans of Coke.	0.287288
Cukor sa pomaly šíril z ostrova na ostrov. ~~~ Nakoniec sa okolo roku 1 000 pred n. l. dostal na ázijskú pevninu.	Sugar spread slowly from island to island, finally reaching the Asian mainland around 1000 B. C.	-0.0182927
Od roku 500 n. l. sa začal v Indii spracovávať na prášok a využívať ako liek na bolesti hlavy, žalúdočné ťažkosti a impotenciu.	By A. D. 500 it was being processed into a powder in India and used as a medicine for headaches, stomach flutters, impotence.	1.91923
Po celé stáročia zostala rafinácia cukru utajeným umením, ktoré sa odovzdávalo z majstra na učňa.	For years sugar refinement remained a secret science, passed master to apprentice.	0.25
Do roku 600 n. l. sa toto umenie rozšírilo aj do Perzie, kde panovníci zaplavovali hostí sladkosťami.	By 600 the art had spread to Persia, where rulers entertained guests with a plethora of sweets.	2.11083
Keď arabské armády dobyli túto oblasť, odniesli si poznatky a lásku k cukru.	When Arab armies conquered the region, they carried away the knowledge and love of sugar.	0.249231
Bolo to, ako keď vo vzduchu poletujú púpavové nažky, čiže sem a tam. ~~~ Jednoducho povedané, cukor sa objavil všade, kde ľudia uctievali Alaha.	It was like throwing paint at a fan: first here, then there, sugar turning up wherever Allah was worshipped.	0.0176692
Kdekoľvek Arabi prišli, priniesli so sebou cukor ako výrobok a aj technológiu jeho výroby, uvádza Sidney Mintz v knihe Sladkosti a ich sila 1.	Wherever they went, the Arabs brought with them sugar, the product and the technology of its production, writes Sidney Mintz in Sweetness and Power.	0.525
Hovorí sa, že cukor išiel po stopách Koránu.	Sugar, we are told, followed the Koran.	0.264706
Moslimskí vládcovia urobili z cukru skvelé umenie.	Muslim caliphs made a great show of sugar.	0.225
Marcipán bol hitom. Mleté mandle s cukrom vytvarované do neobvyklých tvarov vypovedali o bohatstve štátu.	Marzipan was the rage, ground almonds and sugar sculpted into outlandish concoctions that demonstrated the wealth of the state.	0.241304
Jeden autor z 15. storočia opísal marcipánovú mešitu, ktorú si objednal kalif (moslimský vládca).	A 15th-century writer described an entire marzipan mosque commissioned by a caliph.	0.250685
Chudobní boli ňou unesení, obdivovali ju a modlili sa v nej.	Marveled at, prayed in, devoured by the poor.	0.207692
Arabi zdokonalili rafináciu cukru a urobili z nej priemysel.	The Arabs perfected sugar refinement and turned it into an industry.	0.266038
Bola to neskutočne ťažká práca.	The work was brutally difficult.	0.289286
Na poliach bola veľká horúčava, mihotajúce sa kosy, z kotolní sa dymilo a množstvo cukrovarov.	The heat of the fields, the flash of the scythes, the smoke of the boiling rooms, the crush of the mills.	0.281481
Keď od roku 1500 začal dopyt po cukre stúpať, práca na cukrových plantážach sa považovala za vhodnú len pre najspodnejšiu vrstvu robotníkov.	By 1500, with the demand for sugar surging, the work was considered suitable only for the lowest of laborers.	0.208696
Veľkú časť poľnohospodárskych pracovníkov tvorili vojnoví zajatci z východnej Európy, ktorých zajali počas bitiek medzi moslimami a kresťanmi.		-0.3
Britskí a francúzski križiaci boli pravdepodobne prvými Európanmi, ktorí sa do cukru zamilovali.	Many of the field hands were prisoners of war, eastern Europeans captured when Muslim and Christian armies clashed.	0.250588
Na Východ prišli, aby si od neveriacich vzali Svätú zem. ~~~ Domov sa vrátili plní vízií, príbehov a spomienok na cukor.	Perhaps the first Europeans to fall in love with sugar were British and French crusaders who went east to wrest the Holy Land from the infidel.	-0.0285
Cukrová trstina nie je vhodná na pestovanie v miernom podnebnom pásme.	They came home full of visions and stories and memories of sugar.	0.267273
Aby sa jej dobre darilo, potrebuje tropické podnebie a dažďom zmáčané polia. ~~~ Prvý európsky trh bol vybudovaný podľa moslimského trhu a cukor, ktorý sa dostal na Západ, konzumovala len šľachta. ~~~ Málokedy sa zaraďoval medzi korenie.	As cane is not at its most productive in temperate climes—it needs tropical, rain-drenched fields to flourish—the first European market was built on a trickle of Muslim trade, and the sugar that reached the West was consumed only by the nobility, so rare it was classified as a spice.	-0.0901395
Ale keď sa okolo roku 1400 rozširovala Osmanská ríša, obchodovanie s Východom začínalo byť zložitejšie.	But with the spread of the Ottoman Empire in the 1400s, trade with the East became more difficult.	0.270732
Západné mocnosti, ktoré podľahli kúzlu cukru, mali na výber niekoľko možností: vysporiadať sa s malými juhoeurópskymi výrobcami cukru, poraziť Turkov, alebo získať nové zdroje cukru.	To the Western elite who had fallen under sugar’s spell there were few options: deal with the small southern European sugar manufacturers, defeat the Turk, or develop new sources of sugar.	0.3
Hľadaniu území a ostrovov, ktoré by otvorilo Európanom cestu do celého sveta, sa v školách hovorí obdobie zámorských objavov.	In school they call it the age of exploration, the search for territories and islands that would send Europeans all around the world.	0.288889
V skutočnosti išlo vo veľkej miere o lov na polia, kde by sa cukrovej trstine mohlo dobre dariť.	In reality it was, to no small degree, a hunt for fields where sugarcane would prosper.	0.271233
V roku 1425 portugalský princ, známy ako Henrich Moreplavec, poslal prvú skupinu kolonistov s cukrovou trstinu na Madeiru.	In 1425 the Portuguese prince known as Henry the Navigator sent sugarcane to Madeira with an early group of colonists.	2.01884
Onedlho si plodina našla cestu na ďalšie novoobjavené ostrovy v Atlantickom oceáne – Kapverdy a Kanárske ostrovy.		-0.3
Keď sa v roku 1493 Kolumbus vydal na svoju druhú plavbu do Nového sveta, prepravoval aj cukrovú trstinu.	The crop soon made its way to other newly discovered Atlantic islands—the Cape Verde Islands, the Canaries.	0.286364
Tým sa na Karibských ostrovoch začala éra cukru, veľkých plantáží cukrovej trstiny s otrokmi.		-0.3
V dôsledku toho začali po čase na predmestiach zo skla a ocele vznikať veľké dymiace rafinérie.	In 1493, when Columbus set off on his second voyage to the New World, he too carried cane.	0.271622
Došlo k masovej spotrebe cukru a nárastu počtu obéznych detí a rodičov. ~~~ A objavili sa muži v XXL teplákových súpravách, ktorí sa ťažkopádne pohybovali na elektrických vozíkoch.	Thus dawned the age of big sugar, of Caribbean islands and slave plantations, leading, in time, to great smoky refineries on the outskirts of glass cities, to mass consumption, fat kids, obese parents, and men in XXL tracksuits trundling along in electric carts.	-0.0666667
Otroci cukru Kolumbus zasadil prvú cukrovú trstinu Nového sveta na ostrove Haiti, na mieste, kde sa o niekoľko stoviek rokov, nie náhodou, konalo veľké povstanie otrokov.	Slaves to Sugar Columbus planted the New World’s first sugarcane in Hispaniola, the site, not coincidentally, of the great slave revolt a few hundred years later.	0.282609
Niekoľko desaťročí lemovali pahorkatiny Jamajky a Kuby len mlyny, pretože dažďový prales bol vyrúbaný a domorodé obyvateľstvo sužovala choroba, vojna, alebo bolo zotročené.	Within decades mills marked the heights in Jamaica and Cuba, where rain forest had been cleared and the native population eliminated by disease or war, or enslaved.	0.274101
Najúčinnejší model výroby cukru vytvorili Portugalci. ~~~ Z Brazílie si vybudovali prvú prosperujúcu kolóniu, v ktorej viac ako 100 000 otrokov vo veľkom produkovalo tony cukru.	The Portuguese created the most effective model, making Brazil into an early boom colony, with more than 100, 000 slaves churning out tons of sugar.	0.0411765
Čím viac cukrovej trstiny sa vypestovalo, tým viac klesala cena výrobku.	As more cane was planted, the price of the product fell.	0.197872
Od roku 1500 sa so znižovaním ceny začal zvyšovať dopyt.	As the price fell, demand increased.	0.15
Ekonómovia to nazývajú začarovaný kruh – nie je to fráza, ktorú by ste použili, ak by ste sa ocitli na zlej strane rovnice.	Economists call it a virtuous cycle—not a phrase you would use if you happened to be on the wrong side of the equation.	0.412755
V polovici 17. storočia sa cukor začal meniť z luxusného korenia, ktoré sa zaraďovalo do tej istej skupiny ako muškátový oriešok a kardamóm, na základnú zložku potravy u strednej triedy a neskôr aj u chudobných.		-0.3
Súvislosť medzi cukrom a otroctvom sa skončila v 18. storočí. ~~~ Každých pár rokov sa kolonizoval ďalší ostrov, ako napr. Portoriko alebo Trinidad, na ktorom sa klčovali lesy a vysádzala sa cukrová trstina.	In the mid-17th century sugar began to change from a luxury spice, classed with nutmeg and cardamom, to a staple, first for the middle class, then for the poor.	0.0503414
Keď domorodci vymreli, plantážnici ich nahradili africkými otrokmi.	By the 18th century the marriage of sugar and slavery was complete.	0.278947
Po pozbieraní a pomletí úrody ju zhromažďovali na lodiach.	Every few years a new island—Puerto Rico, Trinidad—was colonized, cleared, and planted.	0.447059
Na nich sa prepravovala do Londýna, Amsterdamu alebo Paríža.	When the natives died, the planters replaced them with African slaves.	0.254717
Tam ju vymieňali za hotový tovar, ktorý prevážali na západné pobrežie Afriky, kde ho vymieňali za ďalších otrokov. ~~~ Počas tohto trojuholníkového obchodu zomrelo niekoľko miliónov Afričanov.	After the crop was harvested and milled, it was piled in the holds of ships and carried to London, Amsterdam, Paris, where it was traded for finished goods, which were brought to the west coast of Africa and traded for more slaves.	-0.0225904
Jeho krvavá súčasť sa nazývala ako tzv. Stredná cesta. ~~~ V roku 1807 bolo vo Veľkej Británii otroctvo zakázané.	The bloody side of this triangular trade, during which millions of Africans died, was known as the Middle Passage.	-0.00315789
Dovtedy bolo do Nového sveta prepravených viac ako 11 miliónov Afričanov, z ktorých viac ako polovica skončila na cukrových plantážach.	Until the slave trade was banned in Britain in 1807, more than 11 million Africans were shipped to the New World—more than half ending up on sugar plantations.	1.8304
Trinidadský historik a politik Eric Williams tvrdí: Otroctvo sa nenarodilo z rasizmu, ale skôr rasizmus je následkom otroctva.	According to Trinidadian politician and historian Eric Williams, Slavery was not born of racism; rather, racism was the consequence of slavery.	0.419713
Inak povedané, Afričania neboli zotročení, pretože ich považovali za nižšie postavených. ~~~ Vnímali ich tak preto, aby tým obhájili otroctvo, ktoré bolo potrebné pre prosperitu prvého obchodovania s cukrom.	Africans, in other words, were not enslaved because they were seen as inferior; they were seen as inferior to justify the enslavement required for the prosperity of the early sugar trade.	-0.0199367
Pôvodným britským ostrovom s cukrom bol Barbados.	The original British sugar island was Barbados.	0.660714
Bol neobývaný, až kým ho 14. mája 1625 neobjavil britský kapitán. ~~~ Ostrov čoskoro zaplnili cukrovary, usadlosti na plantážach a chatrče.	Deserted when a British captain found it on May 14, 1625, the island was soon filled with grinding mills, plantation houses, and shanties.	0.0169355
V prvých rokoch sa na ostrove pestoval tabak a bavlna, ale potom sa tam rýchlo rozmohlo pestovanie cukrovej trstiny, rovnako ako keď ju zasadili v Karibiku.	Tobacco and cotton were grown in the early years, but cane quickly overtook the island, as it did wherever it was planted in the Caribbean.	0.258621
V priebehu jedného storočia došlo k ochudobneniu polí a zníženiu hladiny podzemnej vody.	Within a century the fields were depleted, the water table sapped.	0.444737
Dovtedy už najviac ctižiadostiví plantážnici Barbados opustili. ~~~ Snažili sa nájsť ďalší ostrov, ktorý by mohli využívať.	By then the most ambitious planters had left Barbados in search of the next island to exploit.	0.13319
Do roku 1720 mala Jamajka v pestovaní cukru prvé miesto.	By 1720 Jamaica had captured the sugar crown.	3.89744
Život na týchto ostrovoch bol pre Afričanov peklom.	For an African, life on these islands was hell.	0.2625
V celom Karibiku zomreli milióny ľudí na poliach, v lisovniach alebo pri pokuse o útek.	Throughout the Caribbean millions died in the fields and pressing houses or while trying to escape.	0.255405
Aj obyvatelia Európy začali postupne pociťovať hriech z obchodovania.	Gradually the sin of the trade began to be felt in Europe.	0.2125
Reformátori volali po zrušení obchodovania s cukrom, ženy v domácnosti bojkotovali cukrovú trstinu, ktorú vypestovali otroci.	Reformers preached abolition; housewives boycotted slave- grown cane.	0.0714286
Elizabeth Abbottová v diele Cukor: Sladkohorká história cituje vodcu Kvakerov Williama Foxa, ktorý povedal, že za každý kilogram cukru nás môžu vnímať, ako keby sme skonzumovali 100 gramov ľudského mäsa.	In Sugar:A Bittersweet History Elizabeth Abbott quotes Quaker leader William Fox, who told a crowd that for every pound of sugar, we may be considered as consuming two ounces of human flesh.	0.368649
Otrok v diele Voltaira Candide alebo optimizmus, ktorému chýba ruka a noha, vysvetľuje svoje zmrzačenie takto: Keď sme pracovali v cukrovaroch a naše prsty sa zachytili v mlynskom kameni, odsekli nám ruky. Keď sme sa pokúsili utiecť preč, odsekli nám nohy. Mne sa stali obe veci.	A slave in Voltaire’s Candide, missing both a hand and a leg, explains his mutilation: When we work in the sugar mills and we catch our finger in the millstone, they cut off our hand; when we try to run away, they cut off a leg; both things have happened to me.	0.393536
Za túto cenu jete cukor v Európe.	It is at this price that you eat sugar in Europe.	0.171429
Aj napriek tomu sa jeho rozmach nezastavil.	And yet there was no stopping the boom.	0.254545
Cukor bol ropou tej doby.	Sugar was the oil of its day.	0.272727
Čím viac ste ho ochutnali, tým viac ste ho chceli.	The more you tasted, the more you wanted.	0.24
V roku 1800 skonzumoval priemerný Angličan 2 kg cukru ročne.	In 1700 the average Englishman consumed 4 pounds a year.	0.275
V roku 1800 priemerný muž zjedol 9 kg cukru.	In 1800 the common man ate 18 pounds of sugar.	0.591892
V roku 1870 rovnako maškrtný muž zjedol 21 kg ročne.	In 1870 that same sweet-toothed bloke was eating 47 pounds annually.	0.470455
Uspokojilo ho to?	Was he satisfied?	0.3
Samozrejme, že nie!	Of course not!	0.184615
V roku 1900 stúpla konzumácia cukru na 45 kg ročne.	By 1900 he was up to 100 pounds a year.	0.456598
V priebehu týchto 30 rokov svetová produkcia cukrovej trstiny a repného cukru prudko vzrástla z 2, 8 milióna ton cukru na viac ako 13 miliónov ročne.	In that span of 30 years, world production of cane and beet sugar exploded from 2. 8 million tons a year to 13 million plus.	1.8441
V súčasnosti skonzumuje priemerný Američan ročne 35 kg pridaného cukru alebo viac ako 22 čajových lyžičiek cukru denne.	Today the average American consumes 77 pounds of added sugar annually, or more than 22 teaspoons of added sugar a day.	0.445774
Ak dnes navštívime Barbados, uvidíme, čo tam cukor zanechal: zničené mlyny, ich drevené vrtule, ktoré sa otáčajú vo vetre a označujú čas; ošarpané panské sídla; stúpajúce a klesajúce cesty, z ktorých máme vždy výhľad na more. ~~~ Nájdeme tam aj hotely, v ktorých turistom nalievajú sladké rumové kokteily, tých pár tovární, kde sa cukrová trstina stále dvíha do lisov a surový, lepkavý, sladký cukor klesá dolu šmýkačkou.	If you go to Barbados today, you can see the legacies of sugar: the ruined mills, their wooden blades turning in the wind, marking time; the faded mansions; the roads that rise and fall but never lose sight of the sea; the hotels where the tourists are filled with jam and rum; and those few factories where the cane is still heaved into the presses, and the raw sugar, sticky sweet, is sent down the chutes.	-0.00943114
Keď som stál v rafinérii a okolo mňa pobehovali muži s prilbami na hlave, prečítal som si nápis napísaný rukou: modliaci sa človek úpenlivo prosí Pána Boha, aby ho obdaril múdrosťou, ochraňoval ho a zabezpečil plodine úrodnosť.	Standing in a refinery, as men in hard hats rushed around me, I read a handwritten sign: a prayer beseeching the Lord to grant them the wisdom, protection, and strength to bring in the crop.	0.399788
Vinník	The Culprit	0.128571
Zdá sa, že zakaždým, keď skúmam chorobu a zisťujem príčinu jej vzniku, privedie ma to k cukru.	It seems like every time I study an illness and trace a path to the first cause, I find my way back to sugar.	0.602954
Richard Johnson je nefrológ z Denverskej univerzity v štáte Kolorádo. ~~~ V jeho kancelárii v meste Aurora v Koloráde sme sa rozprávali o tom, ako ulice zapĺňajú obézni ľudia.	Richard Johnson, a nephrologist at the University of Colorado Denver, was talking to me in his office in Aurora, Colorado, the Rockies crowding the horizon.	-0.0157895
Je to muž väčších rozmerov, ktorého oči pri rozprávaní žiaria.	He’s a big man with eyes that sparkle when he talks.	0.223256
Prečo má v súčasnosti jedna tretina dospelých (celosvetovo) vysoký krvný tlak, ak v roku 1900 malo vysoký krvný tlak len 5 % dospelých na celom svete? opýtal sa.	Why is it that one-third of adults[worldwide] have high blood pressure, when in 1900 only 5 percent had high blood pressure? he asked.	1.74159
Prečo malo v roku 1980 cukrovku 153 miliónov ľudí a teraz ju má viac ako 347 miliónov?	Why did 153 million people have diabetes in 1980, and now we’re up to 347 million?	0.639706
Prečo je čím ďalej, tým viac Američanov obéznych?	Why are more and more Americans obese?	0.209091
Som presvedčený, že cukor je jedným z vinníkov, ak nie hlavným.	Sugar, we believe, is one of the culprits, if not the major culprit.	0.283333
Už v roku 1675 zažívala západná Európa prvý rozmach cukru. ~~~ Thomas Willis, lekár a jeden zo zakladateľov britskej Kráľovskej spoločnosti vtedy poznamenal, že moč ľudí trpiacich cukrovkou chutí nádherne (úplne) sladko, ako keby bol napustený medom alebo cukrom.	As far back as 1675, when western Europe was experiencing its first sugar boom, Thomas Willis, a physician and founding member of Britain’s Royal Society, noted that the urine of people afflicted with diabetes tasted wonderfully sweet, as if it were imbued with honey or sugar.	0.10431
O 250 rokov neskôr doktor Haven Emerson z Kolumbijskej univerzity upozornil na to, že výrazné zvýšenie počtu úmrtí v dôsledku cukrovky v období rokov 1900 - 1920 sa časovo zhoduje s nárastom spotreby cukru v týchto rokoch.	Two hundred and fifty years later Haven Emerson at Columbia University pointed out that a remarkable increase in deaths from diabetes between 1900 and 1920 corresponded with an increase in sugar consumption.	0.646687
V 60. rokoch 20. storočia vykonal britský odborník na výživu John Yudkin sériu experimentov na zvieratách a ľuďoch.	And in the 1960s the British nutrition expert John Yudkin conducted a series of experiments on animals and people showing that high amounts of sugar in the diet led to high levels of fat and insulin in the blood—risk factors for heart disease and diabetes.	0.42823
Ukázali, že vysoké množstvo cukru v strave vedie k vysokému podielu inzulínu v krvi a nárastu tuku, ktoré sú rizikovými faktormi pre vznik ochorení srdca a cukrovky. ~~~ Ale Yudkinovu správu zmiatla zo stola skupina ďalších vedcov.	But Yudkin’s message was drowned out by a chorus of other scientists blaming the rising rates of obesity and heart disease instead on cholesterol caused by too much saturated fat in the diet.	0.0321429
Príčinu vysokej úrovne obezity a ochorení srdca videli v cholesterole, ktorý bol spôsobený príliš veľkým podielom nasýtených tukov v strave.		-0.3
V dôsledku toho sa dnes v americkej strave nachádza menší podiel tuku ako pred 20 rokmi.	As a result, fat makes up a smaller portion of the American diet than it did 20 years ago.	2.23707
Napriek tomu sa počet obéznych Američanov zvýšil.	Yet the portion of America that is obese has only grown larger.	0.238636
Johnson spolu s ďalšími odborníkmi tvrdí, že hlavným dôvodom rozšírenia obezity je cukor, a najmä fruktóza.	The primary reason, says Johnson, along with other experts, is sugar, and in particular fructose.	0.267857
Sacharóza alebo stolový cukor, sa skladá z rovnakého množstva glukózy a fruktózy, cukru, ktorý môžete prirodzene nájsť v ovocí.	Sucrose, or table sugar, is composed of equal amounts of glucose and fructose, the latter being the kind of sugar you find naturally in fruit.	0.275455
Práve fruktóza dodáva stolovému cukru jeho lahodnú sladkosť.	It’s also what gives table sugar its yummy sweetness.	0.247826
Vysoko-fruktózový kukuričný sirup, v skratke HFCS, tiež tvorí kombinácia fruktózy a glukózy, v nealkoholických nápojoch sa nachádzajú v pomere okolo 55 % ku 45 %.	(High-fructose corn syrup, or HFCS, is also a mix of fructose and glucose— about 55 percent and 45 percent in soft drinks.	2.01726
Zdá sa, že sacharóza a HFCS majú na zdravie podobný vplyv.	The impact on health of sucrose and HFCS appears to be similar. )	0.519388
Johnson mi vysvetlil, že aj keď glukózu odbúravajú bunky celého tela, fruktóza sa spracováva predovšetkým v pečeni.	Johnson explained to me that although glucose is metabolized by cells all through your body, fructose is processed primarily in the liver.	0.412667
Ak budeme konzumovať príliš veľa ľahko stráviteľného jedla, ako sú nealkoholické nápoje a sladkosti, naša pečeň bude rozkladať fruktózu a produkovať tuky, ktoré sa nazývajú triglyceridy.	If you eat too much in quickly digested forms like soft drinks and candy, your liver breaks down the fructose and produces fats called triglycerides.	0.214286
Niektoré z týchto tukov zostávajú v pečeni, ktorá sa môže po ich dlhom pôsobení nimi naplniť a prestať správne fungovať.	Some of these fats stay in the liver, which over long exposure can turn fatty and dysfunctional.	0.222222
Ale veľká časť triglyceridov preniká do krvi.	But a lot of the triglycerides are pushed out into the blood too.	0.195
Časom sa krvný tlak zvýši a tkanivá sa postupne stávajú odolnejšie voči inzulínu.	Over time, blood pressure goes up, and tissues become progressively more resistant to insulin.	0.248571
V dôsledku toho vylúči pankreas väčšie množstvo inzulínu, čím sa snaží udržať veci pod kontrolou.	The pancreas responds by pouring out more insulin, trying to keep things in check.	0.24
Pre stav známy ako pôsobenie metabolického syndrómu je typický vysoký krvný tlak, obezita najmä v oblasti bokov a ďalšie metabolické zmeny. ~~~ Ak sa tento stav nekontroluje, môže viesť k vzniku cukrovky 2. typu a navyše aj zvýšenému riziku srdcového infarktu, ku ktorému môže dôjsť.	Eventually a condition known as metabolic syndrome kicks in, characterized by obesity, especially around the waist; high blood pressure; and other metabolic changes that, if not checked, can lead to type 2 diabetes, with a heightened danger of heart attack thrown in for good measure.	0.0612448
Viac ako tretina dospelých Američanov spĺňa kritériá, ktoré stanovili pre metabolický syndróm Národné inštitúty zdravia USA.	As much as a third of the American adult population could meet the criteria for metabolic syndrome set by the National Institutes of Health.	0.278182
V poslednom čase sa Americká kardiologická asociácia pridala k varovaniam o pridávaní veľkého množstva cukru do stravy.	Recently the American Heart Association added its voice to the warnings against too much added sugar in the diet.	0.275
Základom týchto varovaní je, že cukor poskytuje len prázdne kalórie bez výživovej hodnoty.	But its rationale is that sugar provides calories with no nutritional benefit.	0.251471
Johnson si spolu s jeho kolegami myslí, že to nie je všetko.	According to Johnson and his colleagues, this misses the point.	0.815455
Cukor v nadmernom množstve neobsahuje len prázdne kalórie, ale je aj toxický.	Excessive sugar isn’t just empty calories; it’s toxic.	0.18125
Nemá to nič spoločné s kalóriami, tvrdí endokrinológ Robert Lustig z Kalifornskej univerzity v San Franciscu.	It has nothing to do with its calories, says endocrinologist Robert Lustig of the University of California, San Francisco.	0.974303
Cukor je jedom sám o sebe, keď ho konzumujeme vo vysokých dávkach.	Sugar is a poison by itself when consumed at high doses.	0.242553
Johnson zhrnul všeobecné tvrdenie týmto spôsobom: Američania sú tuční, pretože jedia príliš veľa a cvičia príliš málo.	Johnson summed up the conventional wisdom this way: Americans are fat because they eat too much and exercise too little.	0.463725
Robia to tak preto, lebo sú závislí od cukru, z ktorého po jeho počiatočnom návale nielen priberú, ale zníži sa ich energia. ~~~ Z tohto dôvodu sa potom len povaľujú na gauči.	But they eat too much and exercise too little because they’re addicted to sugar, which not only makes them fatter but, after the initial sugar rush, also saps their energy, beaching them on the couch.	-0.0239583
Príčinou nášho pozerania televízie nie je to, že telka je super, lenže kvôli nadmernej konzumácii cukru nemáme dostatok energie na cvičenie, povedal Johnson.	The reason you’re watching TV is not because TV is so good, he said, but because you have no energy to exercise, because you’re eating too much sugar.	0.270968
Aké je riešenie?	The solution?	0.253846
Prestaňme jesť toľko cukru.	Stop eating so much sugar.	0.273913
Keď obmedzíme cukor v strave, zmizne veľa chorobných príznakov.	When people cut back, many of the ill effects disappear.	0.25
V dnešnej dobe je nesmierne ťažké sa vyhnúť cukru, ktorý je jedným z dôvodov prudkého nárastu konzumácie potravín.	The trouble is, in today’s world it’s extremely difficult to avoid sugar, which is one reason for the spike in consumption.	0.281633
Výrobcovia využívajú cukor, aby dochutili jedlo s nízkym obsahom tuku, takže vyvoláva dojem, že je zdravšie. ~~~ Takýmto jedlom je napr. nízkokalorické pečivo, ktoré často obsahuje veľké množstvo pridaného cukru. ~~~ Je to najhorší možný scenár.	Manufacturers use sugar to replace taste in foods bled of fat so that they seem more healthful, such as fat-free baked goods, which often contain large quantities of added sugar.	-0.122
Nemôžeme smrteľne ochorieť kvôli konzumácii jedla, ktoré milujeme, ale kvôli konzumácii jedla, ktoré neznášame, pretože určite nechceme smrteľne ochorieť.	It’s a worst-case scenario: You sicken unto death not by eating foods you love, but by eating foods you hate—because you don’t want to sicken unto death.	0.278906
Na počiatku bolo ovocie	In the Beginning	0.18
Ak je pre nás cukor zlý, prečo máme naň neuveriteľnú chuť?	Was the FruitIf sugar is so bad for us, why do we crave it?	0.287234
Stručnou odpoveďou je, že injekcia cukru zavedená do krvného obehu stimuluje v mozgu rovnaké centrá slasti, ktoré reagujú na heroín a kokaín.	The short answer is that an injection of sugar into the bloodstream stimulates the same pleasure centers of the brain that respond to heroin and cocaine.	0.280165
Do určitej miery takúto reakciu mozgu spôsobujú aj všetky chutné potraviny.	All tasty foods do this to some extent—that’s why they’re tasty!	0.24
Preto nám tak chutia! ~~~ Ale cukor má veľmi výrazný účinok.	—but sugar has a sharply pronounced effect.	-0.04
V tomto zmysle je doslova návykovou látkou.	In this sense it is literally an addictive drug.	0.276316
Nastoľuje sa otázka: Prečo je náš mozog vyvinutý tak, aby na potenciálne toxickú látku reagoval pôžitkom?	This raises the question, however, of why our brains would evolve to respond pleasurably to a potentially toxic compound.	0.257143
Johnson mi povedal, že odpoveď leží hlboko v našej opičej minulosti, keď naši predkovia túžili po fruktóze len preto, lebo ju potrebovali na prežitie.	The answer, Johnson told me, lies deep in our simian past, when a craving for fructose would be just the thing our ancestors needed to survive.	0.397311
Parafrázujem Johnsona hlasom prepožičaným z bájok: Aké by boli najlepšie teórie, ak nie staré príbehy, ktoré sú prerozprávané vedeckým jazykom?	I paraphrase Johnson in a voice borrowed from the fables, for what are even the best theories, if not the old stories told again in the language of science?	0.2904
Veľmi dávno, pred asi 22 miliónmi rokmi, ľudoopy obsadili koruny stromov afrického dažďového pralesa. ~~~ To mohol byť aj počiatok sveta.	Some 22 million years ago, so far back it might as well be the beginning, apes filled the canopy of the African rain forest.	1.07809
Prežili vďaka strave, ktorá sa skladala z ovocia zo stromov osladeného prírodným cukrom. ~~~ Ovocie jedli celoročne.	They survived on the fruit of the trees, sweet with natural sugar, which they ate year-round—a summer without end.	-0.00463918
Leto tam nemalo koniec.		-0.3
