Seamus Heaney sa narodil v katolíckej vlasteneckej rodine v Severnom Írsku, ktoré obývali prevažne protestantskí unionisti.	Seamus Heaney was born into a Catholic nationalist family in the mainly Protestant unionist Northern Ireland.	0.608731
Keď mal jedenásť rokov, získal štipendium do internátnej školy. ~~~ Išlo o Strednú školu sv. Kolumba v Derry.	When he was eleven, he won a scholarship to a boarding school, St. Columb’s College in Derry.	-0.017619
Následne pokračoval na vysokej škole v Belfaste, kde získal pozíciu univerzitného učiteľa. ~~~ Svoju prvú zbierku poézie vydal, keď mal dvadsaťsedem rokov.	He went on to university teachers’ college in Belfast, publishing his first book of poetry when he was twenty-seven.	-0.035625
O štyridsať štyri rokov neskôr bol už autorom dvanástich básnických zbierok, veľkého množstva prekladov, divadelných hier, próz a mnohých rozprávok.	Forty-four years later, he is the author of a dozen poetry collections, numerous translations, plays, prose, and countless chapbooks and limited editions.	0.433626
Nesmieme zabudnúť ani na jeho limitovanú edíciu.		-0.3
Má toľko veľa priaznivcov, že masa ľudí vystáva rady len preto, aby ho mohla počuť.	His following is so largethat crowds lining up to hear him are dubbed "Heaneyboppers.	0.287143
Títo ľudia sú známi ako Heaneyho stúpenci.		-0.3
Heaneyho básne zobrazujú blízkosť prírodného sveta, jeho stelesňovanie.	Heaney’s poems engage with the immediacy of the natural world, its physicality.	0.281538
Oslavuje v nich domácu sféru, ale vždy aj s vedomím o existencii sveta za jej bránami.	He celebrates the domestic sphere but always with an awareness of the world beyond.	0.295775
V básni Hranica (Terminus) niektoré riadky zachytávajú tento zmysel opisujúc, že keď kope, nachádza oboje, žaluď, ale aj zhrdzavenú skrutku.	Some lines in a poem called "Terminus” capture that sense, describing how when he digs, he finds both an acorn and a rusted bolt.	0.257944
Ak pozdvihne svoj zrak, zočí strechu továrne, ale aj hory.	If he looks up, he sees a factory chimney and a mountain.	0.280851
"Je na tom niečo neobvyklé, ak mám z toho zmiešané pocity?" napísal. ~~~ Neskôr jeho báseň znie: "Odniesť dve vedrá je jednoduchšie ako jedno.	"Is it any wonder when I thought /I would have second thoughts? ”he writes, and, later in that poem: "Two buckets were easier carried than one.	0
Uprostred toho som rástol."	I grew up in between.	0.183333
Slovo "uprostred" neznázorňuje iba politickú líniu, ale odráža aj jeho postoj a vzťah k svetu.	”That "in between” isn’t just a political line but reflects his posture in relation to the world.	0.483796
Od roku 1972 Heaney svoj čas delí striedavo medzi grófstvom Wicklow a Dublin.	Heaney has divided his time between County Wicklow and Dublin since 1972.	0.747253
Dvadsať rokov pôsobil ako profesor. ~~~ Jeden semester strávil na Harvardskej univerzite a v rokoch 1989 – 1994 zastával post profesora poézie na Oxfordskej univerzite.	For twenty years, he taught one semester a year at Harvard, and between 1989 and 1994 he held the position of Professor of Poetry at Oxford.	1.04324
V roku 1995 získal Nobelovu cenu za literatúru.	In 1995, he was awarded the Nobel Prize in Literature.	0.263415
Jeho najnovšia zbierka Ľudské puto (Human Chain) sa objaví vo vašich kníhkupectvách už túto jeseň.	His new collection, Human Chain, will be coming out this fall.	0.118868
Wachtelová: Narodili ste sa na farme Mossbawn v severoírskom okrese Derry a už viackrát ste spomenuli, že o tomto území sa už tak často písalo, či už v úvode kníh, alebo v rôznych cestopisoch, že tomu už ani nemôžete uveriť. ~~~ Ale aj tak sa spýtam. ~~~ Aké sú prvé spomienky, ktoré sa vám vybavia v súvislosti s farmou Mossbawn?	Wachtel: You were born at Mossbawn Farm in County Derry, Northern Ireland, and you say these details are retold so often in introductions and bios that you can scarcely believe them yourself anymore, but all the same, what are your earliest memories of Mossbawn Farm?	-0.0960399
Kontakt mojej nohy s podlahou je prvá spomienka, ktorá sa mi spája s farmou Mossbawn v okrese Derry (alebo skôr išlo o miesto položené o niečo vyššie).	Well, my earliest memory is of my foot touching the ground of Mossbawn, the County Derry earth, or rather a floor laid above the earth.	0.377885
Ležal som v postieľke, ktorú zhotovil tesár. ~~~ Spodnú časť postieľky tvorili drevené latky a malé hladké dosky.	I was in a cot made by the local carpenter, and the bottom of the cot consisted of slats of timber, little smooth boards laid on kind of ledges.	-0.0270292
Dosky neboli pribité zrejme preto, aby sa dali zodvihnúť, keby ste ich chceli vybrať, keďže deti na ne močili, ak aj nie niečo horšie.	They weren’t nailed down; obviously you wanted to be able to lift them because the children would be peeing on them or doing worse.	0.291743
Pamätám si, že ja sám som zodvihol jednu alebo dve zo spomínaných dosiek a cez spodnú časť postieľky som stúpil na hladkú chladnú betónovú podlahu nášho domu.	I remember lifting one or two of those boards and stepping off the bottom of the cot down onto the smooth, cool cement floor of the house.	0.246903
Stále niekde v mojom vnútri cítim niečo z toho malého chlapca.	And I can still feel my little foot inside my old foot here.	0.27551
Nepochybne, toto je moja prvá, prvučičká spomienka.	So that’s my very first memory, undoubtedly.	0.246154
Náš dom mal slamenú krytinu, bielu omietku, bol klasickým vidieckym statkom tejto doby, dlhý a nízky. Bol súčasťou typického dedinského Írska.	The house was a typical thatched, whitewashed, long, low country farmhouse of that era, part of the vernacular architecture of rural Ireland.	0.431405
Dom mal výhľad na miestnu cestu, ktorá bola súčasťou okresu.		-0.3
Za ňou sa o jedno pole ďalej nachádzala železničná trať s názvom Londýnska, Vnútrozemská a škótska železničná spoločnosť, ktorá ukončila prevádzku niekedy koncom päťdesiatych rokov alebo začiatkom šesťdesiatych rokov.	It faced out to the local county road, and behind it, one field away, was the railway called the London, Midland, and Scottish Railway, which stopped operating sometime in the late 1950s, early 1960s.	0.260714
Ale v rokoch štyridsiatych sa tadiaľto vlaky preháňali jedna radosť. ~~~ Silný hluk tohto parného stroja sa k nám doniesol cez pole až do stanice Castledawson.	But through the 1940s, the trains were running, and the big powerful noise would come over the field of a steam engine shunting up to the station at Castledawson.	-0.0011194
Myslím, že o mojom detstve by som mohol hovoriť až do súdneho dňa a stále by som mal čo povedať.	I mean, I could talk about this till the cows came home.	0.0913043
Doma sme kravy chovali v maštali na druhej strane dvora.	There were cows at home in the byre across the yard.	0.265116
V stajni, ktorá sa nachádzala pod strechou obytného domu, sme mali koňa.	There was a horse in the stable.	-0.0888889
Často to bolo veľmi upokojujúce počúvať jeho erdžanie zo stajne na druhom konci domu. ~~~ Oheň v kozube sme síce nemali, ale to, čo sme mali, bola voda z čerpadla.	The stable was under the roof with the dwelling house, and one of the big comforting sounds quite often was the horse going nhrrrrrin the stable at the other end of the house.	-0.011194
Okolo celého domu sa nachádzali studne s vodou. ~~~ Slamená krytina, voda zo studne, konské záprahy, pluhy a mnohé iné veci.	We didn’t have a fire on the hearth, but we did have water from the pump, and there were wells around the place.	0.0452233
Keď sa na to pozriem spätne, mám silný pocit, že všetky tieto vymenované veci už naozaj patria do inej doby.	What with thatch and well water and horse-drawn vehicles and horse ploughs and so on, when I look back on it, there’s a strong sense that it belonged in another age, really.	0.123333
V Mossbawne sme viedli prostý život.	We lived a kind of Arcadian life in Mossbawn.	0.24375
Ak by ste však žili vo Varšave alebo v Londýne, v Birminghame alebo dokonca v Belfaste, ktoré boli počas vojny bombardované, potom by ste určite mali úplne inú predstavu o svete tej doby a vaše stanovisko by bolo neistejšie.	If you’d been living in Warsaw or London, or Birmingham, or even Belfast where they were bombed during the war, you’d have a very different sense of what the world was, and maybe your make-believe would have been more defensive.	0.370187
Pri tejto príležitosti vždy citujem Williama Wordswortha, zamýšľajúc sa nad jeho detstvom než odišiel na internátnu školu: "Čisté obdobie môjho zrodenia si získalo moju dušu. Preto som vyrástol posilnený nielen krásou, ale aj strachom."	But I often quote William Wordsworth thinking of his childhood before he went to boarding school: "Fair seed-time had my soul, ” he says, "and I grew up / Fostered alike by beauty and by fear.	0.212658
V skutočnosti každý strach, ktorý som prežíval, bol skutočne mocnou hrôzou.	And actually any fear I had was on the whole elemental fear.	0.204
Wordsworth mal strach z lesov, no a ja som sa bál žiab a potkanov, nehovoriac o rozmnožovaní žiab, čo som spomenul aj v mojej prvej básni Smrť prírodovedca.	Wordsworth was afraid in the mountains, I was scared by frogs and rats and frogs spawning, which went into my first poem, "Death of a Naturalist.	0.499908
Takýchto spomínaných vecí bolo všade plno.	”That kind of thing was all over the place.	0.283333
Jednoducho išlo o obavy typické pre detstvo prežité na dedine.	The usual rural childhood anxieties.	0.109091
Vo svojej podstate to bol vlastne bezstarostný život až do mojich dvanástich, keď som odišiel do internátnej školy.	But generally it was a very secure time up till the age of twelve, when I went to boarding school.	0.386645
Wachtelová: Čo sa vám zdalo strašidelné na trení žiab?	Wachtel: What frightened you about frogs spawning?	0.286667
Tak dobre. ~~~ Chodil som dole do tejto oblasti, kde sa nachádzala ľanová priehrada. ~~~ Tu reálne žili aj tie stelesnené potvory s pulzujúcimi krkmi ako sa hovorí aj v jednej z mojich básní.	Well, I went down into this area where there was a flax-dam, and they were there as physical creatures with their necks pulsing, as I say in the poem.	-0.118699
Dookola kvákali. ~~~ Bol to jeden z tých hrozivých zvukov doslova vytvárajúci až akýsi zbor. ~~~ A to ma desilo.	They were croaking, and it was a very kind of sinister croak, a kind of chorus of croaking, and it just was scaresome to me.	-0.0577436
V básni som to trochu zdramatizoval.	I dramatized it a little in the poem.	0.290323
Uviedol som v nej, že som zutekal, ale aby som bol presný, iba som sa otočil.	I said I ran away, but I certainly turned.	0.06
Naháňali mi strach.	I was afraid of them.	0.3
Neviem celkom presne, koľko rokov som vtedy mal.	I don’t quite know what age I was.	0.15
Možno päť, možno šesť alebo sedem. Ako som už povedal, nie som si tým istý, ale to nemenilo nič na mojej veľkej a ozajstnej fóbii zo žiab a zvuku, ktorý vydávali.	Maybe five, six, seven, I don’t know, but the sense of the gross, physical frogginess of them all and the sound they made.	0.20495
Krajina, z ktorej pochádzate, sa často objavuje vo vašej poézii a próze.	Wachtel: The land around you comes up frequently in your poetry and your prose.	0.275806
Ako veľmi je pre vás toto prostredie dôležité, keď sa pozriete späť na vaše detstvo?	How important is that physical environment when you look back on your childhood?	0.291304
Heaney: Pre mňa to znamenalo celý svet.	Heaney: For me it was all-important.	0.709821
Keď nad tým teraz premýšľam, sú to viac pocity ako myšlienky, ktoré sa mi stále vracajú.	When I think back, it’s sensation, really, rather than intellection that returns to me.	0.495946
Cit pre určité miesta.	A feel for places.	0.225
Zastávam názor, že telo si veľa vecí uchováva vo svojej pamäti.	I mean, the body stores so much.	0
Napríklad si pamätám, ako sa moja ruka dotýkala držadla na konskom pluhu, pamätám si otcovu ruku nad tou mojou, ktorá mi pomáhala riadiť pluh správnym smerom.	I can remember holding the handles of a horse plough, for example, with my father’s hands over my hands to help me guide it.	0.205882
Keď radlica narazila o malý kamienok v brázde, ten sa vrátil späť cez držadlá až do vašej vlastnej dlane v podobe cengnutia.	When the ploughshare would hit a small stone in the furrow, that travelled back up the handles through the grip into your own hand like a little bleep.	0.239423
Stále si to pamätám, ale na tom asi nie je nič zvláštne, však?	I still remember that, but I think that’s not uncommon, is it?	0.294118
To, čo si pamätá naše telo, je veľmi dôležité a ja si myslím, že iné telesné pocity môžu tento dojem neskôr prinavrátiť späť.	What is stored bodily is very important for memory, and I think that other bodily sensations later on can bring it all back.	0.297087
Wachtelová: Pamätám si ten obraz konského pluhu vo vašej básni Nasledovateľ.	Wachtel: I remember that image of the horse plough in your poem "Follower.	0.280952
Nie je to len krajina, ale aj nástroje, čo robí vaše básne takými živými – a to môžeme pozorovať už od vašich prvých básní, medzi ktoré patrí aj báseň Kopanie, až po tie najnovšie.	It’s not just the land but the tools for engaging with it that are so vivid—from your earliest poems, such as "Digging, ” right up to recent ones.	0.333448
Áno, to je pravda.	Yes, that’s true.	0.3
Moja hlava je plná stredovekého náradia, ako napríklad dvojručné pritĺkacie kladivo, železné klince, ktoré sa zatĺkali do steny, alebo konský chomút a mnohé ďalšie.	My head is furnished with medieval tools like sledgehammers and iron spikes to drive into walls and horse collars and so on.	0.190385
Niečo vo mne na tieto veci silno reaguje rovnako navonok, ale aj vnútorne.	There’s something in me that responds very physically and emotionally to them.	0.27619
Je to, akoby tieto veci človek vedel oveľa lepšie pochopiť, keď sa daných predmetov dotkne rukou, alebo keď ich vysloví.	It’s as if one has a better grip on things when I get my hand or my tongue around those particular objects.	0.248276
V mojej poslednej knihe som napísal báseň o ťažkom kladive udierajúcom po kolíku. ~~~ Myslím si však, že to nebol len ten stelesnený dojem, ktorý som chcel touto básňou dosiahnuť.	In my last book I did a poem about a sledgehammer hitting a post, but I think it wasn’t just a physical sensation I was trying to get at.	0.0293745
Hovorilo sa v nej o úplnom využití nemilosrdnej, hrubej sily.	It was about the full exercise of merciless, violent power.	0.288235
Pri spomínanej básni som sa nechal inšpirovať Irakom.	It was a poem written after Iraq.	0.0964286
Referencie z tohto štátu by ste v nej však hľadali márne. ~~~ Ide tu skôr o pocit previnenia, keď bezvýhradne a neľútostne mlátite kladivom či udierate do slepého miesta.	There were no Iraq references in it, but it is about the sense of transgression you have when you utterly, mercilessly use a sledgehammer, even when hitting a dead post.	0.00591398
Cítite pritom nespútaný hnev a nemilosrdnú krutosť k tomu, čo ste chceli dosiahnuť.	There’s a kind of unrestrained fury, an unforgiving brutality to it that I wanted to get.	0.501786
Z toho dôvodu si myslím, že je možné prenášať vnemy, a zároveň dúfam, že rovnako aj navrhovať a ovplyvňovať dôsledky toho, čo sa môže stať.	So I think that you can transmit sensation but hopefully suggest and effect a consequence as well.	0.34739
Wachtelová: Váš otec bol obchodník s dobytkom.	Wachtel: Your father was a cattle dealer.	0.258333
Môžete mi o ňom povedať zopár slov?	Can you tell me a bit about him?	0.253846
Heaney:Jeho práca alebo povolanie si vyžadovalo chodiť na cesty po jarmokoch, kde kupoval dobytok a potom ich priviezol naspäť domov, alebo ich dodával iným farmárom.	Heaney:His work—his calling, really—involved him going out on the road to fairs, buying cattle there, and then bringing them back home and supplying other farmers.	0.293571
Prijímal však aj objednávky od miestnych poľnohospodárov. ~~~ Fungovalo to asi tak, že sa vybral na trh s cieľom kúpiť dobytok za vopred určenú cenu, potom sa vrátil späť, aby ho mohol predať aj so ziskom.	Or he would get orders from local farmers and would go to the fairs to buy the beasts at a certain rate and bring them back and sell them at some profit or other.	0.0350575
Môj otec bol teda priekupníkom medzi malými poľnohospodármi a inými obchodníkmi s dobytkom.	So he was a kind of middleman between small farmers and other cattle dealers.	0.445055
Teraz hovoríme o kultúre, ktorá úplne vymizla z našich životov.	We’re talking about a culture now that has gone completely.	0.276471
Myslím, že dnes neexistujú jarmočné dni v takej podobe, ako keď miestni ľudia hnali svoj dobytok na hlavnú ulicu v danej dedine. Na tomto mieste sa konalo veľké zhromaždenie každý prvý pondelok v mesiaci alebo každý druhý utorok v mesiaci.	I mean, there are no fair days in the way there used to be when local people drove the cattle into the main street of the local village, and there was a big assembly on the first Monday of every month or the second Tuesday of every month or whatever.	0.298507
Dnes, ale už aj počas neskorších dní života môjho otca, dohadovania tohto typu prebiehajú v aukčnej sieni.	Now, and in the later days of my father’s life, all that negotiation is done in auction rings and it’s much more corporate.	0.263736
Má to však, viac-menej spoločenský charakter.	What he did was find individual beasts and make individual deals at the fair and then on the farm.	0.00731707
Môj otec mal na starosti nájsť individuálne zviera a urobiť konkrétny obchod najprv na jarmoku a potom neskôr na statku.	He was a very good judge of cattle and was much sought by people who wanted decent stock, and I suppose he was trusted also.	0.439887
Bol veľmi dobrým znalcom dobytka, vďaka čomu ho ľudia, ktorí mali záujem o kvalitný tovar, veľmi často vyhľadávali.	Wachtel: You’ve described him as a solid, quiet country man with country confidence.	0.193151
Predpokladám však, že išlo aj o dôveru.	So he didn’t say that much?	0.156522
Wachtelová: Opísali ste ho ako tichého spoľahlivého vidieckeho muža, ktorý si vyslúžil dôveru u dedinčanov.		-0.3
Váš otec toho asi veľa nenahovoril, nemám pravdu?		-0.3
Nie, to teda nenahovoril.	No, he didn’t speak that much, no.	0.221739
Často spomínam, že on považoval reč za istý druh pretvárky.	I’ve often said my father regarded speech as a kind of affectation.	0.264706
Mal dojem, že výpoveď má pozostávať z veľkého množstva dobrého úmyslu a dobrých pocitov.	He suspected the statement of too many good intentions and good sentiments.	0.249231
Predpokladal, že intuitívne konanie je to skutočné.	He assumed that intuitive transmission was the real thing.	0.267391
Ak bolo niečo príliš prehnané, mal sklon sa veciam takéhoto typu vyhýbať.	If it was overstated, he tended to shy away from it.	0.160465
Wachtelová: Pod slovom prehnaný ste asi mali na mysli skôr niečo ako oficiálny.	Wachtel:By overstated you mean stated.	0.0171429
Ale, samozrejme.	Yes, indeed.	0.2
Každé vyhlásenie je do istej miery zveličené. V tom máte pravdu.	Statement was overstatement to some extent, that’s right.	0.276471
Wachtelová: Keď váš otec v roku 1986 zomrel, povedali ste, že ste stratili ochranný štít nad vašou hlavou.		-0.3
Čo ste chceli konkrétne týmto výrokom povedať?		-0.3
Myslím, že som mal vtedy 47 rokov.		-0.3
Moja mama odišla z tohto sveta v roku 1984. Otec ju o dva roky neskôr nasledoval.	Wachtel: When your father died in 1986, you said the roof came off the world.	0.285937
Myslím, že to nie je ničím zvláštna skúsenosť.	Can you tell me what in particular that meant for you?	0.2625
Jednoducho, ste ďalší na rade.	I was forty-seven, I think.	0.2625
Už nie je nad vami nikto, keď hovoríme o veku alebo o slove rodič.	My mother died in 1984, and my father died a couple of years later.	0.294444
To sa odrazilo v mojom osobnom živote, o pár rokov neskôr som zažíval úžasnú vlnu v písaní. ~~~ Písal sa konkrétne rok 1988, 1989, keď som napísal sériu básní s názvom Štvorhrany. ~~~ Boli to veľmi voľné básne.	And I think maybe that’s just a common experience; that you are next in line, there’s nothing over your head in terms of age, in terms of a parent.	-0.123333
Vznikli z obrazu starého zničeného domu bez strechy, z ktorého nezostalo nič, len jeho základy, alebo znázorňovali žobráka stojaceho pred dvermi.	It coincided in my own life with a wonderful bout of writing a couple of years later—1988, 1989—a sequence of poems eventually called Squarings.	0.290164
Predpokladám, že táto konkrétna predstava ma úplne ovládla – myšlienka nezastrešeného priestoru a tvora, stelesnenú dušu, medzi ktorými nie je nič len nekonečnosť.	They were terrifically free, and they began with an image of an unroofed wall-stead of an old ruined house and an image of the soul as a beggar standing in the doorway.	0.416304
Všetky predošlé formácie a náboženské predstavy, ktoré mi predtým stelesňovali život a smrť, zmysel života na tejto planéte ako aj posmrtný život. ~~~ Toto všetko sa akoby šibnutím čarovného prútika opäť pomiešalo.	I suppose that particular image began to take hold of me— the idea of an unroofed space and the creature, soul-body, down here with nothing between it and the infinite.	-0.0166667
Pre kohokoľvek z mojej generácie, ale hlavne čo sa týka generácie írskych katolíkov, bola duša ako malá biela nepoškvrnená vreckovka, ktorú si však človek mohol svojimi hriechmi zašpiniť.	And all the early formation, all the early religious imagery that I got for life and death, for the meaning of your life on earth and then your afterlife, all that somehow was stirred again.	0.292357
Oveľa dôležitejším bol ale ten zmysel, že celý vesmír riadi Boh, že božská pozornosť sa orientuje nielen na vesmír, ale aj na nás samotných.	For anybody in my generation, certainly in the Irish Catholic generation, the soul was like a little white handkerchief, unstained, and you would stain it with sin and so on.	0.228814
Si ako malá kvapka vody v nekonečnom oceáne, si len malou škvrnou v celej schéme vecí.	But more important was the sense that the whole universe was governed by the deity, that there was divine attention being paid not just to the universe but to you yourself.	0.00416667
Pri tom všetkom na nás niekto striehne a to nielen v zmysle ochrany, ale aj kontroly nad tým, či nepáchame niečo zlé.	You’re like a little drop of water in this great ocean, you’re a little speck in the whole scheme of things: nevertheless, you are being watched over, and watched over not only in terms of care but in terms of supervision to see you do nothing wrong.	0.226849
Rovnako existovala aj predstava, ktorej sa moja generácia drží už dosť dlho, že na konci našej púte po tejto Zemi nás čakajú dva súdy.	And there was this idea, and my generation got it very early, that there would be two judgments at the end of your life.	0.257143
Po prvé, budeme po ukončení nášho osobného života vyhnaní do večnosti, kde sa podrobíme osobitnému súdu, na ktorom si prezrieme celý náš život. ~~~ Výsledkom budú odmeny, tresty alebo pokánie.	First, at the end of your particular life, you would be whipped away into eternity and you would undergo a particular judgment; your own life would be scanned, and rewards or punishments, or atonement, would be the result of that.	-0.0266871
Potom na konci všetkého nás opäť čaká všeobecný súd, kde sa vo väčšej miere o všetkom rozhodne.	Then again at the end of time, there would be a general judgment, and the whole thing would be ratified on a larger scale.	0.225
Myslím, že každý, kto si takým niečím prejde, bude navždy poznačený.	Anybody who undergoes that is marked by it forever, I think.	0.252941
Vôbec nezáleží, aká forma sekularizácie sa objaví, už od začiatku je tu obrovská súradnica vytvorená pre naše vedomie. ~~~ Táto predstava lesknúceho sa vonkajšieho rámu na každej jednej veci je vždy súčasťou vašej predstavivosti. ~~~ Možno nasledujúci výrok všetko vysvetlí.	And no matter what kind of secularization occurs, there is a huge coordinate established for consciousness from the beginning, that sense of the outer shimmering rim of everything always being there in your imagination.	-0.104813
Duša je po smrti vyhnaná preč z tohto sveta. ~~~ S ňou sa zároveň stratí aj strecha nad hlavou a vy ste vystavení tej nekonečnosti, ktorá sa objaví po smrti vašich rodičov.	Maybe that explains it—the soul being whipped away and the roof coming off and you being exposed to that infinity that occurs after the death of your parents.	-0.0102273
Wachtelová: Spomenuli ste, že základ vašej viery bol silný bez ohľadu na sekularizáciu, ktorá sa neskôr objavila. Ale boli ste veriaci už aj v tom čase?	Wachtel: You mention that this foundation was so strong regardless of the secularization that occurred later, but were you a believer at the time?	0.290323
Možno som mal už niečo po dvadsiatke – teda až do tejto doby som bol rozhodne súčasťou írskeho katolicizmu.	I don’t know what I believe anymore, but I was part of the Irish Catholic machinery until my late teens, early twenties, definitely.	0.23
Čo sa týka sviatosti oltárnej a jej premeny, tak tieto veci mi do istej miery nedali spávať.	The matter of the sacraments, transubstantiation for example, gave me trouble at a certain stage.	0.460227
Myšlienka, že môžeme prostredníctvom modlitby získať zásluhy pre nás a druhých ľudí, že aj sebaobetovanie má duchovný zmysel. Teda celá táto nadprirodzená ekonomika sa mi veľmi pozdávala.	But the idea that you could gain merit through a system of grace and you could gain merit for other people, that self-denial had a spiritual meaning, and that there was a whole supernatural economy, that had strong appeal to me.	0.357143
Samozrejme, že človek stále žije v pochybnostiach ako povedal John Keats, ale môže žiť rovnako v pochybnostiach ako aj vo viere. Myslím si však, že obe možnosti majú svoje úskalia.	Of course you dwell in doubts, as John Keats says, and you can dwell with doubts as well as with beliefs, but I think that all that was shaken.	0.306897
Keď opustíte tu kostolnú atmosféru a zrazu je z vás dospelý človek na univerzite, náhle sa ocitnete na hranici dvoch svetov.	When you left the church atmosphere and grew into adulthood, at university, you were between worlds again.	0.253846
Na jednej strane viete, že patríte do toho katolíckeho, stredovekého sveta s Chaucerom a Dantem. ~~~ Ale na strane druhej žijete v post-freudovskom a post– lawrenskom svete.	You knew that you belonged in a Catholic, medieval, Chaucerian, Dantesque world, and at the same time you were dwelling in a post-Freudian, post–D. H. Lawrence world.	0.087367
Jedna časť z vás má skúsenosť s vierovyznaním, so spovedaním sa z hriechov, ktoré sú dôvodom našej nečistoty. ~~~ Naša druhá časť píše eseje typu D. H. Lawrenca a vyzdvihuje temné božstvá a zmyslové reality života, ktoré Lawrence vyjadroval.	One part of you had the experience of going to confession and confessing sins of impurity, the other part of you is writing essays about Lawrence and commending the kind of dark gods and the sensual realities of life that he expressed.	-0.00615385
Wachtelová: Nedá mi neopýtať sa: Povedali ste niekedy svojmu otcovi, že ho milujete?	Wachtel: I have to ask you, did you ever say to your father that you loved him?	0.257812
Ako viete, že sa to týkalo môjho otca?	How do you know that’s my father?	0.257143
(smiech) Wachtelová: Máte pravdu.	[laughs]Wachtel: You’re right.	0.27931
Priznávam svoju vinu.	Guilty as charged.	0.247059
Heaney: Nespomínam si.	Heaney:I don’t remember.	0.271429
Tento druh slovníka by môj otec považoval za veľmi podozrivý.	That kind of language would have been much suspect.	0.238636
Vedeli sme, že sa máme radi.	We knew love.	0
Nemalo zmysel to aj vyhlasovať.	It wasn’t a matter of declaring it.	0.278571
Stačilo, že sme si lásku dokazovali.	It was proven.	-0.138462
Wachtelová: Z vašich opisov o domove usudzujem, že ste asi nemali k dispozícii veľa podkladov na čítanie.	Wachtel: From your descriptions of home, there wasn’t a lot of reading material at hand.	0.24
Kedy nastal vo vašom živote ten zlom, že ste sa začali zaujímať o poéziu?	When did you first become interested in poetry?	0.153659
Nie je poézia ako poézia.	Well, poetry as "poetry.	0.3
Spočiatku som mal veľmi blízko k recitácii.	”Early on I was familiar with recitation.	0.283333
Ako deti sme si doma robili malé vystúpenia, na ktorých sme recitovali to, čo sme sa naučili v škole.	We had little concerts at home as children, where we recited poems we’d learned at school.	0.268421
V tom čase nás na Vianoce a na Veľkú noc navštevovali priatelia mojich rodičov, s ktorými sme spievali pesničky. ~~~ Neskôr, keď som vyrástol, ma požiadali, aby som prednášal.	Then at Christmas, and at Easter, elder friends of my father’s and mother’s would be in, and there would be sing-songs; and as I came into adolescence I would be asked to do a recitation.	-0.00714286
Vedel som niekoľko básní, ako napríklad Ako zastrelili Dannyho McGrewa, Prekliatie Yukonu, Kremácia Sama McGee od Roberta Service a takisto básne od írskeho autora Percyho Frencha, ktorý písal podobným spôsobom ako Robert Service.	I knew several, such as "The Shooting of Dan McGrew” from Robert Service, "The Spell the Yukon, ” "The Cremation of Sam McGee, ” and then an Irish writer called Percy French who wrote that kind of thing also.	0.339112
Predpokladám, že to všetko začalo, keď som nastúpil na strednú školu a začal som sa zoznamovať s anglickou literatúrou ako s predmetom.		-0.3
Čo sa týka jazyka, niečo vo mne ožilo, prebudilo sa, alebo sa pohlo. ~~~ Spôsobili to najmä spisovatelia ako John Keats, Gerard Manley Hopkins a tak ďalej.	But it was when I went to secondary school, I suppose, and began to get into English literature and poetry as a subject, that something came alive in me to the language, something wakened or was stirred, especially by poets like John Keats, Gerard Manley Hopkins, and so on.	0.31328
Na vysokej škole tento vedomý pôžitok z jazyka ešte zosilnel, ale pri poézii som bol vždy nesmelý.	In university, that conscious relish of language became stronger, but I was always shy of "poetry.	0.296386
Celkom presne som nevedel, čo to malo znamenať.	”I didn’t quite know what it was.	0.160714
Mal som však pocit, že je správne byť nesmelým, pretože nikto poriadne nevie, čo poézia znamená.	And I think it was right to be shy of it, because nobody knows quite what it is.	0.215625
Stále si nie som istý.	I’m still not sure.	0.264706
Písal som si nejaké básne asi ako každý vysokoškolák, ale nebolo to skôr ako v mojich dvadsiatich dvoch alebo dvadsiatich troch rokoch. Písal sa vtedy rok 1962, keď sa vo mne, takpovediac, niečo zlomilo.	I wrote some poems as every literary undergraduate does, but it wasn’t until I was in my twenty-second or twenty- third year, 1962, that "that something” started in me.	0.33617
Hovorím to často, ale môže za to čítanie poézie Patricka Kavanagha, írskeho básnika, s rovnakým pôvodom ako ja. Zrazu som z neho pocítil obrovský príval energie ako aj z Teda Hughesa, ktorý sa opäť dotkol vecí, o ktorých som si myslel, že sú známe len mne, a to napríklad ako mŕtve ošípané ležiace na fúriku, býky v maštali alebo v stodole.	I’ve said this often, but it came from reading poetry by Patrick Kavanagh, an Irish poet with the same kind of background as myself, a wonderful sudden burst of energy from him; and likewise from Ted Hughes, who again touched on subjects that I thought were known only to me, such as dead pigs lying in barrows, and bulls in outhouses, and barns and so on.	0.38503
Bral som to ako oprávnenie k písaniu.	So that was, as they say, permission.	0.3
Počas štúdia na Kráľovninej univerzite som bol, ako už iste tušíte, vedený k súčasnej poézii. Čítal som teda Eliota či Audena.	As an undergraduate at Queen’s University, of course I had been lectured on contemporary poetry, and I had read Eliot, I had read Auden.	0.280374
Zabudol som poznamenať, že bežný verš vtedajšej poézie bol mestský, ironický a nestranný.	But I had also swallowed the standard line that contemporary poetry was urban, ironical, detached.	0.273077
Myslím, že pri básňach od Elliota som mohol byť poslucháčom, ale nespôsobili ani vo mne neprebudili nič zvláštne, tak ako to urobili iné hlasy.	I mean, the intonations of Eliot I could hear as a listener, but they didn’t enter me or waken anything in me in the way these other voices did.	0.289744
Takže, keď som v roku 1962 začal písať, bol som už presvedčený siahnuť s odhodlaním po niečom väčšom.		-0.3
Wachtelová: Keď ste písali počas vysokej školy, bolo to pod pseudonymom Neistý alebo Nerozhodný.	So once I started in 1962, I was bitten and kept going back for more.	0.15
A až potom, keď ste sa nejakým spôsobom utvrdili, že môžete veriť svojim vlastným skúsenostiam z vidieckeho života, tak ako ste sám povedali Ted Hughes, Patrick Kavanagh alebo dokonca Robert Frost vám dali povolenie.	Wachtel: When you were writing as an undergraduate, you went under the name of Incertus or Uncertain, and then when you got this kind of affirmation to trust your own experience of rural life through, as you say, Ted Hughes or Patrick Kavanagh or even Robert Frost, it gave you this permission.	0.545031
Spomenuli ste však, že žiadne miesto na celom svete sa nemôže viac pýšiť svojou ostražitosťou a realistickým prístupom ako práve Severné Írsko. ~~~ Mňa zaujíma ako, vás táto skutočnosť ovplyvnila pri vašej práci.	But you say that no place in the world prides itself more on its vigilance and realism than Northern Ireland, and I wondered how you felt that influence on your own work.	-0.0207317
Heaney:Toto by bolo veľmi náročné na rozoberanie.	Heaney:It would be very hard for me to analyze that.	0.3
Ja osobne si myslím, že som sám opatrný a tiež trochu skeptický.	I take it that I am vigilant myself and a bit skeptical, and I hope merrily so, so that’s part of the makeup.	0.34188
Dúfam však, že je to súčasť mojej povahy.	And allowing yourself to get through that is part of the action.	0.470476
Avšak dôležité je pripustiť sebe samému, že priblížiť sa k týmto vlastnostiam sa dá aj prostredníctvom činov.		-0.3
Myslím si, že zabúdanie na svoju prítomnosť, sebanadchýnanie je súčasťou činu - písania, samozrejme písania veršov.	I think that self-forgetfulness, self-entrancement, is part of the action of writing, certainly of writing verse.	0.293939
Vo svojom vnútri, zotrvávať v tichu pri nejakej činnosti vo svojom vnútri, zabudnúť na to, že sme súčasťou práve daného momentu, tomu sa hovorí úspech, splnené prianie.	To dwell silently on something within yourself, to forget that you are there watching yourself in action, that’s the achievement and that’s the desire.	0.267442
Dnes naozaj veľa ľudí prežíva svoje zážitky pred obrazovkou.	And I think nowadays a lot of people really experience that in front of a screen.	0.220755
Počítač sa stal naším prostriedkom na uchvátenie.	A computer screen is an entrancement device.	0.261538
Sivá žiara sa do istej miery stala hypnotizujúca.	It’s kind of hypnotic, that grey glow.	0.209091
Nikdy by som nezačínal s písaním svojich básní na počítači.	Not that I would begin poems on the screen.	0.175
Som skôr prepojený s rukoväťou môjho plniaceho pera.	I have a connection to the shaft of the fountain pen still.	0.280435
Rád totiž začínam písať na hárok bieleho papiera so žiarivým atramentom a až potom si užívam to zadosťučinenie pri prepisovaní svojich veršov do počítača.	I like to get started on white paper with ink gleaming, and then I like the reward of putting it out onto the screen and then hard copy and then fiddle away with that.	0.413182
Nakoniec vytvorím ich trvalý záznam, ale neprestávam sa s nimi pohrávať.		-0.3
Wachtelová: Istý čas ste boli súčasťou literárneho sveta v Severnom Írsku. V rokoch šesťdesiatych a sedemdesiatych v ňom mala poézia isté miesto.	Wachtel: You were part of a literary world in Northern Ireland for a while; there was a certain poetry scene in the 1960s and 1970s.	0.386398
Potom ste na rok odišli do Kalifornie.	Then you went to California for a year.	0.3
A keď ste sa vrátili naspäť do Severného Írska, vzdali ste sa vyučovania a presťahovali ste sa na juh do Írskej republiky.	But when you came back to Northern Ireland, you gave up teaching and moved to the south, to the Republic of Ireland.	0.28125
Objavilo sa to na titulnej strane novín The Irish Times.	It made front-page news in The Irish Times.	1.21081
Čo vás dohnalo v roku 1972 k tomuto kroku?	What prompted this move in 1972?	0.225
Heaney:	Heaney:	1.8
Rok, ktorý som strávil v Kalifornii, znamenal pre mňa veľa.	I had a year in California that meant a lot to me, I have to say.	0.3
To musím priznať. ~~~ Písal sa rok 1970, 1971, keď práve zúrila Vietnamská vojna, jednoducho stred konktrakultúrneho momentu.	That was 1970, 1971, right in the middle of the Vietnam War, the middle of the countercultural moment.	0.191279
Hrôzostrašné protesty.	Terrific protests.	0.233333
Celé územie zálivu bolo skutočne konktrakultúrnou oblasťou.	The whole of that Bay area was really a countercultural area.	0.288462
Len si zoberte také gangy ako Čierni panteri či Hare Krishna, a už vôbec nehovoriac o voľných odevoch či nelegálnych látkach.	You had the Black Panthers, you had the Hare Krishna, you had the loose garments, you had the illegal substances.	0.550977
V areáli univerzity ste sa mohli stretnúť so všetkými druhmi vôní, rétoriky a protestov.	You had all kinds of fragrances on that campus, all kinds of rhetoric, all kinds of protest.	0.296053
Básnici boli toho všetkého súčasťou.	And the poets were very much involved.	0.3
Veď rok, ktorý som tu strávil, mi boli Robert, mám na mysli Roberta Duncana, a taktiež Gary Snyder na blízku.	The year I was there, Robert Bly was up in Inverness, just a little north of Berkeley; Gary Snyder was there, Robert Duncan.	0.689011
V tom čase žili konkrétne v meste Inverness, ktoré sa nachádza niečo severne od Berkeley.		-0.3
Keď som sa vrátil do Belfastu, bol som utvrdený v myšlienke, že sa môžem vrátiť späť na katedru angličtiny, pretože posledné slová z úst vedúceho katedry boli: "Ak kedykoľvek budete potrebovať vrátiť sa, u nás budete mať dvere vždy otvorené."	When I came back to Belfast, I was first of all fortified in the knowledge that I could go back to the English department, because the last thing the chairman said to me was, "If you ever need to come back, you’d be very welcome.	0.270968
Bol to akýsi záchytný bod, ale v tom roku vo mne rástla aj vnútorná potreba poslania.	”There was that security blanket, and then there was a feeling of vocation that had grown in me during that year.	0.202817
Tým mám na mysli činnosti ako vyučovať na Kráľovninej univerzite v spomínanom Belfaste, dokončiť moju tretiu knihu ako aj pocit, že nastal čas osvedčiť sa aj ako spisovateľ.	I taught for another year in Queen’s University and finished my third book, and I got a feeling that it was time to declare myself as a writer.	0.223077
Cítil som, že musím ísť do toho.	So I thought, okay, go for it.	0.276
Odísť do Írskej republiky však nebola bezprostredná myšlienka jednej noci.	But there was no immediate plan at all that we would go to the Republic of Ireland.	0.290909
V lete 1972 sme spolu s Mary jazdili po severe a obzerali sme si okresy Derry, Tyrone a Antrim.	That early summer of 1972, Marie and I were driving around the north—County Derry, County Tyrone, County Antrim—looking at places.	0.319231
Z Kanady sme následne obdržali list od našej drahej priateľky Anny Saddlemyerovej vyučujúcej na Masseyskej vysokej škole, ktorá je súčasťou Torontskej univerzity.	Then from Canada, we got a letter from our dear friend Ann Saddlemyer, who was then teaching in the University of Toronto at Massey College.	0.235897
Ann vlastnila vidiecky dom v Írsku v okrese Wicklow južne od Dublinu.	She had this cottage in County Wicklow in the Republic, south of Dublin.	0.5206
Dom bol súčasťou starého pozemku spisovateľa Johna Millingtona Synga.		-0.3
Ann bola jeho študentkou a okrem toho vydávala aj jeho knihy.	It was on the old Synge estate—Ann was a scholar of Synge’s work, an editor.	0.486538
Napísala: "Donieslo sa ku mne, že zamýšľate na istý čas odísť z akadémie a taktiež, že sa obzeráte po nejakom dome.	She wrote, "I heard on the grapevine that you’re thinking of leaving the academy for a while and looking for a house.	0.433239
Mám stále ten dom v okrese Wicklow."	I’ve got this cottage in County Wicklow.	0.26129
Na Veľkú noc sme sa tam šli s Mary a deťmi pozrieť a rozhodli sme tam presťahovať. ~~~ Rezignoval som.	So at Easter, Marie and I and the kids went down to that cottage and we decided, yes, let’s make a go of it.	0.040796
Na konci augusta sme osedlali kone, naložili dodávku a vydali sme sa na cestu do domu v meste Glanmore, kde sme strávili celé štyri roky. ~~~ Nevrátili sme sa ani Kráľovninu univerzitu, a ani naspäť na sever.	I gave in my resignation, and in the month of August we saddled up, filled a van, and went down to the Glanmore cottage, stayed there for four years, and didn’t go back to Queen’s, didn’t go back to the north to dwell there at all.	0.0446109
Bola to pozitívna spleť Anninej dobročinnosti a pozitívneho rozvoja v našich životoch.	So it was a happy mixture of Ann’s philanthropy, as it were, and the growth point in our own lives.	0.511032
Wachtelová: V okamihu, keď ste sa presťahovali, zmenilo to váš pohľad na politickú situáciu?	Wachtel: Once you did make the move, did it change how you saw the political situation?	0.271233
Aký dopad malo presťahovanie sa do Írskej republiky na vašu rodinu?	What effect did it have on your family, to move to the Republic?	0.271698
Heaney: Nemyslím si, že sťahovanie nejakým spôsobom ovplyvnilo môj pohľad na politiku.	Heaney:I don’t think it had very much effect in terms of politics or anything like that.	0.291892
Mám dojem, že keby som zostal na severe, môj názor by sa nijako nezmenil.	I mean, if I had been in the north, my attitude would have been the same.	0.289831
Chcel som, aby moje deti naozaj zažili detstvo, aké som mal ja. ~~~ Mám na mysli, aby pri vyrastaní mali taký istý pocit dospievania za živým plotom, aby kdekoľvek padne ich zrak, mali neustále na očiach vtáčie hniezda, lístie, kvety a podobne.	I wanted the kids, really, to have the kind of childhood I’d had, I suppose; to share the feeling of growing up behind hedges and having eye-level contact with bird’s nests and leaves and flowers and so on.	-0.0211409
Niečo hlboko v mojom vnútri si vychutnávalo skromný život vo vidieckom domčeku, ktorý bol súčasťou môjho predošlého života, nemalo to však nič spoločné s clivosťou za domovom.	And there was something in myself that relished the frugality of life in the cottage, something that belonged in my first life, but it wasn’t a matter of fleeing the north.	0.285315
Nažívali sme si s rovnakou ľahkosťou ako v Belfaste, presne ako v rokoch, keď došlo ku konfliktu známym pod menom Konflikty v Severnom Írsku.	We lived as easily in Belfast as ever we had lived in the years leading up to the Troubles.	0.117568
Nešlo o pocit strachu či o vysilenie z daného miesta, ale ani o to, že by sa nás čas na predchádzajúcom mieste naplnil.	It wasn’t a matter of feeling scared or being hunted out of the place or shaking the dust of the place off.	0.262069
Predovšetkým malo ísť o voľbu, slobodu, možnosť výberu a o prijate niečoho iného.	It was very much to do with the option and the freedom of making a choice, embracing something different.	0.437143
V istom zmysle išlo o prvú voľbu, ktorú som urobil zámerne.	In a sense, it was the first choice I deliberately made.	0.280851
Vždy hovorím, že ja a Mary sme boli súčasťou generácie, ktorá mala dočinenia so štipendiom.	I’ve often said that Marie and I, we were part of the scholarship generation.	0.24
Dostávali sme ho najskôr na strednej škole, potom na univerzite a nakoniec sme dostávali štipendium aj pri vykonávaní praxe. ~~~ Neskôr sme začali učiť, zasnúbili sme sa, zobrali sme si hypotéku, postavili sme si dom a pomerne mladí sme si založili rodinu.	We got the scholarship to secondary school, we got the scholarship to the university, we got the scholarship to the teaching training college, we went into teaching, we got engaged, we got the mortgage, we got the house, we got the young family, and there we were.	-0.0027907
Takto plynul náš život. ~~~ Až Kalifornia bola akýmsi vybočením z tej pravidelnej čiary života, ktorý sme viedli.	California was the first step off the conveyor belt, and when we came back we stepped farther off it.	-0.0202703
Keď sme sa vrátili späť, odbočili sme od nej ešte viac.		-0.3
To bola tá sloboda.	So that was a freedom.	0.264706
Wachtelová: V niektorých vašich dielach sa vyskytujú odkazy na spomínané Konflikty v Severnom Írsku, i keď nie často v zmysle hlavnej myšlienky.	Wachtel: There are references to the Troubles in some of your work, but it’s not often there as a central focus.	0.2
Čo si myslíte o zodpovednosti spisovateľov za politiku svojej doby?	How do you see the responsibility of poets to the politics of their time?	0.289831
Heaney: Myslím, že toto je ten typ otázky, na ktorú som odpovedal veľmi často, doslova až do úmoru medzi rokmi 1969 - 1970 až 1989.	Heaney:I think that is a question that I kept answering ad nauseum between about 1969 or 1970 and 1989.	2.17326
Takmer každá próza, ktorú som napísal, a už vôbec nehovoriac o dielach napísaných vo veršoch, zobrazujú práve tento problém.	Almost everything that I’ve written in prose and much that’s in verse is about that question.	0.193671
Básnici tridsiatych rokov pôsobiacich v Anglicku túto situáciu pociťovali najviac.	Poets of the 1930s in England especially felt that.	0.0954545
Tým mám na mysli Spendera, Audena a napokon aj Louisa MacNeica, ktorý je samozrejme írskym básnikom, ale takisto aj súčasťou britskej generácie.		-0.3
Práve títo básnici sa museli vyrovnať so španielskou občianskou vojnou, s nárastom fašizmu a podobnými vecami. ~~~ I keď boli lyrickými básnikmi, mali aj svoje vlastné životy - lásku, túžbu, sex, čas, detstvo.	I mean, Spender, Auden, and Louis MacNeice—who’s an Irish poet of course, but part of that British generation—they had to deal with the Spanish Civil War, the rise of fascism, and so on.	0.066945
Súčasne popri tom všetkom zúrila neľútostná vojna a s ňou rástla aj potreba oddanosti.	They were lyric poets, they had private subjects.	0.0837209
Komunizmus ako ideológia prekvital. ~~~ U biednych dominovala oddanosť, ktorá ich viedla k práci.	They had love, Eros, sex, time, childhood, and yet there was the big war and the need for commitment.	0
Bola hlboká, morálna a podmanivá.	Communism was flowering as an ideology.	0.25
Taká bola príťažlivá sila, ktorá tiahla zúfalých ľudí našej planéty k práci.	The attraction of working for the wretched of the earth was deep, moral, and compelling.	0.259091
Čo mali lyrickí básnici žijúci si svoj život robiť?	So what was the private lyric poet to do?	0.211765
Mal sa on alebo ona pridŕžať výhradne svojich básnických tém, v ktorých sa orientovali na seba a krásu, alebo ich úloha mala oveľa širší význam?	Was he or she to just keep to the lyric matter of the self and beauty, or was there a bigger obligation?	0.298292
Ja osobne som mal po krk ortodoxného názoru, ktorý nám počas vysokej školy vštepovali.		-0.3
Myšlienku, ktorá hovorí, že je chyba, ak básnici vo svojich dielach zahŕňajú čokoľvek propagandistické alebo politické.	I grew up with an orthodoxy inculcated at the university that these poets made a mistake when they embraced anything propagandist or political.	0.251429
Myslím si, že pri rozlišovaní propagácie a politiky zavládol nielen v mojej, ale aj v hlavách mojich učiteľov, zmätok.	I think there was a confusion, perhaps, in my mind and in the minds of some of my teachers between the propagandist and the political.	0.420297
Čo sa politických záležitostí týka, tie boli v spojitosti s umením a poéziou vnímané ako slová nevhodné.	Political was kind of inculcated as a bad word in relation to art and poetry.	0.370312
V tomto prípade môžeme ako vynikajúci príklad uviesť básnika známeho pod menom W. B. Yeats, ktorý dokonca nesúhlasil ani s vyjadrovaním názoru vo verši.	Our great exemplar W. B. Yeats was ever against "opinion” in verse, but he was never afraid to deliver opinion.	0.466359
Na verejnosti sa však svoje stanovisko nikdy nebál vyjadriť.		-0.3
Neskôr som si uvedomil, že jeho rečnícke umenie a prax boli tak trochu v rozpore.	I realized later on that his rhetoric and his practice were slightly at odds.	0.286154
Som toho názoru, že s pribúdajúcim vekom by sme sa mali učiť, ako v našich dielach spracovať udalosti, ako napr. Konflikty v Severnom Írsku – bomby, zabíjanie či skutočnú podobu súčasného Severného Írska.	So over the years, I think we had to learn how to incorporate the matter of the Troubles—bombs, killings, the actual landscape of contemporary Ulster—into the kinds of things we were writing.	0.27764
Napríklad taká farma Mossbawn bola od obrovského rachotu posunovacej lokomotívy až po výbuchy áut, ktoré v Belfaste spôsobili rinčanie okien, či od udalostí známych ako Krvavá nedeľa a Krvavý piatok, ktoré sa odohrali v roku 1972, na míle vzdialená.	It’s a far cry from Mossbawn, if you like, from the big noise of the shunting of an engine to the explosions of car bombs rattling the windows in Belfast; Bloody Sunday to Bloody Friday, both occurring in 1972.	0.30737
Nikto z nás poriadne nevedel, ako sa má k tejto situácii postaviť.	None of us quite had got the way of handling it.	0.169231
Až oveľa neskôr som našiel spôsob, ako nechať prehovoriť niekoľko ľudí v básni s názvom Station Island. ~~~ Bol to vlastne dialóg medzi hlavným hrdinom - básnikom a niekoľkými duchmi, z ktorých časť bola zabitá počas už spomínaných Nepokojov v Severnom Írsku, a druhá polovica duchov bola súčasťou života v Írsku v 19. storočí. Samozrejme nesmel chýbať tieň Jamesa Joyca, ktorý varuje, že sa nemáme príliš často postaviť na niečiu stranu, že nemáme byť hlasom druhých ľudí, ale sústrediť sa na seba.	Many years later, I found a way of letting some people speak in a poem called "Station Island, ” which was a kind of a dialogue between a poet/protagonist and various ghosts—some who had been killed in the Troubles, some who had been involved in Irish life in the nineteenth century, and indeed the shade of James Joyce, who warns against too much side-taking, not to be the voice of any people, but to be your own voice.	0.0619359
Wachtelová:	Wachtel:	0.2
Keď sa teraz obzriete naspäť, nechcem tým samozrejme povedať, že by ste sa museli nejako veľmi zamýšľať nad správnosťou vašich diel, ale nedá mi nespýtať sa: "Myslíte si, že ste vždy kráčali správnym smerom?		-0.3
Veľakrát musela byť vaša cesta pekne tŕnistá a nebolo ľahké vybrať si ten správny variant." ~~~ Rozhodne mi neschádza na um nič nečestné z toho, čo som kedy napísal.	And when you look back now, not that you need to spend much time revisiting it in your own work, but do you feel you walked the right line?	-0.0334821
Možno to nepoteší každého, ale mne to nateraz úplne stačí.	I mean, it was at some times, I think, a fairly difficult path to negotiate.	0.494727
Čestnosť je tá najlepšia vec, ktorú môžete ako autor použiť.	Well, there’s nothing that strikes me as dishonest in anything that was written.	0.201923
Tým mám na mysli (smiech) písať poctivo, pokiaľ ide o tému, názory, ale aj z hľadiska toho, kým a čím v skutočnosti ste.	It may not have pleased everybody, but it pleased me enough to be going on with, and that’s the best you can do as a writer, I think [laughs]—to write honestly, honestly in terms of the subject and in terms of your attitudes, and in terms of who and what you are.	0.0795455
Ale aj keď hovoríme o tvorbe, umení, ktoré nie je sfalšované, ale zodpovedá pravdivej nápaditej odpovedi, ktorá nie je vyvolaná vašou vôľou, ale ktorá sa zrodí z niečoho, čo je vo vašom vnútri hlboko zakorenené.	And honestly in terms of your makings, in terms of the art, that it is not faked up, that it belongs as a true imaginative response, that it isn’t generated out of will but arises out of something more deeply lodged in yourself.	0.284831
Niečo vo mne vyvoláva pocit, že nech už bolo v mojich knihách napísané čokoľvek, či už správne alebo nesprávne, priemerne napísané, dobré alebo zlé, nemám žiadne obavy niečo zmeniť alebo nadobro sa toho zbaviť.	I feel that anything that is in the books, mistaken or not, middling writing or not, good or bad, got there like that and changing it or getting rid of it.	0.17619
Wachtelová:Tak veľa sa za ten čas vo vašej krajine zmenilo. V posledných rokoch to bola zmena k lepšiemu.	I have no anxiety about Wachtel:So much has happened since that time and in more recent years for the good.	0.3
Aký máte teraz pocit?	How do you feel now?	0.264706
Ako vidíte budúcnosť Severného Írska?	How do you see the future for Northern Ireland?	0.247059
Zriaďovanie nových inštitúcií považujem za dôležité, avšak na veľké vzplanutie lásky medzi týmito dvoma spoločenstvami (medzi republikánmi a nacionalistami) to nevidím ešte na dosť dlhý čas.	I think that the new institutions are important, but I don’t see any great love-in occurring between the two communities for a good while.	0.29069
Najdôležitejšie by bolo, aby oponujúce strany v miestnej samospráve našli prinajmenšom spôsob, ako spolu komunikovať, namiesto toho, aby sa znovu utápali v ideologickom alebo sektárskom hneve.	The main thing would be that in the new local parliament the opposing sides would find a way of talking at least, not bogging themselves down in ideological or sectarian fury again.	0.266225
Myslím však, že isté veci naznačujú aspoň priemerné zlepšenie.	I think the signs are middlingly good for that.	0.1875
Prešli sme z otrasnej politiky k opatrnému, obmedzenému neporiadku, kde sa uplatňuje politika oko za oko, zub za zub, čo znamená určitý krok vpred.	We’ve moved from the atrocious to the vigilant, small-minded messiness of tit-for-tat politics, and that is an advance.	0.235922
Takže áno, pevne dúfam v zlepšenie.		-0.3
Šance sú rozhodne oveľa lepšie ako pred tridsiatimi, štyridsiatimi a dokonca aj ako pred päťdesiatimi rokmi.	So I am hopeful, yes, and certainly it’s a far better prospect now than it was thirty, forty, fifty years ago even.	0.473279
Ľady sa pohli.	Things have moved on.	0.161538
Aj malé zmeny sú veľmi dôležité, keďže sú súčasťou niečoho väčšieho.	Little changes are very important, little changes in the individual breast.	0.264407
Budovať nové inštitúcie, aj keď nejdú na plný plyn ale aspoň na rezervu, sú zárukou veľkého úspechu, veľkej zmeny.	And getting the institutions up, if not running, at least going at pedestrian speed, has been a great achievement, a great change.	0.259794
Wachtelová: Vaše diela sú bohaté na obraznosť.	Wachtel: There are so many rich images in your work.	0.278049
Keď sa tak nad tým zamýšľam, ako sa u vás obyčajne zrodí báseň?	I’m wondering, how does a poem start for you?	0.189474
Takmer vždy sa to začína spomienkami, niečo, na čo zabudnete, sa neskôr objaví sčista-jasna ako dar z nebies.	Almost always it starts from some memory, something you’d forgotten that comes up like a living gift of presence.	0.290323
Robert Frost v predhovore svojej knihy Zbierka básní uviedol: "Ako vplyvné živočíchy tejto planéty sa neustále náhlime za skúsenosťami, vrháme sa vpred, aby sme si postupne vydláždili svoju budúcnosť a to i naprieč dňu, v ktorom budeme možno chcieť naraziť na rad cieľov niekde na druhej strane."	Robert Frost said in his introduction to his Collected Poems, "like giants we are always hurling experience ahead of us to pave the future with against the day when we may want to strike a line of purpose across from somewhere.	0.485182
Toto sa asi tak vo všeobecnosti deje so mnou.	”That is generally the way things happen with me.	0.268421
Začnú sa vynárať spomienky. A ak mám práve šťastie, prepoja sa s ďalšou myšlienkou.	The memory comes up and if I’m lucky, it attaches itself, it crosses itself with some other thing.	0.253521
Myslím, že jedna z mojich básní zobrazuje hru s vláčikmi na pohovke v Mossbawne.	I mean, I had that poem about playing trains on the sofa in Mossbawn.	0.242105
Táto báseň, našťastie nekončí len ako nostalgické znovuvytvorenie rodinnej idylky tráviacej svoj čas na pohovke v štyridsiatych rokoch.	It luckily didn’t end up just a little nostalgic recreation of happy families on the sofa in the 1940s.	0.184884
Prepája sa so zmyslom, ktorý postupne prerastá v celok. ~~~ Mám na mysli šťastný život, ktorý sme viedli, keď sme nemuseli žiť tak desivo a tragicky ako ľudia na pevnine Európy a Británie.	It crossed with that sense that gradually came as one grew, how lucky we were not to be living the terrible, tragic life of others in mainland Europe and in Britain.	-0.0220588
Tieň týchto udalostí, ktorý sme nezažili na vlastnej koži, sme však mali možnosť spoznať retrospektívne.	The shadow that we didn’t know was there could be recognized retrospectively.	0.192537
A to je presne druh básne, ktorý naozaj obľubujem: podnet, ktorý sa v našej pamäti vytvorí a tiež význam, ktorý je dúfam viac ako len súčasťou obsahu nášho vedomia.	That is the kind of poem I really like: the stimulus in memory, but the import, hopefully, more than just the content of memory.	0.212264
Nemyslím si, že by som bez pamäti urobil čo i len jeden krok vpred.	But without memory, I don’t think I could move.	0.1875
Verím totiž, že Mnemosyne je matkou všetkých Múz.	Mnemnosyne, I believe, is supposed to be the mother of the Muses.	0.216279
Wachtelová:	Wachtel:	0.2
V príhovore pri preberaní Nobelovej ceny v roku 1995 ste vzdali hold poézii za jej "pravdivosť o živote", a to v každom zmysle tohto slovného spojenia.	In your Nobel lecture in 1995, you credit poetry for its "truth to life, ” in every sense of that phrase.	0.29334
Čo ste mali na mysli pod pojmom v každom zmysle tohto slovného spojenia?	What were you thinking in terms of the senses of that phrase?	0.241176
Heaney: Na začiatok by som si rád požičal slová básnika Frosta, ktorý povedal, že všetko, čo opisuje aktuálne udalosti, má dokumentárny charakter.	Heaney:First of all, in a poet like Frost, say, it describes the actual, it has a documentary quality.	0.160465
Avšak toto nie je jediný zmysel, pri ktorom sa chcete pravdivo vyjadrovať o živote.	But that’s not the only sense in which you can be true to life.	0.182353
Hovoriť pravdu môžete aj čo sa týka morálneho pohľadu, etického úsudku či z hľadiska ponímania vecí z toho imaginárneho aspektu.	You can be true to it in terms of moral insight, in terms of ethical judgment, in realizing the imaginative dimensions of things.	0.294444
Môžete byť dôveryhodní spôsobom, akým je Wallace Stevens dôveryhodný vo svojej nedávnej básni Rieka riek v štáte Connecticut alebo druhom vyjadrovania pravdivosti v jednej z jeho starších lyrických básní.	You can be true to it the way Wallace Stevens is true to it in a late poem like "The River of Rivers in Connecticut, ” or the way he’s true to it in an early, crazy, little lyric like "The bucks went clattering .	0.485799
Táto kratšia a tak trochu bláznivá báseň nesie slová ako "Frajeri šli burácajúc".	”I’ve forgotten which state they go clattering through.	0.171429
Ani za nič si však neviem spomenúť, cez aký štát to tak hlučne prechádzajú.	Or "The Emperor of Ice Cream, ” this kind of grand flourish—sportive, elegant, just play for its own sake in the domain of language.	0.0761905
Ale nedá mi nespomenúť ani báseň Vládca zmrzliny, v ktorej môžeme nájsť taký druh veľkého rozkvetu – hravosť a elegancia hrajú v prospech autora, a to v oblasti jazyka. ~~~ Pozrime sa bližšie na súčasných amerických autorov, akým je napríklad aj John Ashbery, s ktorými malo a pravdepodobne ešte stále má ťažkosti veľa ľudí.	If you take a contemporary American writer like John Ashbery, who a lot of people had, and probably still have, difficulty with—kind of whimsical, non sequitur kind of writing, channel surfing the language, going zigzag from sentence to sentence—he is true to life insofar as that is the way people’s minds are now, hopping from thing to thing.	0.14059
Dôvodom týchto ťažkostí je nevyspytateľný, logicky nesúvisiaci druh písania, neobvyklé využitie jazyka, kľučkovanie od jednej vety k druhej.		-0.3
To je však súčasťou jeho spôsobu vyjadrovania skutočnosti, pretože tak dnes naozaj vyzerá ľudská myseľ – skáče od jednej myšlienky k druhej.		-0.3
Rozpätie času, počas ktorého sa dokážeme sústrediť, sa neustále skracuje.	It’s the way the world is, attention spans shortened.	0.176087
To je obraz dnešného sveta.		-0.3
Je totiž plný rôznych útržkov, nehovoriac o hluku.	The world is full of little sound bites, clamours.	0.293023
Na tomto svete ostalo už veľmi málo miest, kde môžete nájsť božský pokoj.	There’s very little silence on earth for anyone anymore.	0.220408
Vyžaduje si to neskutočnú dávku úsilia naraziť na miesto, kde by sme mohli kráčať len tak v tichu.	It takes a lot of effort to find a place to walk silently.	0.290881
Ashbery vierohodne zaznamenal život, aký v tomto novom svete vedieme.	Ashbery registers the truth-to-lifeness of the new world we live in.	0.562558
Osobne si myslím, že pravda nie je iba záležitosťou poézie či súčasťou tvorivého sveta, ktorého úlohou je informovať.	So I think it’s not just a matter of poetry being true in a novelistic kind of way, reporting what happens, but it’s true to the nature of reality, to the balance between the imagined and the endured, between the moral and the imagined and so on.	0.0029703
Pravdivosť by mala prirodzene byť súčasťou reality.	That must be what I meant when I said it.	0.181818
Jednoducho by mala existovať akási rovnováha medzi vymysleným a trvalým, medzi morálkou a predstavou.		-0.3
Čo sa týka odpovede na vašu otázku, tak som pod tým pojmom musel mať na mysli jedine to, čo som práve opísal.		-0.3
Wachtelová: Každá samostatná časť v dielach Johna Ashbera je veľmi zreteľná a ľahká na pochopenie.	Wachtel: Each of John Ashbery’s separate segments is very recognizable and you can understand it.	0.296429
Problém však vzniká, až keď sa snažíme z daných kúskov, ktoré sú tak trochu nenápadné, poskladať celok.	It’s only when you try to make sense of the whole thing that each piece is somewhat discreet.	0.257143
Mňa však zaujíma, čo sa vo vašom živote zmenilo, keď ste vyhrali Nobelovu cenu?	I was wondering, also, how did winning the Nobel change your life?	0.241071
Heaney: Pravdupovediac, na toto naozaj neviem odpovedať.	Heaney:I don’t really know the answer to that, to tell you the truth.	0.258824
Myslím, že sa zmenilo pár vecí, pokiaľ ide o pozvania na určité udalosti či o nátlak na moju emailovú schránku.	I mean, it changed it in terms of invitations to do things, in terms of pressure of the mail, in terms of saying no to many things.	0.258065
Naučil som sa aj to, že je nevyhnutné používať slovo nie pri odpovedi na mnohé veci. ~~~ A v Írsku, keďže sme malá krajina, počet pozvánok sa nevzťahuje len na literatúru.	And in Ireland, because we are a small country, the number of invitations to do things isn’t just confined to the literary.	-0.0553398
V septembri budem napríklad prednášať na medzinárodnom kongrese gerontológov.	For example, I’m going to speak at an international conference of gerontologists in September.	0.248571
Týmto spôsobom sa veci pohli, ale nemám pocit, že by šlo o radikálnu zmenu, ktorá by ma zmenila či už ako človeka, alebo ako spisovateľa.	So that kind of thing changed, but I don’t think it radically changed my sense of myself or what I was about as a writer.	0.25102
Nazdávam sa, že spomínanú cenu som dostal skôr za prácu, ktorú som už vykonal, ako za diela, ktoré ešte len prídu.	I mean, I assume that it was given for work that was done rather than work I was going to do.	0.214865
Spomínané ocenenie sa mi pošťastilo získať v roku 1995.	This happened to me in 1995.	0.428571
Práve v čase, keď som bol dosť zaneprázdnený, odhalený svetu, známy a kontrolovaný.		-0.3
Žil som na severe krajiny práve v čase, keď sa odohrávali udalosti známe pod názvom Konflikt v Severnom Írsku.	At that stage, I was already fairly busy and fairly exposed to the world, and fairly well-known and scrutinized.	0.293548
Patril som do generácie básnikov s menami ako Longley, Derek Mahon a ďalší. ~~~ Ja a títo básnici sme boli pod starostlivým dohľadom.	Living through the Troubles as a writer in the north, living as someone who’s part of that generation of poets—Michael Longley, Derek Mahon, and so on—we were constantly under scrutiny.	0.10346
Tým mám na mysli politickú kontrolu, nátlak, vypočúvanie.	We were under political scrutiny, we were under pressure, we were interviewed.	0.2
Pozornosť, ktorá prišla spolu s Nobelovou cenou, nebola ani zďaleka taká ostrá či náročná v porovnaní s dozorom, ktorým sme si už prešli. ~~~ Z toho dôvodu si nemyslím, že by som klamne opísal moje reakcie na cenu.	I think the kind of attention that came with the Nobel Prize wasn’t any more acute or exacting than what we had suffered ourselves already, so I don’t think I’m misrepresenting my response to the prize.	-0.00803571
Pravdou je, že akonáhle vám cenu udelia, ľudia vás začnú vnímať odlišne.	What is true is this, that other people see you differently once this garland is hung on you.	0.227419
To už je iná vec a aj ich Wachtelová: Chceli ste povedať, že to je ich problém.	That’s another matter, but that’s their Wachtel: That’s their problem.	0.290323
(smiech) Heaney: Presne.	[laughs]Heaney:Yeah.	0.271429
Wachtelová: V roku 2006 ste prekonali mŕtvicu. ~~~ Vyjadrili ste sa, že to vonkoncom nebol únik z hrobárovej lopaty.	Wachtel:You had a stroke in 2006, which you say wasn’t exactly a brush with death.	-0.0348214
Čo konkrétne sa teda stalo?	What was it?	-0.0545455
Jedného dňa som sa zobudil v jednom penzióne, ktorý sa nachádzal na území grófstva Donegal. ~~~ Predchádzajúcu noc sme tam s priateľmi niečo oslavovali. ~~~ Vôbec som nebol schopný čo i len vstať z postele a keď som sa snažil urobiť nejaké pohyby, nič sa nedialo.	Well, it was wakening up one morning in County Donegal in a guest house where we had been at a party with friends the night before and not being able to get out of the bed, making moves and nothing happening.	-0.122464
Moja ľavá strana bola úplne ochrnutá.	I was paralyzed on my left side.	0.233333
Našťastie, moji výborní priatelia boli nablízku a jedna z nich bola náhodou fyzioterapeutka.	Luckily, our very good friends were there on the spot, one of them a physiotherapist, so she came in and had a kind of calm talk.	0.425397
Prišla do mojej izby a snažila sa so mnou viesť pokojný rozhovor. ~~~ Záchranná služba prišla veľmi rýchlo a hneď ma previezli do nemocnice, ktorá bola od penziónu vzdialená asi hodinu cesty.	The ambulance services came very quickly and I was snatched straight to the hospital, which was an hour away, and en route I was hooked up to a drip that was very good for the circulation and so on.	0.0740625
Celý čas som bol napojený na infúziu, čo bolo veľmi prospešné pre môj krvný obeh.		-0.3
Po príchode do nemocnice som niečo vyše dňa strávil na jednotke intenzívnej starostlivosti. ~~~ Potom sa stalo niečo úžasné.	So I went to hospital, was in intensive care for a day and a half, and then something terrific happened.	-0.01125
Palec na mojej ľavej nohe sa po niekoľkých dňoch začal znovu hýbať.	My big toe moved on the left foot after a couple days.	0.211364
Na základe toho ma záchranka previezla z Donegalu dole do Dublinu, čo bolo asi 190 kilometrov.	At that point I was brought by ambulance from the north, from Donegal, about 120 miles down to Dublin.	0.28125
Tu som strávil týždeň vo všeobecnej nemocnici.	I was in a general hospital there for a week.	0.267568
Nestratili ste však reč?		-0.3
Vôbec to nepostihlo vašu myseľ?	No, I was extremely lucky in that way.	0.257143
Nie, v tomto smere som mal neskutočné šťastie.	Didn’t lose speech, didn’t lose memory, and emerged unmarked.	0.195
Nestratil som reč a ani som neprišiel o pamäť. ~~~ Vyviazol som z toho absolútne nepoznačený.	But for a while it was scary enough when I just wondered if I’d remain paralyzed.	0.0423077
Istý čas mi však behal mráz po chrbte, keď som uvažoval nad tým, že by som mohol zostať ochrnutý.		-0.3
Mal som z pekla šťastie.	I was blessed, really.	0.285
Koniec koncov bola to zlomová skúsenosť.	But it was a changing experience all right.	0.291667
Na čas dlhší ako jeden rok som totiž odvolal všetky stretnutia, ktoré sa týkali čítania a prednášok. ~~~ Malo to blahodarné účinky.	I cancelled every appointment I had for readings, lectures, and so on for a year, and that had a good effect.	0.0745098
Spôsobilo to, že som bol oveľa opatrnejší pri prijímaní pozvánok. ~~~ Uvedomil som si totiž, koľko času som strávil na cestách a tiež, že by som mal pozmeniť niektoré smery mojich ciest.	It made me much more cautious about accepting invitations and made me realize how much I was on the road and how I should change my ways a bit.	0.0388004
Takže toľko k blahodarným účinkom.	So it had that good effect.	0.195652
		0.3
