K improvizácia patrí extempore - - niečo nepripravené a nepredvídate né, s čím sa aj v živote každodenne stretávame, ke sa musíme rýchlo vynájsť, rozhodnúť sa v sekunde či náhle reagovať na situáciu.	Improvisation implies the extempore – something out of time and unprepared – i. e. engaging with the unpredictable, as all of us are challenged to do in our everyday lives when we must draw spontaneously on our own resources, make on-the-spot decisions, or react to situations in unexpected ways.	0.243592
Jedným z cie ov je zistiť, ktoré z aspektov tvorenia hudby pociťuje pacient ako obzvlášť prospešné.	One of the aims when the therapist and patient review what has taken place during an improvisation session is to identify those aspects of the music making that the patient him- or herself experiences as particularly useful.	-0.0670588
Tomu, kto sa terapie nezúčastňuje, môže takáto improvizovaná hudba znieť zvláštne, ne ubozvučne.	For an outsider, such improvised music often sounds strange, cacophonous.	0.207692
Pacienti zvyčajne potrebujú čas, aby si na improvizáciu zvykli a prispôsobili sa jej.	Patients too usually need some time to adjust themselves to and feel comfortable with the improvisation set-up.	0.210811
Improvizácia je tiež psychoterapeutickým prístupom, ke slová nestačia a pocity sa ťažko vyjadrujú.	Improvisation is often used as a psychotherapeutic approach when words fail and emotions are hard to express.	0.490148
Odstraňuje citové bloky a v aka nej pacienti znovu začnú veriť, že dokážu komunikovať s ostatnými.	It helps to dissolve emotional blocks, and through it patients can relearn to trust their ability to interact with others.	0.228571
Komponovanie Komponovaním pacienti prejavujú svoje pocity, experimentujú s bojujú proti skutočnosti, že hudba je pominute ná (hrá len chví ku) tým, hudbou, ale aj že sa pre nich stáva mentálnym a emocionálnym útočiskom.	Composition Composition is used in music therapy to express feelings, to experiment with music but also to counteract the ephemerality of music by creating a mental and emotional anchor.	0.345283
V oblasti pediatrie môžu deti napr. prepisovať slová ich ob úbených piesní, aby ahšie pochopili, resp. vyjadrili svoj strach a odvážili sa mu postaviť zoči-voči.	In the pediatric setting, for example, children may rewrite the words to their favorite songs in order to understand or express their fears and to gain courage in facing them.	0.280435
Smrte ne chorým pacientom dáva komponovanie priestor na skúmanie základných otázok života, umierania a smrti.	During terminal care, composition provides a space to explore fundamental questions about life, dying and death.	0.48125
Títo pacienti zanechávajú vo svojich skladbách odkazy pre najdôležitejších udí svojho života, čím prejavujú svoju lásku, v ačnosť a úctu.	Such patients may write pieces as a legacy for the most important people in their lives, expressing their love, gratitude and appreciation.	0.442857
Tvorba melódie a textov piesní pomáha dospelým vyjadriť pocity spojené s nepríjemnými zážitkami a čeliť traumám.	In work with adults, writing the melodies and texts of songs can help to thematize painful experiences and address traumas.	0.278571
Témy, o ktorých sa terapeut s pacientom počas terapie rozpráva, sa neskôr odrazia v jeho tvorivej umeleckej činnosti.	During the composition process, discussion with the therapist helps the patient to assimilate the topics that are relevant to the therapy and then feed these reflections back into the creative artistic practice.	0.0623762
Jeden z našich pacientov napísal v čase svojej onkologickej liečby pieseň Cítim sa opäť dobre.	During an oncological rehabilitation, one of our patients wrote the song ‘Feeling Well Again. ’	0.296296
Po dvoch rokoch sa v dobrom zdravotnom stave vrátil na Kliniku nádorovej biológie na konsolidačnú terapiu.	Two years later, in good health, he returned to the Clinic for Tumor Biology for consolidation therapy.	0.286364
Túto melódiu si nastavil ako zvonenie na mobile.	He had programmed his tune as the ring tone for his mobile phone.	0.214286
Zakaždým prichádzajúcim hovorom si spomenul na svoje predsavzatie - starať sa o vlastné zdravie a myslieť o sebe pozitívne.	Every time he received a call, it reminded him of his resolution to take care of his health and to think well of himself.	0.428788
Nepozdvihol tým náladu len sebe, ale aj rodine a priate om.	This raised not only his spirits but also that of his family and friends.	0.234
Receptívna muzikoterapia používajúca monochord pri lôžku pacienta v akútnom zdravotnom stave na Klinike nádorovej biológie vo Freiburgu, Nemecko. ~~~ Receptívna muzikoterapia	Receptive music therapy using the monochord at the patient’s bedside in an acute medical situation at the Tumor Biology Center in Freiburg, Germany Receptive Music Therapy	0.0580171
V receptívnej muzikoterapii sa hudba používa na relaxáciu, zníženie bolesti, zmiernenie úzkostí a/alebo na stimuláciu psychických procesov, ktoré súvisia s chorobou a liečbou.	In receptive music therapy, music is used for purposes of relaxation, to reduce pain, relieve anxieties and/or to stimulate illness- and therapy-relevant psychic processes.	0.292
Pacient počúva bu terapeuta, ktorý hrá na hudobnom nástroji, alebo hudobnú nahrávku.	The patient listens either to music played live by the therapist or to recorded music.	0.29589
V aka rytmickému impulzu či pravidelným úderom má počúvanie hudby aj funkčné neurologické účinky.	Listening to music can also have additional functional neurological effects through the stimulus of rhythm or a metrical beat.	0.215294
Paliatívna/Relaxačná Cie om relaxačnej muzikoterapie je, aby si pacient pri počúvaní hudby oddýchol psychicky i fyzicky.	Palliative/Relaxational The goal of relaxational music therapy is to procure psychophysical relaxation through listening to music.	0.271698
Na Klinike nádorovej biológie vo Freiburgu používame na túto terapiu monochord, 30-strunový hudobný nástroj, na ktorom hrá terapeut.	In the Clinic for Tumor Biology in Freiburg, for such therapy we employ the monochord, a 30- stringed instrument, played live by the therapist.	0.444964
Tento prístup pri práci so skupinou nazývame hudobná meditácia.	In group work we refer to this approach as sound meditation.	0.270588
Pacientom, ktorým nevyhovujú iné relaxačné metódy umožňuje meditácia dosiahnuť intenzívny pocit hlbokého uvo nenia a vnútorného pokoja.	It enables many patients who encounter problems with other relaxation modalities to achieve an intense experience of deep relaxation and inner peace.	0.2775
Receptívna muzikoterapia sa uplatňuje aj ke je pacient pripútaný na lôžko.	Receptive music therapy can also be applied at the bedside.	0.217647
Hudba prináša psychické i fyzické uvo nenie (anxiolýza) a znižuje bolesť (audioanalgézia) hlavne v situáciách, ke pacient umiera a má obrovský strach.	Especially in situations – such as the approach of death – when anxieties may be strong, music can bring about both physical and psychic relaxation (anxiolysis) and may reduce pain (audioanalgesia).	0.21
Hudba dokáže preniknúť cez uši do tela a "duše" chorého, aj ke ostatné zmyslové orgány nefungujú (napr. oči) alebo sú oslabené kvôli liekom.	When other senses are closed off (sight for example) or numbed by medication, through the ear, music can often still reach the body and ‘soul’ of the sick person.	0.259664
Rehabilitačná Pri rehabilitačnej muzikoterapii hudba podporuje psychoterapiu a procesy sebapoznávania.	Rehabilitative Here music is used to support processes of self-discovery and psychotherapy.	0.251852
Jednou z metód je hudbou riadená imaginácia.	One established method is guided imagery and music.	0.253846
Hudobným pozadím je zvyčajne vážna hudba, ktorá vyvoláva vnútorné predstavy, myšlienky a spomienky. ~~~ Pacient o nich potom rozpráva, asimiluje ich a terapeuticky integruje.	Usually classical music is employed as a sound setting to bring forth inner images, ideas and memories that are subsequently discussed, assimilated and therapeutically integrated by the patient.	0.0902554
Funkčná Počúvanie stimulujúcej hudby, jednoduchého rytmu alebo pravidelných úderov (napr. metronómu) je z terapeutického h adiska prospešné.	Functional Applied appropriately, listening to stimulating music, a simple rhythm or even just a regular beat can have therapeutic benefits.	0.292623
Pri fyzioterapii po mozgovej porážke pomáha počúvanie týchto pravidelných úderov určitým funkciám spojeným s chôdzou, ako napr. rýchlosť chôdze a dĺžka kroku [11].	During physiotherapy following a stroke, for example, listening to a metric beat can facilitate the relearning of certain gait functions such as walking speed and step length [11].	0.524648
Thaut so svojimi kolegami [12] dokázal, že zvukovo-rytmický stimul zlepšuje pohyb a ovládanie rečových svalov u pacientov s Parkinsonovou chorobou.	Thaut and his colleagues [12] have also been able to show that an acoustic-rhythmic stimulus can improve the movement and speech motor control of patients with Parkinson’s disease.	0.527575
Pacient po mozgovej porážke robí za pomoci fyzioterapeuta a metronómu zvukovo-rytmickú stimuláciu zameranú na nácvik chôdze v Centre biomedicínskeho výskumu hudby na Coloradskej štátnej univerzite (fotografia so súhlasom Michaela Thauta).	Stroke patient doing rhythmic auditory stimulation- based gait training with a metronome and a physical therapist at the Center for Biomedical Research in Music, Colorado State University (photo courtesy of Michael Thaut).	0.368649
Hoci dnes v medicíne dominujú prístupy založené na dôkazoch, muzikoterapia, či už s terapeutom alebo bez neho, sa stala vedecky dokázaným "liečebným prostriedkom", ktorý poskytuje pacientom doplnkovú bezliekovú liečbu.	Today, even in fields of medicine strongly dominated by evidence-based approaches, music, with or without a therapist, has become a scientifically proven ‘remedy’ that offers patients a nondrug, complementary medical treatment.	0.289005
Používa sa na zvýšenie pocitu duševnej pohody, zníženie stresu, vyjadrovanie pocitov bez slov, zlepšenie medzi udskej komunikácie, stimuláciu pamäťového výkonu a na zmiernenie bolesti.	Music can be applied to enhance the sense of well-being, to reduce stress, to express feelings without words, to improve interpersonal communication, to stimulate memory performance and to relieve pain.	0.277778
Muzikoterapia už v súčasnosti nepredstavuje takú nezvyčajnú metódu a rozvíja sa do vážnej, vedecky založenej disciplíny so širokým spektrom liečebných možností.	Music therapy is now rapidly shedding its exotic status and developing into a serious, scientifically based discipline with a broad range of therapeutic options.	0.432047
Jedným z najdôležitejších predpokladov účinnej liečby je, že si pacient bude užívať to, čo robí a počúva.	One of the most important prerequisites for an effective therapy is that the patient enjoys what he or she is doing and hearing.	0.243333
Iba za týchto podmienok môže hudba naplno ukázať svoje liečivé účinky.	Under these conditions, music can unfold its healing powers.	0.254717
Aký význam má pre mňa O. J. Simpson theatlantic. com (Ta-Nehisi Coates) 12. september 2016	What O. J. Simpson Means to Me theatlantic.com (Ta-Nehisi Coates) September 12, 2016	3.71213
(Zdroj: Jeff Elkins)	Photo collage by Jeff Elkins*	0.939474
Moja reakcia na zatknutie O. J. Simpsona za vraždu svojej bývalej manželky Nicole Simpsonovej a jej kamaráta Rona Goldmana bola nezvyčajná.	MY REACTION TO O. J. Simpson’s arrest for the murder of his ex-wife Nicole Simpson and her friend Ron Goldman was atypical.	0.659576
Písal sa rok 1994.	It was 1994.	0.913636
Bol som mladý černoch navštevujúci historicky černošskú univerzitu vo Washintone, D. C. , kde je väčšina obyvateľov tmavej pleti. ~~~ So Simpsonom som nijak nesúcitil. ~~~ Nerozumel som, prečo vyvolal ľútosť u iných, a s tvrdením Simpsonových právnikov, že sa stal terčom kvôli svojej farbe pleti, som sa nestotožnil.	I was a young black man attending a historically black university in the majority-black city of Washington, D. C. , with zero sympathy for Simpson, zero understanding of the sympathy he elicited from my people, and zero appreciation for the defense team’s claim that Simpson had been targeted because he was black.	-0.0857143
O. J. Simpson nebol černoch.	O. J. Simpson wasn’t black.	1.7875
Vyrastal v šesťdesiatych rokoch, v dobe, keď Muhammad Ali protestoval proti vojne vo Vietname a John Carlos s Tommiem Smithom zdvihnutými päsťami prejavili sympatie k černošskému hnutiu Black Power na olympijských hrách v roku 1968.	He came of age in the 1960s—the era of Muhammad Ali’s opposition to the Vietnam War and John Carlos and Tommie Smith’s black-power salute at the 1968 Olympics.	0.461473
No O. J. Simpson, ktorého som poznal, a O. J. , ktorého tento rok dojemne zobrazil Ezra Edelman vo svojom výnimočnom dokumente O. J. : Made in America, poznal len jeden boj, a to o vlastný postup.	But the O. J. Simpson I knew, and the one poignantly depicted this year in Ezra Edelman’s epic documentary, O. J. : Made in America, recognized only one struggle—the struggle to advance O. J. Simpson.	1.28882
Keď sa aktivista Harry Edwards snažil zapojiť Simpsona do bojkotu olympiády, ten ho rázne odmietol a neskôr tvrdil, že organizátori ako Edwards sa ho pokúsili využiť.	When the activist Harry Edwards attempted to enlist Simpson in the Olympic boycott, Simpson rebuffed him and later claimed that organizers like Edwards had tried to use” him.	0.620657
Protest uškodil Tommiemu Smithovi a Johnovi Carlosovi, povedal Simpson.	Protest hurt Tommie Smith, it hurt John Carlos, ” Simpson said.	0.544444
Smith a Carlos na stupienku víťazov neoslavovali svoje víťazstvo, ale skákali, ako Edwards pískal.	Smith and Carlos were standing on [Edwards’s] platform, [when] they should have been standing on their own platform. ”	0.647674
Môj názor, že Simpson žil za hranicami černošskej Ameriky, bol založený nielen na jeho slabom politickom povedomí, ale aj na jeho vlastných slovách.	My view that Simpson existed beyond the borders of black America was based not merely on his narrow political consciousness, but on his own words.	0.415244
Mojím najväčším úspechom, povedal novinárovi Robertovi Lipsytovi, je, že ľudia sa najprv na mňa pozrú ako na človeka, a nie ako na černocha.	My biggest accomplishment, ” Simpson once told the journalist Robert Lipsyte, is that people look at me like a man first, not a black man. ”	0.417241
Potom pokračoval v rozprávaní príbehu zo svadby, na ktorej bol so svojou prvou ženou a skupinkou kamarátov – černochov.	Simpson went on to tell the story of a wedding he’d attended with his first wife and a group of black friends.	0.41
V istom momente započul hosťa, belocha, poznamenať: Pozrite, tam je O. J. Simpson a nejakí negri.	At some point he overheard a white guest remark, Look, there’s O. J. Simpson and some niggers. ”	0.994632
Simpson sa priznal, že poznámka sa ho dotkla, no o to v príbehu nešlo.	Simpson confessed that the remark hurt. But that wasn’t the point of the story.	0.453448
Imponovalo mu, že ho nevnímali ako jedného z negrov.	The point was not being seen as one of the niggers. ”	0.286047
Simpson sa tváril, že žije vo svete bez rasizmu, ale rasizmus v Amerike stále prítomný bol.	Simpson sought to be post-racial in a world that was not.	0.36875
Priepasť medzi černochmi a belochmi sa nezmenšila ani po jeho nespočetných úspechoch: stal sa hlavným running backom v univerzitnom futbale, prvým running backom v NFL (National Football League), ktorý prešprintoval 2 000 yardov za sezónu, jedným z prvých černochov, ktorý vystupoval v reklamách v Amerike, kde sa všetko točí okolo obchodu.	His myriad achievements— becoming the premier running back in college football, the first NFL running back to rush for 2, 000 yards in a season, one of the first black pitchmen for corporate America—did not mark the erosion of the great wall between black and white Americans.	0.534578
Ovplyvnený bol iba jeho osobný úspech, ktorý spočíval v prekračovaní tejto priepasti.	It marked Simpson’s individual success at hurdling that wall.	0.183333
Simpson, ktorý vyrastal vo verejných bytoch 14 v chudobnej časti San Francisca, našiel svoje nové ja ako celebrita.	Landing on the other side, Simpson, a product of public housing in inner-city San Francisco, found reinvention as a celebrity.	0.588517
(14 Byty, ktorých výstavba je financovaná z verejných fondov a sú určené pre ľudí s nízkym príjmom (pozn. prekladateľa).		-0.3
Zbohatol.	He became wealthy.	0.09
Snažil sa získať pozornosť a vyhľadal rady bohatých podnikateľov.	He courted the attentions and advice of affluent businessmen.	0.277778
V rovnakom roku, kedy sa oženil s Afroameričankou Marguerite Whitleyovou, sa dostal na Juhokalifornskú univerzitu a aj napriek tomu, že bol ženatý, nemal problém dvoriť beloškám.	And though he’d married Marguerite Whitley, who was black, the same year he arrived at the University of Southern California, he now courted white women.	0.36
To, čo robím, nie je kvôli princípom alebo černochom, zveril sa Simpson Lipsytovi.	What I’m doing is not for principles or black people, ” Simpson told Lipsyte.	0.486593
Nie, v prvom rade mi záleží na O. J. Simpsonovi, na jeho žene a deťoch.	No, I’m dealing first for O. J. Simpson, his wife, and his babies. ”	0.689286
Demonštranti sa pred budovou súdu v Los Angeles zhromaždili, aby podporili Simpsonových právnikov.	Protesters outside the Los Angeles courthouse rallied in support of Simpson’s defense team.	0.702321
Simpson našiel podporu aj u sociálnych aktivistov a černošskí obchodníci predávali tričká s nápismi Run O. J. a Free O. J. Simpson.	Community activists also backed Simpson, and black vendors sold Run O. J. and Free O. J. Simpson T-shirts.	1.33526
(Zdroj: AFP/Getty)	(AFP / Getty)	0.15
Kedykoľvek som kráčal ulicami D. C. v čase procesu, videl som černochov vyjadrujúcich O. J. -ovi podporu, akoby bol jedným z nich.	And yet, during his trial, whenever I walked the streets of D. C. , I saw black people broadcasting their support as though he were one of them.	0.539051
Pouliční predavači ponúkali tričká s nápismi Run O. J. a Free O. J. Simpson 15 . ( 15 Utekaj, O. J. a Osloboďte O. J. Simpsona, (pozn. prekladateľa)	Vendors hawked RUN O. J. and FREE O. J. SIMPSON T-shirts.	0.8375
Občianski aktivisti, ktorí dovtedy nemali pre Simpsona žiadnu cenu, mu horlivo ponúkali ochranu.	Community activists, for whom Simpson had previously had no use, offered fervent defenses of him.	0.296429
Po vyhlásení rozsudku prišli na právnickú fakultu Howardovej univerzity štáby z celonárodných správ, aby natočili, ako sa ľudia radujú zo Simpsonovho zbavenia viny.	When the verdict was announced, national-news cameras came to Howard Law School to record what turned out to be a jubilant response to Simpson’s acquittal.	0.275
Toto všetko bolo pre mňa veľmi frustrujúce.	I found all of this very frustrating.	0.24375
Mal som 19 rokov.	I was 19 years old.	6.88
Bol som bojovne naladené čierne dieťa, ktoré sa pohrávalo s myšlienkami Louisa Farrakhana a Frantza Fanonona, a uvažovalo nad vegánstvom.	I was the kind of militant black kid who flirted with Louis Farrakhan, Frantz Fanon, and veganism and who believed What should black people do? ” was a question that could be asked in earnest.	0.342017
Dieťa, ktoré verilo, že otázka: Čo by mali černosi robiť? by mohla byť myslená vážne.	The answer, I was sure, would open a new era of black excellence.	0.2
Bol som si istý, že odpoveď na ňu by bol začiatok novej éry, v ktorej by černosi ukázali svoju jedinečnosť.		-0.3
Podporovať Simpsona bolo nerozumným a politicky nevyspelým krokom späť.	The support of Simpson was a step backward.	0.414414
Zdalo sa, že súčasne by mohli byť pravdivé dve veci: Simpson sa opakovane správal násilne a zabil svoju bývalú manželku, a policajné oddelenie Los Angeles bolo brutálnou okupačnou armádou.	Two things, it seemed to me, could be true at once: Simpson was a serial abuser who killed his ex-wife, and the Los Angeles Police Department was a brutal army of occupation.	0.764583
Prečo bola policajná brutalita v tomto prípade taká podstatná a čo mala spoločné so Simpsonom, ktorý žil ďaleko od problematických losangelských get?	So why was it that the latter seemed to be all that mattered, and what did it have to do with Simpson, who lived a life far beyond the embattled ghettos of L. A. ?	0.428109
Svoje pocity som ventiloval v školskom časopise.	I vented in the school newspaper.	0.155172
Napísal som: Keďže Simpsonove činy naznačujú, že ani v najmenšom sa nezaujíma o záležitosti černochov, otázkou ostáva, prečo majú černosi záujem o neho.	Since Simpson’s practices show he clearly has no interest in the affairs of black people, ” I wrote, the question becomes why do blacks have any interest in him? ”	0.29084
V tom čase som si Afroameričanov predstavoval ako politickú stranu, ktorá si jednohlasne potrebovala zvoliť správnu stratégiu za účelom zbaviť sa pohromy zvanej rasizmus.	In those days, I conceived of African Americans as a kind of political party, which needed only, in unison, to select the correct strategy in order to make the scourge of racism disappear.	0.281757
Vynakladanie politického kapitálu na O. J. Simpsona sa mi zdalo ako presný opak správnej stratégie.	Expending political capital on O. J. Simpson struck me as exactly the opposite of the correct strategy.	0.668023
Hľadiac späť si uvedomujem, čo mi uniklo.	Looking back, I realize what eluded me.	0.282353
Celý svoj život som žil medzi černochmi a začal som ich vnímať ako abstrakcie, a nie ako ľudí.	I had lived among black people all my life, but somehow I had come to see them as abstractions, not as humans.	0.253846
Vtedy som ešte nečítal Ragtime, román E. L. Doctorowa, o ktorom Simpson tvrdil, že ho má veľmi rád.	I had not yet read Ragtime, the E. L. Doctorow novel that Simpson claimed to love.	0.939706
Po ukončení futbalovej kariéry v roku 1979 sa Simpson vybral na hereckú dráhu a sníval o tom, že vo filmovej adaptácii knihy získa rolu Coalhousa Walkera.	After his retirement in 1979, he began doing some acting and dreamed of playing Coalhouse Walker in the film adaptation of the book.	0.248649
Myslel si, že rola Walkera, černošského ragtimového pianistu, ktorý sa stane revolucionárom, sa zhoduje s jeho životom.	Simpson felt the role of Walker, a black ragtime piano player turned revolutionary, matched his life.	0.241379
Podobu len predstieral a, každopádne, rolu získal Howard Rollins.	The parallels are strained—and in any case Simpson lost the role to Howard Rollins.	0.832759
No podobá sa na inú postavu z knihy. Postavu, ktorej činy vysvetľujú podivné puto medzi Simpsonom a černošskou komunitou.	But Simpson does resemble another character in the book, one whose feats explain the strange bond between Simpson and the black community.	0.259615
Doctorow predkladá zbeletrizovaného Harryho Houdiniho, ktorý unikne zo zvieracích kazajok, bankových trezorov, z piana a poštových vriec a nadchýna chudobných obyvateľov.	Doctorow offers a fictionalized Harry Houdini, whose escapes from straitjackets, bank vaults, piano cases, and mailbags thrill the poor people of the nation.	0.539639
V Bostone ho zavrú do väzenia, uväznia ho na anglickej lodi, v reťaziach ho hodia do Seiny.	He is jailed in Boston, imprisoned on an English ship, tossed into the Seine in manacles.	0.296
Zakaždým vyviazne.	Each time, he escapes.	0.266667
Vďaka svojim vystúpeniam môže uskutočniť svoj veľkolepý útek, útek z chudoby, hoci nakoniec zistí, že rešpekt elity si nekúpi.	Houdini’s act allows him to make the greatest escape of all—out of poverty—though he eventually discovers that no amount of money will buy him the respect of the elite.	0.211927
Chudobní ľudia nie sú uchvátení Houdinim preto, že vystupuje v ich mene, ale preto, že jeho pozoruhodné výkony rezonujú s ich životmi, o ktorých vedia, že sú plné padacích dvierok a nástrah. Vedia, že boli zatknutí, uväznení, spútaní a vrhnutí do mora.	The poor are enthralled by Houdini not because he organizes on their behalf, but because his exploits resonate with them: They know that their lives are trapdoored and trip-wired, that they too have been jailed, imprisoned, chained, and tossed into the sea.	0.292925
Houdiniho vystúpenia boli miniatúrou ich životov s jedným obrovským rozdielom – on zo všetkého vyviazol.	A Houdini performance was their life in miniature, with one heroic difference—he escaped.	0.25
Dlho pred tým, ako ho polícia naháňala po celom L. A. , bol Simpson majstrom úniku.	LONG BEFORE HE LED THE POLICE on a chase through L. A. , Simpson had been an escape artist.	0.984143
Pre výnimočné atletické nadanie nestrávil detstvo v chudobe, a v roku 1967 sa vďaka futbalovému štipendiu dostal na Juhokalifornskú univerzitu.	His rare athletic talent freed him from an impoverished childhood, and brought him to USC on a football scholarship in 1967.	0.385714
Dokument Made in America šikovne zachytáva jeho športové vlohy, no upozorňuje na ich symboliku a rekapituluje mnohé Simpsonove šprinty z čias, keď chodil na Juhokalifornskú univerzitu, a neskôr, keď hral za Buffalo Bills.	Made in America, deftly capturing his athleticism, is alert to symbolism too, replaying Simpson’s manifold escapes while at USC and later with the Buffalo Bills.	0.648495
Jeho šprinty priam bijú do očí.	They are dazzling to behold.	0.276
Simpson sa nerozbehol elegantne, ale neohrabane.	Simpson’s speed was enhanced not by grace but by awkwardness.	0.238636
Na jednom zábere vidieť, ako podskočí pri obrancovi, podľa všetkého pri dopade stratí rovnováhu, a vzápätí uteká cez ihrisko najrýchlejšie, ako sa dá.	In one frame he leaps past a defender, lands seemingly off balance, and then cuts across the field at full velocity.	0.337395
V niekoľkých kritických momentoch čakáte, že spadne, a keď sa to stane, tak obranca padá s nim, no potom Simpson v zlomku sekundy vyskočí na nohy a uháňa ďalej.	At several junctures, you expect him to fall, and the one time he does, the defender falls with him—but then Simpson, in a matter of milliseconds, glides to his feet and races off.	0.46391
Naklonil sa a jeho dolná časť tela smerovala na inú stranu ako horná.	He would angle himself against the earth, his hips flying one way, his head another.	0.232759
Zdalo sa, akoby sa vznášal. Hruď si nechránil, hoci bola ľahkým cieľom pre obrancu.	He seemed to run too high, with his chest exposed, presenting what should have been an inviting target for the defense.	0.177465
A aj napriek tomu unikol.	And yet he escaped.	0.211765
Myšlienka, že losangelská polícia môže falošne obviniť černocha bola vierohodná pre černošských obyvateľov Los Angeles v roku 1994.	For many black residents of Los Angeles in 1994, the idea that the LAPD might frame a black man was entirely plausible.	0.567305
Nedbalé zbieranie dôkazov obžaloby iba potvrdilo nedôveru.	The prosecution’s careless gathering of evidence only confirmed the distrust.	0.209434
(Zdroj: Vince Bucci/Getty) Simpson bol running backom. ~~~ V tejto pozícii posledné polstoročie dominujú Afroameričania.	(Vince Bucci / Getty) Simpson was a running back, a position dominated by African Americans for the past half century—a fact that has often been invoked to boost racist thinking about the innate athleticism of blacks.	-0.0352041
Kvôli tomuto faktu vrodene športové nadanie černochov vyvoláva rasistické reakcie. ~~~ Relevantnejšie však je, že hlavnou úlohou running backa je utiecť.	More pertinent, the job of the running back—to escape—is the most basic of vocations, one that a kid from the projects can begin practicing in that first game of tag.	-0.0056391
Túto úlohu môže dieťa z verejných bytov začať trénovať pri prvej hre na naháňačku. ~~~ Beh má špeciálny význam pre ľudí už len z toho dôvodu, že je to najúčinnejšia dostupná zbraň tých, ktorí si nemôžu dovoliť násilne odporovať.	Running also holds a special significance to a people denied violent resistance as a viable option, if only because it has always been the most potent tool available.	0.0335294
Otrok na úteku je pevnou súčasťou amerického povedomia.	The runaway slave is a fixture in the American imagination.	0.287755
Spisovateľka Isabel Wilkersová spomína vo svojom opise veľkej migračnej vlny, že černosi, ktorí utiekli z Juhu počas 20. storočia, urobili to, čo ľudia hľadajúci slobodu často robia už odjakživa.	As the writer Isabel Wilkerson notes in her account of the Great Migration, the blacks who fled the South during the 20th century did what human beings looking for freedom, throughout history, have often done.	0.385714
Odídu.	They left. ”	0.128571
Z dejín vieme, že niektoré úteky Afroameričanov majú zlú povesť. ~~~ Ide o zvyk černochov, ktorí sú dosť bledí na to, aby sa dostali na druhú stranu, začlenili sa medzi belochov a zmizli v privilegovanej vrstve.	There is also a less reputable history of fleeing among African Americans—the tradition of those blacks light enough to pass” as white and disappear into the overclass.	0.0274402
Simpson mal veľké šťastie, že vrchol svojich síl dosiahol v sedemdesiatych rokoch, po skončení hnutia za občianske práva černochov. ~~~ Vtedy človek už mohol zinscenovať rituál prechodu na druhú stranu nie preto, že vyzeral ako beloch, ale vďaka tomu, že mal vlastnosti, ktoré mu belosi závideli.	Simpson’s great fortune was to reach the height of his powers in the 1970s, after the civil- rights movement, a time when one might enact the rituals of passing not by looking white, but by possessing qualities that white society envied.	-0.0401515
Simpson bol celebrita.	Simpson was a celebrity.	1.03571
Bol atraktívny, výrečný a očarujúci.	He was handsome, articulate, and charming.	0.254545
Jednoznačne bol černoch, no ak jeho správanie porovnáme s arogantnosťou Muhammada Aliho a so spútanou zúrivosťou Jima Browna, tak Simpsonova inakosť vyžarovala istotu a serióznosť.	He was identifiably black, but measured against the brashness of Muhammad Ali and the coiled rage of Jim Brown, his distinction was to radiate reassurance and respectability.	0.283893
V úspešnej sérii reklám pre požičovňu áut Hertz z roku 1975, stále bežal, no teraz cez letiská, ikonu spoločenskej mobility, kde ho belosi povzbudzovali slovami: Ideš, O. J.	In the successful series of ads he starred in for Hertz beginning in 1975, he was still running—only now through airports, an icon of social mobility, with white people cheering him on: Go, O. J. ”	0.784588
Starý Simpsonov kamarát v dokumente Made in America povedal, že Simpson sa nechal zviesť belošskou spoločnosťou.	An old friend of Simpson’s says in Made in America that Simpson was seduced by white society. ”	0.93373
Možno.	Perhaps.	0.214286
Ale zvádzanie bolo vzájomné a on využil svoju futbalovú slávu, aby získal prístup k sponzorom, belochom, ktorí sa už nevedeli dočkať, kedy mu ukážu luxus.	But the seduction was mutual, and he used his football fame to gain access to white patrons eager to expose him to the finer things in life.	0.258261
Zobral som ho na miesta, kam sa len tak hocijaký černoch nedostane, povedal v dokumente Frank Olson, výkonný riaditeľ spoločnosti Hertz.	I took him places where I think very few black men had ever been, ” Frank Olson, the former CEO of Hertz, says in the film.	0.518182
Simpson sa pustil do reči s bohatými podnikateľmi v golfových kluboch, kde bol jedným z mála černochov, ak nie prvým a jediným.	Simpson mingled with wealthy entrepreneurs at golf clubs where he was one of the few black members, or the first and only black member.	0.413612
Boli nadšení, že sa stretnú s ozajstným športovým hrdinom v jeho sídle, v Rockinghame, ktoré sa nachádza v zámožnom belošskom predmestí Brentwoodu.	He gave them the thrill of convening with a real sports hero at his mansion, Rockingham, nestled in the wealthy white suburb of Brentwood.	0.271552
Vďaka tomu, že sa pohyboval v dobrej spoločnosti, podarilo sa Simpsonovi nahromadiť nemalé bohatstvo.	Simpson’s social circle helped him amass a small fortune.	0.066
Do deväťdesiatych rokov bol jeho čistý majetok odhadovaný na 10 miliónov dolárov.	By the 1990s, his net worth was estimated to be $10 million.	0.174
Bol výkonným riaditeľom podniku O. J. Simpson Enterprises, ktorý investoval do hotelov a reštaurácií a okrem toho mal pod palcom štyri rozdielne firemné výbory.	He was the CEO of O. J. Simpson Enterprises, which owned stakes in hotels and restaurants, and he sat on four different corporate boards.	0.72
Mojim najväčším úspechom je, že ľudia sa najprv na mňa pozrú ako na človeka, a potom ako na černocha, povedal Simpson novinárom.	My biggest accomplishment, ” Simpson once told a journalist, is that people look at me like a man first, not a black man. ”	0.540077
Po tom, čo bol zbavený obvinenia, si Simpson prečítal článok, kde ho považovali za černošskú ikonu.	After his acquittal, he read press coverage that treated him as a black icon.	0.207692
(Zdroj: Lawrence Shiller/Getty)	(Lawrence Schiller / Getty)	0.24
Príliš veľa svojej pozornosti venoval zvádzaniu žien.	His pursuit of white women was profligate.	0.210811
Vo veľavravnom momente v dokumente Joe Bell, Simpsonov kamarát od detských čias, spomína, ako si to v sedemdesiatych rokoch šinuli po Rodeo Drive a žasli, akú to vyvolalo reakciu.	In a telling moment in the documentary, Joe Bell, a friend of Simpson’s since childhood, recalls them slowly cruising down Rodeo Drive in the 1970s and being awed by the response.	0.796
Ženy sa mu vrhali okolo pliec, valili sa naňho, vraví Bell.	Women come up, throw their arms around O. J. , and just lay it on him, ” Bell says.	0.204
A nie hocijaké ženy.	Not just women.	0.214286
Belošky.	White women.	0.2
Krásne belošky.	Fine white women. ”	0.26
V roku 1977 si Simpson začal s očarujúcou 18-ročnou blondínkou, Nicole Brownovou, ktorá po prvom rande prišla domov s roztrhanými nohavicami.	In 1977, Simpson began an affair with a beautiful blond 18-year-old, Nicole Brown, who came home from their first date with her pants ripped.	0.565164
No, bol trochu náruživý, povedala svojej kamarátke.	Well, he was a little forceful, ” she told a friend.	0.27907
O dva roky nato opustil Marguerite, aby mohol pokračovať vo vzťahu s Nicole.	Two years later, he left Marguerite to pursue a relationship with Nicole.	0.521245
Ale aféry pokračovali: Bond girls, playmate, modelky, herečky, skoro všetky boli belošky.	But the affairs continued: Bond girls, Playboy playmates, models, actresses, most of them white.	0.742551
Pre Simpsona boli ženy v jeho náručí len telami, ozdobami, dôkazmi víťazstva. ~~~ Tento postoj vykryštalizoval do tých najbrutálnejších následkov – v Simpsonovom susedstve sa začali pohybovať pasáci.	For Simpson, the women on his arm were not women but bodies, ornaments, evidence of conquests—an outlook he had seen taken to its most violent conclusions in the form of neighborhood pimps.	-0.0122642
Človeče, tí by zmlátili šľapku priamo na ulici, spomína Bell so smiechom.	Man, they’d beat a ho down right there on the street, ” Bell remembers, laughing.	0.50696
Aby všetky ženy vedeli, že takto sa budú správať ku každej, ktorá im neprinesie peniaze.	So that all the women would know this is the kind of treatment you’re gonna get if you don’t bring me my money. ”	0.236
Tieto ženy boli černošky, no názor, že ženy sú majetok, nepozná rasové bariéry.	Those women were black, but the basic notion of women as property knows no racial boundaries.	0.465756
Jeho nepotrestané správanie k Nicole Brownovej bolo dôkazom, že nebol obeťou rasizmu, na rozdiel od miliónov iných černochov.	Nicole Brown was proof to the world that Simpson, among the millions of black men caught in the maze of American racism, had risen above it.	0.438629
Nikto, ani černosi, ani belosi netušili, aký druh násilia, verbálneho alebo fyzického, sa dial za bránami Simpsonovho sídla.	What sort of abuse—verbal and physical—was going on behind the mansion gates, almost no one, black or white, guessed.	0.276
Alebo to nikoho nezaujímalo.	Or much cared.	0
To, čo sa deje v getách v L. A. , bolo rozpoznateľnejšie a lepšie preskúmané, ale O. J. Simpson o tom nič netušil.	The goings-on in the ghettos of L. A. were both more knowable and better explored—but not by O. J. Simpson.	0.857945
Vyhol sa účasti na akejkoľvek politike, ktorá by mohla pošpiniť jeho meno, tak ako aj jeho honbu za bohatstvom.	He eschewed involvement in any sort of politics that might tarnish his brand, and thus his pursuit of wealth.	0.293478
Ak bolo pre Simpsona jednoduché zabudnúť na svet, z ktorého pochádza, tak to bolo sčasti preto, lebo vo svete, do ktorého teraz patril, sa ľudia snažili čo najrýchlejšie zabúdať.	If it was easy for Simpson to forget the world he came from, that was partly because the world he now belonged to was invested in forgetting.	0.316626
Na začiatku dokumentu bol úžasný moment, ako sa Edelman mimo kameru pýta Simpsonovho spoluhráča, belocha z Juhokalifornskej univerzity, čo si pamätá z roku 1968.	In an incredible moment early on in the documentary, Edelman, off camera, asks a white USC teammate of Simpson’s what he remembers about 1968.	0.3725
Na obrazovke sa objaví montáž násilných udalostí: atentát na Martina Luthera Kinga, Jr. , a Roberta F. Kennedyho, burácajúci nominačný zjazd demokratov.	A montage of violent events flashes across the screen—Martin Luther King Jr. ’s assassination, Robert F. Kennedy’s assassination, the raucous Democratic National Convention.	0.515415
Edelman sa potom obráti na Simpsonovho spoluhráča, ktorý odpovie: Asi to, že sme vyhrali všetky zápasy a že sa O. J. stal slávnym. Všetci na škole si mysleli, že je to tá najúžasnejšia vec na svete.	Edelman then returns to the teammate, who says, I think of winning all the games, getting O. J. famous, everybody on campus thinking it’s the greatest thing on Earth.	0.646043
Na nič iné sme nemysleli.	That’s all we thought about.	0.259091
Nič iné sa nedialo.	There was nothing else going on. ”	0.0882353
No Edelman nás nenechá len tak zabudnúť, pretože Simpsonov príbeh bol úzko spätý so vzťahom medzi políciou a černošským Los Angeles a s príbehom komunity, ktorá tu žila.	BUT EDELMAN DOES NOT allow us to forget, because the Simpson story turned out to be intimately enmeshed with the story of black Los Angeles and its relationship with the police.	0.496407
Veď odtiaľ pochádzala Simpsonova porota a koniec koncov práve táto komunita držala jeho život v neistote.	This was the community the Simpson jury was drawn from, and ultimately the one that held his life in the balance.	0.29011
Dlhé roky sa väčšina krajiny zamýšľa, ako je možné, že Simpsona uznali nevinným.	For years, much of the country has wondered how Simpson could possibly have been found innocent.	0.243478
Existuje nevyrieknutý predpoklad, ktorý nás utvrdzuje v domnienke, že porota si myslela, že právny systém je spoľahlivý.	An unspoken assumption underlies this conjecture—that the jury understood the legal system to be credible.	0.26129
Dokument prichádza s množstvom obetí, ktoré zbila, zabila alebo obťažovala losangelská polícia, a tým objasňuje, že prevažne černošská porota oprávnene nemohla rozumieť právnemu systému.	What the film makes clear in piecing together a parade of victims beaten, killed, and harassed by the LAPD is that the predominantly black jury—quite rightfully—understood no such thing.	0.410566
Dokonca aj ja, radikál z vysokej školy, som chápal brutalitu losangelskej polície iba abstraktne.	Even I, college radical that I was, grasped the LAPD’s brutality only abstractly.	0.235714
Policajti boli suroví, pretože moje politické názory a moje vlastné skúsenosti s políciou naznačovali, že suroví budú.	The officers were brutal because my own politics, and my own experiences with the police, suggested they would be so.	0.287879
No slovo brutalita nevystihuje to, čo losangelská polícia v tých rokoch robila. ~~~ Polícia nielen že brutálne zaobchádzala s černošskými komunitami, ona ich terorizovala.	But brutality understates what the LAPD did in those years: It didn’t just brutalize black communities; it terrorized them.	-0.0538462
Zo samotného vedenia polície sa šíril teror.	The terror emanated directly from the top.	0.283784
Policajný veliteľ Daryl Gates, ktorý radikálnym spôsobom bojoval proti drogám, raz na schôdzi Senátu povedal, že bežný užívateľ drog by mal byť vyvlečený von a zastrelený.	Police Chief Daryl Gates was a drug warrior who once said at a Senate hearing that casual drug users ought to be taken out and shot. ”	0.417635
V roku 1982, po tom, čo mnohí černosi boli udusení škrtiacim chvatom, ktorý použila polícia, to Gates okomentoval: Niektorým černochom sa žily a tepny pri tomto chvate neroztiahnu tak rýchlo ako normálnym ľuďom.	In 1982, after numerous deaths of black people had resulted from police use of choke holds, Gates commented, In some blacks when it is applied, the veins or arteries do not open up as fast as they do in normal people. ”	0.474795
Prenikavý pocit neustálej nespravodlivosti dosiahol svoj vrchol v roku 1991, keď sa štyria policajti objavili na videu, ako nemilosrdne bijú Rodneyho Kinga a súd ich neskôr oslobodil.	The intensifying sense of constant injustice came to a head when four officers were videotaped ruthlessly beating Rodney King in 1991, only to be acquitted when they went on trial.	0.502444
Dva týždne po tom, ako bol King dobitý na smrť, americko-kórejský majiteľ potravín strelil zákazníčku, 15-ročnú černošku Latashu Harlingsovú, zozadu do hlavy.	Two weeks after King’s beating, a Korean American grocer shot a black customer, 15-year-old Latasha Harlins, in the back of the head.	0.233628
Majiteľ, ktorý bol usvedčený z úmyselného zabitia, dostal podmienku, pokutu a musel odpracovať verejnoprospešné práce, no do väzenia nešiel.	The grocer, convicted of voluntary manslaughter, received probation, a fine, and community service, but didn’t go to jail.	0.409782
Kým sa Simpson dostal pred súd, väčšina černošského obyvateľstva v Los Angeles mala dostatočný dôvod si myslieť, že presadzovaniu práva chýba nielen dôveryhodnosť, ale aj základná legitimita.	By the time Simpson came to trial, most of the black community in Los Angeles had ample reason to view law enforcement as lacking not just credibility but basic legitimacy.	0.575595
Diskriminácia podnecovala stratu rešpektu voči presadzovaniu práva a táto strata rešpektu zase premenila obete na tých, čo diskriminujú.	Victimization fed a loss of respect for law enforcement, and that loss of respect in turn transformed victims into victimizers.	0.42762
Záznam, na ktorom počas výtržností v Los Angeles vytiahli z nákladného auta Reginalda Dennyho a dosť dlho ho bili, je desivý.	The footage of the protracted beating of a white man, Reginald Denny, who was pulled from his truck during the Los Angeles riots, is chilling.	0.672298
No keď sa presadzovanie práva stane nevypočítateľným, obyvatelia sa uchýlia k svojmu vlastnému právu, ktoré je zakorenené v pradávnych impulzoch, kmeňovej lojálnosti a pomste.	But when law enforcement becomes capricious, citizens are apt to resort to their own law, rooted in ancient impulses, tribal loyalties, and vengeance.	0.244186
Zbitie Reginalda Dennyho bolo pomstou za zabitie Rodneyho Kinga.	The beating of Reginald Denny was vengeance for the beating of Rodney King.	0.263158
Pomsta za Kinga zohrala rolu v Simpsonovom oslobodení, tvrdí členka poroty Carrie Bessová.	And vengeance for King played a role in Simpson’s acquittal, according to one of the jurors, Carrie Bess.	0.476311
No pomsta je iba čiastočným vysvetlením Simpsonovho posledného veľkého úteku.	But revenge only partly explains Simpson’s last great escape.	0.216667
V roku 1994 černosi v mojom okolí pravdepodobne vytušili skutočnosť, ktorej som ja nerozumel. ~~~ Skutočnosť, na ktorú sa dokument Made in America priam znepokojujúco zameriava. Ide o to, že Simpson v podstate mohol zavraždiť svoju bývalú manželku a jej kamaráta, a porota rozhodla správne, keď ho vyhlásila za nevinného.	What I couldn’t fathom in 1994 was a reality that black people around me likely sensed and that Made in America brings into deeply discomfiting focus: that Simpson may well have murdered his ex-wife and her friend, and that the jury got it right in declaring him not guilty.	0.82963
Losangelská polícia dostala toho správneho, keď zatkla O. J. Simpsona.	When the LAPD collared O. J. Simpson, the police force had gotten its man.	0.845455
Dôkazy sa aj laikovi mohli zdať jednoznačné: dôveryhodná nahrávka domáceho násilia (Zabije ma! kričala Nicole Brownová Simpsonová policajtovi, ktorý reagoval na jeden z množstva jej telefonátov); krvavý odtlačok topánky, ktorý sa zhoduje so Simpsonovými topánkami; zakrvavené rukavice z miesta vraždy totožné s tými, ktoré mal Simpson doma; krv na Simpsonovom aute, na jeho ponožkách a v jeho kúpeľni.	The evidence all looked so obvious to a lay observer: the vivid record of spousal abuse (He’s going to kill me, ” Nicole Brown Simpson yelled to an officer who responded to one of her many calls); the bloody shoe print, which matched shoes Simpson owned; the bloody glove found at the murder scene, which matched the glove at Simpson’s home; the blood on Simpson’s car and his socks and in his bathroom.	0.491643
Pre Johnnieho Cochrana, Simpsonovho hlavného právnika, bol hnev namierený na policajnú brutalitu osobný.	For Johnnie Cochran, Simpson’s lead lawyer, rage against police brutality had personal roots.	0.259756
O svojej skúsenosti s losangelskými policajtmi, ktorí ho zastavili, keď šoféroval a vytasili naňho zbraň, hovorí: Nerobil som z toho aféru, ale nikdy som na to nezabudol. (Zdroj: Lee Celano/Getty)	About his experience of being pulled over by LAPD officers who then drew their guns, he said, I never made an issue of it. But I never forgot it. ” (Lee Celano / Getty)	0.229412
No členovia poroty nie sú laickými pozorovateľmi a právnici nemuseli úplne zbaviť Simpsona viny, a ani kompletne vyvrátiť všetky dôkazy.	But juries are not merely lay observers, and the defense needed to neither wholly exonerate Simpson nor completely contradict all the evidence.	0.287288
Právnikom jednoducho stačilo vyvolať dôvodnú pochybnosť.	His lawyers simply needed to instill reasonable doubt.	0.275
Losangelská polícia strávila desaťročia vštepovaním neistoty do myslí ľudí, ako sú tí v porote, ktorej väčšina boli černošky.	The LAPD had spent decades seeding that doubt in the minds of people like those on the jury, the majority of whom were black women.	0.297222
Aby sa uistili, že táto snaha mala žiaduci efekt, Simpson sa pridal na stranu aktivistu, ktorým dlho opovrhoval.	To make sure the doubt was harvested, Simpson leaned on the kind of activist he’d long spurned.	0.406667
Johnnieho Cochrana si dnes pamätáme takmer ako karikatúru parodovanú v seriáli Show Jerryho Seinfelda.	These days Johnnie Cochran is remembered almost in caricature, mocked on Seinfeld and derided as a race hustler.	0.28
Posmešne ho zobrazovali ako človeka, ktorý zapredal vlastnú rasu.		-0.3
V tom čase dokonca aj môj názor na Cochrana bol z časti ovplyvnený jeho satirizáciou z programu Saturday Night Live.	Back then, even my view of Cochran was shaped in part by the satirization of him on Saturday Night Live.	0.686711
Edelman vzkriesil menej známeho Cochrana, hrdinu černošských právnikov, ktorí boli prominentnými právnymi zástupcami pri boji proti policajnej brutalite od druhej polovice šesťdesiatych rokov.	Edelman resurrects a lesser-known Cochran, a hero to the black lawyers who’d been the prominent legal advocates in the fight against police brutality since the late 1960s.	0.37363
Denník New York Times napísal, že Cochran bol rozhorčený a namieril všetku svoju pozornosť a energiu proti polícii, ktorá pochybila.	The New York Times called Cochran’s rage at police misconduct all consuming. ”	0.732409
Oproti jeho stvárneniu v populárnej kultúre tento hnev bol skutočný a okamžite sa stal jeho súčasťou.	Contrary to the portrayals of him in popular culture, that rage was genuine and directly acquired.	0.289286
V roku 1980 bol Cochran počas šoférovania zastavený losangelskou políciou a bolo mu nariadené vystúpiť z auta.	In 1980, Cochran was pulled over by LAPD officers and instructed to get out of his car.	0.370833
Jeho dcéra a syn sedeli na zadných sedadlách.	His daughter and son were in the backseat.	0.275
Keď vystúpil, policajti mali zbrane už vytiahnuté.	When Cochran stepped out, the officers had their guns drawn.	0.253333
Situácia sa upokojila, až keď prehľadali auto a našli odznak. ~~~ V tom čase bol totiž tretím najvyššie postaveným právnikom u okresného prokurátora.	The tension was defused only when the officers searched the car and found a badge—Cochran was then the third-highest- ranking official in the district attorney’s office.	-0.0212598
Cochranovi sa dostalo osobného ospravedlnenia od šéfa polície.	Cochran received a personal apology from the chief of police.	0.283019
Nerobil som z toho aféru, napísal neskôr Cochran.	I never made an issue of it, ” Cochran later wrote.	0.292857
Ale nikdy na to nezabudnem.	But I never forgot it. ”	0.24
Simpson sa otočil chrbtom aktivistom bojujúcim za práva černochov zatiaľ, čo zarábal milióny tým, že sa pred belochmi zo strednej vrstvy prezentoval ako slušný človek. ~~~ No teraz, keď jeho život visel na vlásku, neváhal udeliť moc jednému z aktivistov.	Simpson, who had turned his back on race men while making millions selling himself as inoffensive to middle-class white people, didn’t hesitate to empower one of them now that his life was on the line.	-0.025
A tak Simpsonov tím právnikov prišiel s nečakaným riešením. ~~~ Simpson najprv odmietal tradíciu aktivistov, no zrazu bola financovaná zo zdrojov, ktoré Simpson nazhromaždil odmietaním tradície.	Thus the Simpson defense team presented an ironic alchemy—an activist tradition that Simpson had rejected, fueled by funds that he’d garnered rejecting it.	0.153195
O. J. mal peniaze, ktoré mohol a chcel minúť na svoju vlastnú ochranu, povedal jeden zo Simpsonových právnikov, Carl Douglas, Edelmanovi.	O. J. had money to spend and a willingness to spend it on his own defense, ” one of Simpson’s lawyers, Carl Douglas, says to Edelman.	0.957048
To bolo pre mňa hlavné.	This was a first for me. ”	0.285
Simpsonov prípad bol pretkaný rasizmom, či som ho vnímal ako černocha alebo nie.	Whether I saw Simpson as black or not, racism pervaded his case.	0.216667
Zohral rolu, ktorá siahala až za hranice viditeľných dôkazov.	The role it played went beyond the evidence on display.	0.255319
Rasizmus bol jednoznačne odhalený na záznamoch, na ktorých sa detektív losangelskej polície, Mark Fuhrman, vychvaľuje, ako, okrem iného, zbil černošských svedkov, ktorých volal negri a vysvetľoval, ako odignoroval ich ústavné práva.	Racism was not just blatantly revealed in the tapes of the LAPD detective Mark Fuhrman bragging about, among other things, beating black suspects, whom he identified as niggers, ” and explaining how he disregarded their constitutional rights.	0.387839
(Nepotrebuješ dôvod, aby si niekoho zatkol.	(You don’t need probable cause, ” Fuhrman said.	0.284615
Však ty si tu pán, povedal Fuhrman.	You’re God. ”)	-0.0923077
) Ďalej Fuhrman krivo svedčil, odmietal odpovedať na otázky, keď ho tvrdo vypočúvali a kládli kľúčovú otázku, či podstrčil nejaký dôkaz. ~~~ Rasizmus vytvoril živnú pôdu pre obhajobu tohto prípadu.	And racism was not just confirmed by Fuhrman’s exposure as a perjurer who was then maneuvered into pleading the Fifth in response to grilling by the defense—including the pivotal question of whether he’d planted any evidence.	-0.0205357
Fakt, že losangelská polícia môže falošne obviniť černocha, bolo v Los Angeles krutou realitou. ~~~ Simpsonovi právnici si pripravoval tieto stereotypy ako zbraň, ktorou zaútočia na bojovom poli.	Racism formed the substrate of the defense’s case: The notion that the LAPD might frame a black man was completely within the realm of possibility for black people in Los Angeles.	-0.018
Vytrvalo atakovali mnohé očividné nedostatky z nedbanlivosti vo vyšetrovaní a v procese zbierania dôkazov. ~~~ Deka prehodená cez telo Nicole Brownovej Simpsonovej bola vystavená vláknam a DNA iných ľudí v dome; jemný materiál bol zbieraný holými rukami; impsonovu krv dali do obálky, ktorú mal na starosti policajt a priniesol ju do Simpsonovho domu.	Simpson’s legal team worked those preconceptions the way a boxer might work an opponent’s wound, relentlessly attacking the numerous flaws in an investigation and an evidence-collection process that were egregiously careless: the blanket thrown over Nicole Brown Simpson’s body, exposing it to fibers and the DNA of others in the house; the sensitive material collected bare-handed; the sample of Simpson’s blood stored in an envelope in an officer’s care and brought to Simpson’s house.	0.041806
Belosi považovali tieto chyby za malichernosti a aj napriek nim sa domnievali, že proces prebehne spravodlivo. ~~~ Na druhej strane, bol tento proces spojený s dôverou černochov, ktorých poháňala túžba po vyšetrovaní, ktoré by malo istý štandard, no, bohužiaľ, sa ho nedočkali.	Errors that to white viewers could look like technicalities in what they presumed to be an abstractly fair” trial tapped into fundamental questions of trust for black viewers, who saw up close a machine operated by humans striving for an ideal standard, but often falling woefully short.	0.0538787
Koľko černochov polícia usvedčila na základe podobne nízkych štandardov vyšetrovania?	How many black men had the LAPD arrested and convicted under a similarly lax application of standards?	0.261039
Ak dokážete neprávom odsúdiť O. J. Simpsona, ktorý má milióny dolárov a tím tých najlepších právnikov, tak vieme, čo dokážete spraviť obyčajnému Afroameričanovi a iným slušným obyvateľom, povedal aktivista Danny Bakewell davu v L. A. po tom, čo zverejnili Fuhrmanove nahrávky.	If you can railroad O. J. Simpson with his millions of dollars and his dream team of legal experts, ” the activist Danny Bakewell told an assembled crowd in L. A. after the Fuhrman tapes were made public, we know what you can do to the average African American and other decent citizens in this country. ”	0.712116
Toto tvrdenie bolo proroctvom.	The claim was prophetic.	0.218182
Štyri roky po tom, čo Simpsona zbavili viny, elitná jednotka losangelskej polície bojujúca proti gangom bola zapletená do akcie, v rámci ktorej sa dopúšťala všetkého od mučenia a podsúvania dôkazov, až po krádeže a bankové lúpeže. ~~~ Toto je najhorší korupčný škandál v dejinách losangelskej polície, informoval denník Los Angeles Times.	Four years after Simpson was acquitted, an elite antigang unit of the LAPD’s Rampart division was implicated in a campaign of terror that ranged from torture and planting evidence to drug theft and bank robbery—the worst corruption scandal in LAPD history, ” according to the Los Angeles Times.	0.0412088
Mesto bolo donútené prepustiť viac ako 100 odsúdencov a zaplatiť 78 miliónov dolárov ako odškodné.	The city was forced to vacate more than 100 convictions and pay out $78 million in settlements.	0.46875
Ukázalo sa, že Simpsonova porota rozumela losangelskej polícii až príliš dobre.	The Simpson jury, as it turned out, understood the LAPD all too well.	0.237931
Jej závery o tom, ako oddelenie neschopne narábalo s dôkazmi, boli potvrdené krátko po procese, keď prezreli mestské laboratórium.	And it s conclusions about the department’s inept handling of evidence were confirmed not long after the trial, when the city’s crime lab was overhauled.	0.404867
Ak máte za úlohu, vyčistiť ulice od kriminálnikov, ale kvôli vašej neschopnosti ich nemôžete súdne stíhať, tak potom túto úlohu nedokážete plniť, vraví Mike Williamson, bývalý člen losangelskej polície, niekoľko rokov po procese.	If your mission is to sweep the streets of bad people … and you can’t prosecute them successfully because you’re incompetent, ” Mike Williamson, a retired LAPD officer, remarked years later about the trial, you’ve defeated your primary mission. ”	0.461319
Simpsonov veľký útek stále leží mnohým v žalúdku.	O. J. SIMPSON’S GREAT ESCAPE still sticks in the craw of much of the country.	0.153488
O jeho právnikoch sa nehovorí ako o schopných obhajcoch, namiesto toho sú znevažovaní ako bezohľadní ignoranti, ktorým pravidlá nič nehovoria. ~~~ Vsadili na rasu obžalovaného v prípade, ktorý mal byť o vedeckých dôkazoch, aj keby boli len čiastočne využité.	Simpson’s lawyers are not praised as adept defense attorneys, but disparaged as unscrupulous flouters of the rules who played the race card” in a case that should have been about science—no matter how poorly that science was deployed.	-0.0166667
Rozhorčenosť pretrváva. ~~~ Simpson si mohol dovoliť najlepších obhajcov (Cochrana), ktorých si za svoje peniaze mohol kúpiť.	Resentment continues to fester that Simpson was afforded the best defense money could buy, in the form of Cochran.	0.0788235
Urazilo ma to, hovorí Edelmanovi Marcia Clarková, hlavná žalobkyňa, pretože Cochran veľmi vážnu tému, rasovú nerovnosť, využil pri obhajovaní muža, ktorý nechcel mať nič spoločné s černošskou komunitou.	It offended me, ” Marcia Clark, the lead prosecutor, says to Edelman, because he was using a very serious, for-real issue—racial injustice—in defense of a man who wanted nothing to do with the black community. ”	0.401744
Aj mňa to urazilo.	It offended me, too.	0.2625
Simpson je posledný človek na svete, ktorý by mal byť odmenený za boj proti losangelskej polícii.	Simpson should have been the last person in the world to reap a reward from the struggle waged against the LAPD.	0.440326
Niekoľko mesiacov po tom, ako bol zbavený viny, som sledoval, ako sa prihovára v černošskom kostole v D. C. , kde ho privítala miestna komunita.	Months after he was acquitted, I watched him give a speech at a black church in D. C. , where he was embraced by the local community.	0.610043
Darovali mu tradičný africký odev.	He was presented with traditional African garb.	0.193548
Černošský nacionalista Malik Zulu Shabazz ho privítal, ako keby bol reinkarnáciou Malcolma X.	The black nationalist Malik Zulu Shabazz greeted Simpson as if he were the reincarnation of Malcolm X.	1.13885
Nikdy som sa nehanbil za to, že som černoch, no v tejto chvíli som tú hanbu naplno pocítil.	I have not, in my life, ever felt much shame in being black. That was a moment when I felt it deeply.	0.276
Vtedy som ešte nevedel, že černosi nie sú počítačový program, ale komunita ľudí, každý z nich je iný, sú úžasní a sú omylní, plní zmiešaných podnetov a nerestí, ktoré sa nájdu v každej pestrej spoločnosti.	I hadn’t yet learned that black people are not a computer program but a community of humans, varied, brilliant, and fallible, filled with the mixed motives and vices one finds in any broad collection of humanity.	0.456202
No dôležitejšie je to, že som nerozumel tomu, čo spája Simpsona a černošskú komunitu.	More important, I did not understand the ties that united Simpson and the black community.	0.283562
Simpson najprv utekal pred spravodlivosťou, potom prestal, bol súdený za vraždu a opäť sa vyhýbal spravodlivosti. ~~~ Od čias hnutia za ľudské práva to bol najšokujúcejší dôkaz jednoznačnej rovnocennosti.	When O. J. Simpson ran from justice, returned to it, was tried for murder, and eluded justice again, it was the most shocking statement of pure equality since the civil-rights movement.	0.0690045
Simpson zabil Nicole Brownovú Simpsonovú a Rona Goldmana.	Simpson had killed Nicole Brown Simpson and Ron Goldman.	0.954422
Myslel som si to vtedy a teraz som o tom presvedčený.	I suspected that then, and I am sure of it now.	0.252632
