Po niekoľkých desaťročiach snahy rozšíriť ich využitie sa novodobé materiály stávajú dôležitým prostriedkom v biomedicíne a biotechnológii.	After taking several decades to come into widespread use, smart materials are now becoming an important tool in biomedicine and biotechnology.	0.297561
Kombinovanie polymérov s inými funkčnými chemickými látkami môže viesť k takmer neobmedzenému množstvu inteligentných materiálov.	Combining polymers with other functional chemistries can lead to an almost unlimited variety of smart materials.	0.244898
V blízkej budúcnosti budú inteligentné polyméry hrať rolu pri sledovaní zmien kyslosti v obličkách na monitorovanie homeostáz, pri prijímaní podnetov z enzýmov v krvných cievach na odstránenie embólie, pri nasadení biochemických zlúčenín na úpravu zdeformovaných proteínov pri neurodegeneratívnych chorobách, ako napríklad Alzheimerova, Parkinsonova a Huntignotonova choroba. Ďalej na sformovanie chemických a biochemických stimulov na regulovanie zložiek krvi, ako napríklad glukóza alebo na blokovanie chemických signálov, ktoré môžu spustiť vytvorenie melanómu.	In the near future, smart polymers will play a role in keeping track of changes in acidity in the kidneys to monitor homeostasis; taking their cue from enzymes in the blood vessels to repair embolisms; deploying biochemical compounds onsite to fix misshapen proteins in neurodegenerative diseases like Alzheimer’s, Parkinson’s, and Huntington’s; forming chemical and biochemical stimuli to regulate blood components such as glucose; and blocking chemical signals that can trigger melanoma.	0.287968
Inteligentné materiály reagujúce na určité spúšťacie mechanizmy, ako napríklad svetlo a teplo, boli kedysi len teóriou a dnes sú realitou.	Once a mere theoretical possibility, smart materials that respond to individual triggers like light and temperature are now a real possibility.	0.575714
Takéto materiály sú nesmierne zaujímavé pre vedcov hľadajúcich nové cesty ako liečiť chorobu a obísť, občas kontraproduktívne, prešibanú obranyschopnosť tela.	Such materials are of immense interest to scientists searching for new ways to treat disease and bypass the body’s cunning, but often counterproductive, defenses.	0.3
Popri materiáloch reagujúcich na teplotu je aj iná kategória zaujímavých inteligentných polymérov, ktorých zmeny spúšťa svetlo.	Alongside materials that respond to changes in temperature is another category of intriguing smart polymers whose changes are triggered instead by light.	0.246903
Keďže je svetlo čistý stimul umožňujúci diaľkové ovládanie bez fyzického kontaktu, tieto foto-reaktívne polyméry sú užitočné pre široké spektrum použitia zahŕňajúc mikro-elektrotechnické systémy, senzory, textil, povlaky a fotovoltaické články.	Because light is a clean stimulus that allows remote control without physical contact, these photo-responsive polymers are useful for a wide variety of applications, including smart optical systems, micro-electrochemical systems, sensors, textiles, coatings, and solar cells.	0.36682
Jedna sféra pútajúca pozornosť je zmena farby foto-reaktívnych materiálov ako reakcia na svetlo.	One area receiving attention now is photo-responsive smart materials that change their color in response to light.	0.250588
V našom laboratóriu práve skúmame určitú skupiny polymérov, ktoré obsahujú organickú zlúčeninu spiropyrán.	In our laboratory we are currently investigating a particular family of polymers that incorporate an organic compound called spiropyran.	0.224211
Táto molekula má štruktúru prstenca, ktorá sa otvára a zatvára pri vystavení určitých vlnových dĺžok svetla, alebo v niektorých prípadoch, keď je vystavená zmenám kyslosti.	This molecule has ring- shaped structures that open and close when exposed to certain wavelengths of light—or, in some cases, when exposed to changes in acidity.	0.273723
Štiepenie prstenca na mieste špecifickej väzby kyslíka a uhlíka vytvára chromofor (oblasť, ktorá produkuje farbu) pohlcujúca viditeľné svetlo.	Cleavage of the ring at the site of a specific carbon-oxygen bond creates a chromophore (color-producing region) that strongly absorbs visible light.	0.450752
Ako iné inteligentné materiály spomínané v tomto článku, tento polymér je prísľubom pre biomedicínske využitie pri obalení a cielenom uvoľňovaní liekov.	Like other smart materials discussed in the article, this polymer holds promise for biomedical application in the encapsulation and targeted release of drugs.	0.290977
V úplne odlišnom využití, textilný priemysel využíva foto-reaktívne polyméry vtkané do odevu na vyrobenie oblečenia, ktoré mení farbu, alebo ktoré odkryjú vytlačený vzor na svetle, alebo vlákna, ktoré sa správajú ako indikátory pri veľkom vystavení svetla. Prostriedok, ktorý môžeme oceniť napríklad pri detskom oblečení.	In a completely different application, the textile industry uses photo-responsive polymers woven into apparel to produce garments that change their color or reveal a print pattern in the sunlight, or fibers that act as an indicator of over-exposure to the sun—a feature that might be appreciated, for example, in children’s clothing.	0.294624
Inteligentné materiály môžu byť navrhnuté tak, aby viedli elektróny ako odpoveď na elektromagnetickú radiáciu. absorbovanie polyméry nefungujú rovnako účinne ako polovodičový materiál v počítačovom priemysle.	Smart materials can be designed to conduct electrons in response to the absorption of electromagnetic radiation.	0.0336735
Polyméry sú však považované za budúcu generáciu pre fotovoltaické zariadenia, lebo nie sú finančne náročné na spracovanie.	However, polymers are considered the next-generation material for photovoltaic devices because they are so inexpensive to manufacture.	0.266355
Prebieha výskum na zlepšenie výkonu solárnych článkov na polymérovej báze.	Research is under way to improve the performance of polymer-based solar cells.	0.290909
V ideálnom prípade by tieto polymérové modely reagovali na široké spektrum svetla (infračervené žiarenie na viditeľných vlnových dĺžkach) a zvyšovali by ich účinnosť napríklad pri zariadeniach výkonovej elektroniky.	Ideally, the polymer models would respond to a broad range of light (infrared to visible wavelengths), increasing their efficiency to (for example) power electronic devices.	0.337385
Na to, aby sme dosiahli tento cieľ, naša skupina pracuje na rozvíjaní materiálov známe ako parafenylénové oligomery.	Working toward this goal, our group has an ongoing interest in developing materials known as paraphenylene oligomers.	0.29703
Experimentálne a teoretické štúdie vykonané v našej skupine ukazujú, že spojenie týchto molekúl s ďalšími molekulovými skupinami spôsobuje, že foto-reaktívne polyméry absorbujú dlhšie červenšie vlnové dĺžky svetla.	Experimental and theoretical studies carried out in our group show that tagging those molecules with additional molecular groups causes the photo-responsive polymers to absorb longer, redder wavelengths of light.	0.293514
Zisťujeme, že tieto materiály môžu byť nastavené tak, aby reagovali na ešte širšie spektrum svetla pridaním skupiny silných akceptorov elektrónov.	These materials could be tuned to respond to an even broader range of light, we find, by adding a strong electron acceptor group.	0.244444
Polyméry obsahujúce prechodné kovy, ako napríklad ruténium, sú obzvlášť vhodné ako prostriedok priťahujúci svetlo, ktorý zjednodušuje absorbovanie svetla a presun elektrónov (a/alebo presun energie) v materiáli.	Polymers containing transition metals such as ruthenium are particularly well suited as antennae for attracting light, a feature that facilitates its absorption and electron transfer (and/or energy transfer) within the material.	0.39186
Naša skupina v spolupráci s kolegami na Univerzite Severnej Karolíny.	Our group, in collaboration with colleagues at the University of North Carolina.	0.255738
Chapel Hill používa ruténium s kombináciou polyméru na vytvorenie hybridného systému (ako napríklad ruténium (II) polypyridyl derivovaný polystyrén), ktorý vyzerá veľmi sľubne.	Chapel Hill, has been using ruthenium in combination with a polymer to form a hybrid system (such as ruthenium (II) polypyridyl derivatized polystyrene) that looks particularly promising.	0.679766
Vďaka tejto metóde môžeme bližšie porozumieť tomu, ako sa elektrónová a fotónová energia presúva v rámci foto-reaktívnych polymérov.	This line of investigation should yield a better understanding of how electron and photon energy are transported within the photo-responsive polymers.	0.419102
Naše nedávne štúdie ukazujú, že relatívne priestorové usporiadanie medzi iónmi ruténia v polyméri je kľúčovým parametrom ovplyvňujúcim spôsob prenosu elektrónov cez systém.	Our latest studies suggest that the relative spatial arrangement between the ruthenium ions in the polymer is a key parameter influencing the way it transports electrons through the system.	0.280263
Tieto objavy nás prinášajú bližšie k objaveniu polymérových solárnych článkov, ktoré môžu konkurovať uhlíku a paroplynovým elektrárňam.	Such discoveries are bringing us closer to developing polymer-based solar cells that can compete with coal- and natural gas–fired power plants.	0.29
Pochopenie internej fyziky o polyméroch absorbujúcich svetlo je nevyhnutné pre uskutočnenie ďalších pokrokov.	Understanding the internal physics of light-absorbing polymers is essential to making further advances.	0.280435
Aj keď sa všeobecne využívajú fotovoltaické články na báze kremíka, solárne zariadenia na báze polymérov by mohli tiež ponúknuť značné výhody.	Although conventional, silicon-based photovoltaic arrays are already in widespread use, polymer- based solar devices would offer significant advantages.	0.268293
Polyméry nie sú finančné náročné na rozvoj, sú ľahko spracovateľné do veľkých manufaktúrnych množstiev a ľahko sa prispôsobujú širokej škále dizajnových kritérií.	Polymers are inexpensive to develop, easily scaled to large manufacturing quantities, lightweight, and adaptable to a wide variety of design criteria.	0.411173
Zlepšenie a následné komercializovanie tejto technológie by prospelo nielen priemyslu solárnych panelov, ale aj textilnému. Bolo by možné vtkať elektrovodivé inteligentné materiály do látok, čo sa môže využiť v textilnom priemysle.	Refining and commercializing this technology would benefit not only the solar panel industry but also the textile industry, as it becomes possible to weave electron-conducting smart materials into fabrics.	0.259551
V skutočnosti sa tieto dve odvetvia môžu jedného dňa prekrývať.	In fact, the two industries may someday come to overlap.	0.25625
Začlenenie foto-reaktívnych látok do textilu by mohlo zmeniť spôsob interagovať s našou elektronikou, čo môže v konečnom dôsledku viesť k zariadeniam, ktoré môžu byť nabíjané v kontakte s naším oblečením.	Incorporating light-responsive smart materials into textiles could transform the way we interact with our electronics, perhaps leading ultimately to devices that can be charged by contact with our clothing.	0.394886
Jeho veličenstvo kráľovná	The King Herself	0.12
Prečo sa Hatšepsut rozhodla vládnuť starovekému Egyptu ako muž, kým jej nevlastný syn stál v tieni?	What motivated Hatshepsut to rule ancient Egypt as a man while her stepson stood in the shadows?	0.285185
Jej múmia a životný príbeh vychádzajú na svetlo sveta.	Her mummy, and her true story, have come to light.	0.264286
Na končekoch jej prstov prekvapivo niečo nesedelo.	There was something strangely touching about her fingertips.	0.24
Očné jamky mala naplnené čiernou živicou a v nozdrách nevkusne vložené tenké kúsky látky.	Her eye sockets were packed with blind black resin, her nostrils unbecomingly plugged with tight rolls of cloth.	0.225974
Ľavé ucho jej pokleslo do mäsa na boku lebky a na hlave už nemala prakticky žiadne vlasy.	Her left ear had sunk into the flesh on the side of her skull, and her head was almost completely without hair.	0.231081
Naklonil som sa k otvorenej vitríne v Egyptskom múzeu v Káhire a hľadel na čosi, čo je pravdepodobne telo faraónky Hatšepsut, výnimočnej ženy vládnucej v Egypte od roku 1458 pred Kristom. V súčasnosti nie je až tak známa pre jej vládnutie počas zlatého veku egyptskej 18. dynastie, ale skôr pre jej trúfalosť nechať sa vyobrazovať ako muž.	I leaned toward the open display case in Cairo's Egyptian Museum and gazed at what in all likelihood is the body of the female pharaoh Hatshepsut, the extraordinary woman who ruled Egypt from 1479 to 1458 B. C. and is famous today less for her reign during the golden age of Egypt's 18th dynasty than for having the audacity to portray herself as a man.	0.39711
V ovzduší som necítil očarujúcu vôňu myrhy, len akýsi ostrý a kyslý zápach pravdepodobne vytvorený počas mnohých storočí, ktoré strávila vo vápencovej hrobke.	There was no beguiling myrrh perfume in the air, only some sharp and sour smell that seemed minted during the many centuries she had spent in a limestone cave.	0.413636
Bolo pre mňa ťažké predstaviť si, že toto zničené torzo bolo kedysi veľkolepou vládkyňou žijúcou pred mnohými rokmi, o ktorej sa písalo: Pohľad na ňu bol krajší než čokoľvek iné.	It was hard to square this prostrate thing with the great ruler who lived so long ago and of whom it was written, To look upon her was more beautiful than anything.	0.264179
Jediná ľudská črta sa zablysla v pozostatkoch jej končekoch prstov bez nechtov, kde ustúpilo mumifikované tkanivo tvoriac ilúziu manikúry a vyvolávajúc nielen našu pravekú márnivosť, ale aj naše chabé dôvernosti i krátky a pominuteľný dojem zo sveta.	The only human touch was in the bone shine of her nailless fingertips where the mummified flesh had shrunk back, creating the illusion of a manicure and evoking not just our primordial vanity but our tenuous intimacies, our brief and passing feel for the world.	0.374761
Objav stratenej múmie Hatšepsut sa stal mediálnou senzáciou pred dvoma rokmi, no celý príbeh sa rozvíjal pomaly, po krokoch, pripomínajúc skôr kriminálnu drámu zo seriálu CSI ako Dobyvateľov stratenej archy.	The discovery of Hatshepsut's lost mummy made headlines two summers ago, but the full story unfolded slowly, in increments, a forensic drama more along the lines of CSI than Raiders of the Lost Ark.	0.37328
V skutočnosti pátranie po Hatšepsut vykazovalo rozsah, pri ktorom sa muselo klasické archeologické náradie ako hoblíky a kefky doplniť CT skenermi a gradientovými termocyklérmi pre určenie DNA.	Indeed the search for Hatshepsut showed the extent to which the trowels and brushes of archaeology's traditional toolbox have been supplemented by CT scanners and DNA gradient thermocyclers.	0.399826
V roku 1903 objavil preslávený archeológ Howard Carter sarkofág kráľovnej Hatšepsut v 20. hrobke v Údolí kráľov (Valley of the Kings) – KV20.	In 1903 the renowned archaeologist Howard Carter had found Hatshepsut's sarcophagus in the 20th tomb discovered in the Valley of the Kings—KV20.	2.24652
Jeden z troch sarkofágov pripravených pre Hatšepsut bol prázdny.	The sarcophagus, one of three Hatshepsut had prepared, was empty.	0.3
Vedci netušili, kde sa jej múmia nachádza, a či vôbec prežila ničivé ťaženie jej spoluvládcu a hlavného následníka Thutmosa III. Takmer všetky jej obrazy ako kráľovnej sa postupne vysekávali z chrámov, pamätníkov a obeliskov.	Scholars did not know where her mummy was or whether it had even survived the campaign to eradicate the record of her rule during the reign of her co-regent and ultimate successor, Thutmose III, when almost all the images of her as king were systematically chiseled off temples, monuments, and obelisks.	0.205181
Výskum, ktorý, ako sa zdá, konečne vyriešil záhadu, sa uskutočnil v roku 2005 Zahi Hawass, vedúci Projektu egyptskej múmie a generálny tajomník Najvyššej rady pre starožitnosti Egypta.	The search that seems to have finally solved the mystery was launched in 2005 by Zahi Hawass, head of the Egyptian Mummy Project and secretary general of the Supreme Council of Antiquities.	1.69286
Hawass a tím vedcov si vzali na mušku múmiu nazývanú KV60a. Tá sa našla pred viac ako storočím, no nepovažovali ju za natoľko dôležitú, aby ju premiestnili z podlahy menšej hrobky v Údolí kráľov.	Hawass and a team of scientists zeroed in on a mummy they called KV60a, which had been discovered more than a century earlier but wasn't thought significant enough to remove from the floor of a minor tomb in the Valley of the Kings.	0.419895
KV60a blúdila celú večnosť bez rakvy, ba dokonca bez sprievodu pohrebných figúrok znázorňujúcich kráľovských služobníkov.	KV60a had been cruising eternity without even the hospitality of a coffin, much less a retinue of figurines to perform royal chores.	0.476389
Nemala žiadne oblečenie, ani nijakú ozdobu hlavy, bola bez šperkov, zlatých sandál či zlatej špičky a ozdobných návlekov na prsty, nemala žiaden z pokladov, aké boli objavené v hrobke faraóna Tutanchamóna, ktorý bol v porovnaní s Hatšepsut len obyčajným smrteľníkom.	She had nothing to wear, either—no headdress, no jewelry, no gold sandals or gold toe and finger coverings, none of the treasures that had been provided the pharaoh Tutankhamun, who was a pip-squeak of a king compared with Hatshepsut.	0.327792
Ak by nedošlo k náhodnému objavu zuba, dokonca aj za pomoci špičkovej technológie použitej na rozlúštenie jedného z najpozoruhodnejších egyptských prípadov nezvestnej osoby, KV60a by ešte stále bývala ležala osamote v tme a jej meno a prestíž by zostali v zabudnutí.	And even with all the high-tech methods used to crack one of Egypt's most notable missing person cases, if it had not been for the serendipitous discovery of a tooth, KV60a might still be lying alone in the dark, her royal name and status unacknowledged.	0.420108
Dnes sa jej múmia uchováva v jednej z dvoch miestností kráľovských múmií v Egyptskom múzeu, kde je na pamätných doskách v arabčine a angličtine označená ako Jeho veličenstvo kráľovná Hatšepsut a kde je opäť pohromade s jej vzdialenou rodinou faraónov Novej ríše.	Today she is enshrined in one of the two Royal Mummy Rooms at the Egyptian Museum, with plaques in Arabic and English proclaiming her to be Hatshepsut, the King Herself, reunited at long last with her extended family of fellow New Kingdom pharaohs.	0.278261
Vzhľadom na to, že Hatšepsut upadla do zabudnutia, ťažko si predstaviť faraóna, ktorého túžba po večnej sláve by bola silnejšia.	Given the oblivion that befell Hatshepsut, it's hard to think of a pharaoh whose hopes of being remembered are more poignant.	0.288679
Zdá sa, že sa viac obávala anonymity než smrti.	She seems to have been more afraid of anonymity than of death.	0.51
Bola jedným z najvýznamnejších panovníkov podporujúcich kultúrny rozmach v čase jednej z najvýznamnejších dynastií Egypta.	She was one of the greatest builders in one of the greatest Egyptian dynasties.	0.11194
Dala postaviť a renovovať chrámy a svätyne tiahnuce od vrchu Sinaj až po Núbiu.	She raised and renovated temples and shrines from the Sinai to Nubia.	0.259322
Takisto dala postaviť štyri žulové obelisky týčiace sa na rozsiahlom chráme veľkého boha Amona v Karnaku, ktoré patria medzi najimpozantnejšie aké kedy boli postavené.	The four granite obelisks she erected at the vast temple of the great god Amun at Karnak were among the most magnificent ever constructed.	0.225
Nechala postaviť stovky sôch so svojou podobizňou a v kameni zanechala pravdivé no i vymyslené správy o jej pôvode, hodnosti, minulosti, dokonca sa z času na čas úprimne zverila aj so svojimi myšlienkami a nádejami.	She commissioned hundreds of statues of herself and left accounts in stone of her lineage, her titles, her history, both real and concocted, even her thoughts and hopes, which at times she confided with uncommon candor.	0.295055
Svoje obavy, ktoré aj dnes znejú takmer pôvabne neisto, vyryla do jedného z jej obeliskov v Karnaku: Tomu sa moje srdce prispôsobí, čo ľudí uspokojí.	Expressions of worry Hatshepsut inscribed on one of her obelisks at Karnak still resonate with an almost charming insecurity: Now my heart turns this way and that, as I think what the people will say.	0.202381
Tí, ktorí moje pamiatky neskôr uvidia a o mojich skutkoch povedia.	Those who see my monuments in years to come, and who shall speak of what I have done.	0.236842
Na počiatku sužovali Novú ríšu mnohé neistoty, ale je isté, že v čase, keď sa narodila Hatšepsut, Egypt naberal na sile.	Many uncertainties plague the early history of the New Kingdom, but it's clear that when Hatshepsut was born, Egyptian power was waxing.	0.255446
Ahmose, zakladateľ 18. dynastie a pravdepodobne starý otec Hatšepsut, vyhnal obávanú útočnú skupinu Hyksósov, ktorá po dve storočia okupovala severnú časť údolia Nílu.	Her possible grandfather Ahmose, founder of the 18th dynasty, had driven out the formidable Hyksos invaders who had occupied the northern part of the Nile Valley for two centuries.	0.410616
Keď syn Ahmosa Amenhotep I. nepočal syna, ktorý by bol jeho nástupcom, obávaný generál známy ako Thutmose I. sa vraj dostal sobášom s princeznou do kráľovskej línie.	When Ahmose's son Amenhotep I did not produce a son who lived to succeed him, a redoubtable general known as Thutmose is believed to have been brought into the royal line since he had married a princess.	0.454286
Hatšepsut bola najstaršou dcérou Thutmosa a jeho Veľkej kráľovskej manželky, kráľovnej Ahmose, a pravdepodobne blízkou príbuznou kráľa Ahmosa.	Hatshepsut was the oldest daughter of Thutmose and his Great Royal Wife, Queen Ahmose, likely a close relative of King Ahmose.	0.562518
Thutmose mal ale s inou kráľovnou syna nazývaného Thutmose II., ktorý zdedil korunu, keď sa jeho otec pobral na večný odpočinok.	But Thutmose also had a son by another queen, and this son, Thutmose II, inherited the crown when his father rested from life.	0.561299
Ako bolo v tom čase kvôli zachovaniu kráľovského rodu zaužívané, Thutmose II. a Hatšepsut sa vzali. ~~~ Dnes by bol takýto sobáš spochybňovaný pre pohlavný styk s vlastnou sestrou a aj pre vtedy tak rozšírenú polygamiu.	Adhering to a common method of fortifying the royal lineage—and with none of our modern-day qualms about sleeping with your sister—Thutmose II and Hatshepsut married.	0.031993
Splodili spolu jednu dcéru a jeho ďalšia manželka Isis porodila Thutmosovi mužského dediča, ktorého mu Hatšepsut nedala.	They produced one daughter; a minor wife, Isis, would give Thutmose the male heir that Hatshepsut was unable to provide.	0.457843
Thutmose II. nevládol dlho a ako zistili CT skenery o 3 500 rokov neskôr, na druhý svet ho poslal infarkt. ~~~ V tom čase bol jeho dedič Thutmose III. ešte len dieťa.	Thutmose II did not rule for long, and when he was ushered into the afterlife by what CT scans 3, 500 years later would suggest was heart disease, his heir, Thutmose III, was still a young boy.	0.166396
Podľa vtedajšej tradície Hatšepsut prevzala aktívnu kontrolu ako kráľovská regentka mladého faraóna.	In time-honored fashion, Hatshepsut assumed effective control as the young pharaoh's queen regent.	0.289655
A tak sa začala jedna z najfascinujúcejších dôb starovekého Egypta.	So began one of the most intriguing periods of ancient Egyptian history.	0.284746
Hatšepsut spočiatku jednala v prospech svojho nevlastného syna rešpektujúc zvyklosti predchádzajúcich kráľovien v otázkach riešenia politických záležitostí, zatiaľ čo sa ratolesť priúčala, ako držať opraty.	At first, Hatshepsut acted on her stepson's behalf, careful to respect the conventions under which previous queens had handled political affairs while juvenile offspring learned the ropes.	0.26319
Onedlho sa však začalo ukazovať, že jej vláda bude iná.	But before long, signs emerged that Hatshepsut's regency would be different.	0.17234
Reliéfy z raného obdobia znázorňujú Hatšepsut zastávať kráľovské funkcie pri obete bohom a pri zabezpečovaní obeliskov z lomov čiernej žuly v egyptskom meste Asuán.	Early reliefs show her performing kingly functions such as making offerings to the gods and ordering up obelisks from red granite quarries at Aswan.	0.261905
O pár rokov sa zhostila úlohy kráľa Egypta, najvyššej moci v krajine.	After just a few years she had assumed the role of king of Egypt, supreme power in the land.	0.218644
Jej nevlastný syn, v tom čase už plne schopný chopiť sa trónu, zostal len ako následník.	Her stepson—who by then may have been fully capable of assuming the throne—was relegated to second-in-command.	0.210811
Hatšepsut pokračovala vo vládnutí, ktoré napokon trvalo 21 rokov.	Hatshepsut proceeded to rule for a total of 21 years.	3.51333
Čo ovplyvnilo Hatšepsut, aby skoncovala s tradičnou úlohou kráľovskej regentky?	What induced Hatshepsut to break so radically with the traditional role of queen regent?	0.278873
Stála za tým sociálna či vojenská kríza?	A social or military crisis?	0.18
Snáď politika dynastie?	Dynastic politics?	0.233333
Zásah boha Amona?	Divine injunctions from Amun?	0.09375
Alebo hlad po moci?	A thirst for power?	0.3
Nevieme presne čo, ale niečo ju donútilo zmeniť spôsob, akým sa nechávala vyobraziť na verejných pamiatkach, vraví Peter Dorman, známy egyptológ a predseda Americkej bejrútskej univerzity.	There was something impelling Hatshepsut to change the way she portrayed herself on public monuments, but we don't know what it is, says Peter Dorman, a noted Egyptologist and president of the American University of Beirut.	0.587602
Jednou z najťažších vecí je prísť na to, aký bol jej motív.	One of the hardest things to guess is her motive.	0.241463
Mohlo by to mať nejakú súvislosť s pokrvnou líniou.	Bloodlines may have had something to do with it.	0.578049
Na pomníku v pieskovcových lomoch v oblasti Gebel el Silsila ju označuje jej správca a architekt Senenmut ako na kráľovu prvorodenú dcéru.	On a cenotaph at the sandstone quarries of Gebel el Silsila, her chief steward and architect Senenmut refers to her as the king's firstborn daughter, a distinction that accents her lineage as the senior heir of Thutmose I rather than as the chief royal wife of Thutmose II.	0.54462
Táto pocta zdôrazňuje skôr jej pôvod ako najstaršej dedičky Thutmosa I., a nie jej postavenie kráľovskej manželky Thutmosa II.	Remember, Hatshepsut was a true blue blood, related to the pharaoh Ahmose, while her husband-brother was the offspring of an adopted king.	0.425229
Nezabúdajme, že Hatšepsut mala skutočne modrú krv, pretože bola príbuznou faraóna Ahmosa, zatiaľ čo jej manžel a zároveň i brat bol potomkom adoptovaného kráľa.	The Egyptians believed in the divinity of the pharaoh; only Hatshepsut, not her stepson, had a biological link to divine royalty.	0.36
Egypťania verili v božstvo faraónov.	Still, there was the small matter of gender.	0.254545
Iba Hatšepsut bola biologicky prepojená s božským majestátom, nie jej nevlastný syn. ~~~ Avšak stále tu rezonovala jedna maličkosť týkajúca sa pohlavia. ~~~ Kráľovstvo sa malo odovzdať z otca na syna, nie na dcéru.	The kingship was meant to be passed down from father to son, not daughter; religious belief dictated that the king's role could not be adequately carried out by a woman.	-0.107634
Podľa náboženskej viery žena nie je schopná adekvátne vykonávať úlohu kráľa.	Getting over this hurdle must have taken great shrewdness from the female king.	0.295522
Na zdolanie tejto prekážky musela kráľovná, ktorá vystupovala ako muž, disponovať lišiackou prefíkanosťou.		-0.3
Po smrti jej manžela už nebolo prioritnou hodnosťou Hatšepsut titul Kráľova manželka, ale Manželka boha Amona. ~~~ Toto oslovenie jej pravdepodobne vydláždilo cestu na trón.	When her husband died, Hatshepsut's preferred title was not King's Wife, but God's Wife of Amun, a designation some believe paved her way to the throne.	-0.0246094
Na jednej soche z červenej žuly je Hatšepsut jasne vyobrazená so ženským telom no so znakmi kráľa, a to slávnostnou prúžkovanou šatkou nemes so znakom uraeus, znakom kobry so vztýčenou hlavou.	In one seated red granite statue, Hatshepsut is shown with the unmistakable body of a woman but with the striped nemes headdress and uraeus cobra, symbols of a king.	0.445652
V niektorých chrámových reliéfoch je odetá v tradičnom priliehavom rúchu siahajúcom po členky, avšak s postojom príznačným pre kráľa, čiže chodidlami ďaleko od seba, znázorňujúc tým vykročenie.	In some temple reliefs, Hatshepsut is dressed in a traditional restrictive ankle-length gown but with her feet wide apart in the striding pose of the king.	0.215267
Ako roky plynuli, bolo pre ňu očividne jednoduchšie vyhýbať sa otázke pohlavia.	As the years went on, she seems to have decided it was easier to sidestep the issue of gender altogether.	0.221739
Formálne sa nechávala zobrazovať ako mužský vládca bez akýchkoľvek ženských čŕt s čelenkou faraóna, faraónskou suknicou s vyčnievajúcim cípom a falošnou briadkou príznačnou pre faraónov.	She had herself depicted solely as a male king, in the pharaoh's headdress, the pharaoh's shendyt kilt, and the pharaoh's false beard—without any female traits.	0.35845
Mnoho jej sôch, podobizní a textov sa javí ako súčasť dobre prešpekulovanej mediálnej kampane na upevnenie jej vlády ako panovníčky a ospravedlnenie jej previnení.	Many of her statues, images, and texts seem part of a carefully calibrated media campaign to bolster the legitimacy of her reign as king—and rationalize her transgression.	0.409362
V reliéfoch na jej zádušnom chráme interpretovala príbeh o jej nástupe na trón ako splnenie božieho plánu a uviedla, že jej otec Thutmose I. ju zamýšľal nielen dosadiť na trón, ale mohol sa tiež zúčastniť na jej korunovácii.	In reliefs at Hatshepsut's mortuary temple, she spun a fable of her accession as the fulfillment of a divine plan and declared that her father, Thutmose I, not only intended her to be king but also was able to attend her coronation.	0.447463
Kazety znázorňujú veľkého boha Amona ako sa objavuje ešte predtým, než sa matka kráľovnej Hatšepsut prezlečie za Thutmosa I.	In the panels the great god Amun is shown appearing before Hatshepsut's mother disguised as Thutmose I.	0.401894
