Disney zosobnil starú americkú myšlienku, že ak môžete uchopiť dostatok americkej divočiny, tak vytvoríte svet bez problémov, ktoré obťažujú ľudí na miestach, akou je americká oblasť Frost Belt (silná priemyselná oblasť typická veľmi nízkymi teplotami).	Disney acted out the old American idea that if you can just grab hold of enough American wilderness, you can create a world free of the problems that besiege people in places like the frost belt.	0.273395
Kerouac vytvoril Ameriku bez koreňov tam, kde ľudia nikdy nedosiahnu svoj cieľ, nehľadiac na to, ako dlho blúdia.	Kerouac evoked a rootless America where, no matter how far people wander, they never reach their destination.	0.457092
Dovtedy žiadni dvaja muži, takí americkí a takí odlišní, neskončili v Orlande.	Never were two men so totally American and so totally different, yet both of them wound up in Orlando.	0.225
Toto prorocké zblíženie nás núti sa spýtať: Pokiaľ ide o budúcnosť Ameriky, kto z nich bol lepším prorokom pre Ameriku a jej obyvateľov?	This prophetic convergence raises the question: When it came to America's future, who was the better prophet of what, since then, we and our country have become?	0.245217
Pripomínajú ľudia usmievajúce sa Disneyho postavičky?	As a people, and as a nation, are we more like Disney's smiling characters?	0.214286
Alebo sú skôr podobní napoly strateným tulákom, akými bol Kerouac a jeho skupina?	Or do we more resemble half- lost wanderers, like Kerouac and his crew?	0.464286
Zdá sa, že odpoveď je jasná. ~~~ Na celom svete je Orlando synonymom kultúry zábavných parkov, ktoré predbehlo celú Ameriku.	The answer seems clear: Around the world, Orlando is synonymous with the theme-park culture that has overtaken America.	0.0640179
Nikde inde sa nedá vnímať triumf Disneyho ducha tak celistvo. ~~~ A keď mesto lepšie spoznáte, ešte aj objavíte čosi paradoxné.	Nowhere else does the triumph of the Disney ethos seem so total, yet something paradoxical emerges when you get to know the place.	-0.00280374
O päťdesiat rokov neskôr Kerouacov nepokojný duch sa stále voľne vznáša nad zľavami orlandských nákupných centier, zakráda sa v parkoch pre obytné vozidlá a potĺka sa vo fast-foodoch.	Fifty years on, Kerouac's restless spirit is still on the loose in Orlando's discount shopping malls. ~~~ It prowls the RV parks and hangs out at the fast-food franchises.	-0.0146853
Všade tam, kde ľudia zanedbávajú kosenie trávy, alebo preklínajú platby za auto, je Kerouacova časť Orlanda, pretože títo ľudia, presne ako Kerouac, pochádzajú z nejakého iného miesta.	Wherever people neglect to mow the grass, or curse the car payments, you're in Kerouac's Orlando because they, like him, were once from someplace else.	0.227344
Aspoň na chvíľu sa pre nich Orlando zdá také, ako pre tohto apoštola generácie beatnikov - ako miesto, kde účty nikdy nedovŕšia dátum splatnosti a minulosť nezanecháva svoje stopy.	And, for a while at least, Orlando seemed to them, as it did to the Beat apostle, like a place where the utility bills never get past due and the past can never haunt you.	0.467391
Prečo nenavštíviť Orlando a neobjaviť šialenú floridskú scénu dokonale čistých diaľnic a úžasných supermarketov? napísal Kerouac Lawrencovi Ferlinghettimu, beatnickému básnikovi v roku 1961.	Why not come to Orlando and dig the crazy Florida scene of spotlessly clean highways and fantastic supermarkets? Kerouac wrote Lawrence Ferlinghetti, the Beat poet, in 1961.	0.632432
Ani v Orlande Kerouac nikdy nenašiel únik.	But in Orlando, as everywhere else he roamed, Kerouac never did find escape.	0.447973
Po tom, čo zavesil prácu spisovateľa na klinec, Florida sa stala miestom, kde mohol holdovať alkoholu a koniec koncov i odísť zo sveta.	Florida became for him, after he stopped writing, a place to drink, and ultimately a place to die.	0.498716
Malý domček na Clouser Avenue 1418, kde Kerouac napísal svoj román, dnes slúži ako akýsi literárny časový úsek, v ktorom spisovatelia pracovne strávia tri mesiace v nádeji, že sa naladia na Kerouacov geniálny spisovateľský kanál.	The little house at 1418 Clouser Avenue where Kerouac wrote his novel now serves as a kind of literary time- share, where writers spend three months at a stint, hoping to channel Kerouac's manic genius.	0.502071
Veci však nedopadli podľa Disneyho predstáv.	Things did not turn out as Walt Disney intended either.	0.2475
Ľudia sa tlačili do Čarovného kráľovstva, aby na vlastné oči zazreli to, čo videli televízii. Epcot, Disneyho uctievaný plán vytvárania futuristickej komunity, kde žili a pracovali v harmónii so špičkovou technikou, sa však nikdy nestal realitou.	People thronged to the Magic Kingdom to see with their own eyes what they'd seen on TV, but Epcot, Disney's cherished project of creating a futuristic community where people lived and worked in high-tech harmony, never became a reality.	0.442564
Disneyho nekonečná interpretácia zajtrajška ľudí nezaujala.	People weren't interested in Disney's edgeless version of tomorrow.	0.272727
Epcot bol takým zlyhaním, že Disneyho vedúci pracovníci museli uvažovať nad jeho zastavením, no namiesto toho ho preniesli do inej turistickej atrakcie.	Epcot was such a failure that Disney officials faced the embarrassing prospect of shutting it down. Instead, they turned it into another tourist attraction.	0.425889
Dnes Epcot ponúka nostalgickú napodobeninu dovolenky pri mori zo štyridsiatych rokov, takmer 100 kilometrov od najbližšieho mora, spolu s tematickými kulinárskymi možnosťami na miestach, akými je napríklad cesta vo vesmíre Gay Paree alebo pobrežie Key West.	Today Epcot offers a nostalgic pastiche of a 1940s seashore vacation 60 miles (97 kilometers) from the nearest sea, along with food options themed to places like Gay Paree, a space ride, and Key West time- share options.	0.479656
V snahe vytvoriť Kráľovstvo mágie, ktoré bude imúnne voči nečistotám a komplikáciám, Disney odštartoval šialenstvo nekontrolovaného rastu, ktoré stále nevykazuje známky spomalenia.	By trying to create a Magic Kingdom immune from squalor and complexity, Disney touched off an orgy of uncontrolled growth that still shows no signs of abating.	0.502661
Zaniknuté zábavné parky znečistili krajinu Orlanda tak, ako mŕtve fabriky v upadnutej priemyselnej časti.	Extinct theme parks litter the Orlando landscape the way dead factories mark the rust belt.	0.242308
Nefungujúce atrakcie ako napr. Splendid China, ktorá predstavuje miniatúru Veľkého čínskeho múru, skrachovali, pretože boli príliš realistické.	Defunct attractions like Splendid China, which featured a miniature Great Wall, went bankrupt because they were too realistic.	0.584242
Nedokázali poskytnúť to, čo sa od zábavných parkov očakáva, teda fantáziu zodpovedajúcu presne tomu, ktorú si žiada platiaca verejnosť.	They failed to provide what all successful theme parks must: fantasies conforming exactly to what the paying public expects to get.	0.283929
Dnes je Orlando kotlom všetkých spoločenských charakteristík, ktoré sa Disney snažil kontrolovať.	Today Orlando is a cauldron of all the communal characteristics Disney sought to control.	0.722577
V obvode Parramore si môžete kúpiť do zásoby kokaín, pervitín alebo takzvaný anjelský prach.	In its Parramore district, you can stock up on crack, meth, and angel dust.	0.419048
Podľa výskumnej spoločnosti Morgan Quitno sa Orlando pripojilo k mestám ako Detroit alebo St. Louis, ktoré sú v rebríčku 25 najnebezpečnejších miest v Amerike.	According to the Morgan Quitno research firm, in 2006 it joined such cities as Detroit and St. Louis to become one of the 25 most dangerous cities in America.	0.88626
Preto pri bránach obytných častí stretnete ozbrojené stráže a prístup do nich získate len na základe pozvania.	The result is armed guards at the gates of communities where entry is solely by invitation.	0.22987
Oblasť Orlanda má jednu z najvyšších bilancií v úmrtí chodcov v rámci najväčších regiónov v krajine.	The Orlando area also has one of the highest pedestrian death rates among the largest metro regions in the country.	0.261628
Štyri desaťročia po Disneyho osudnom prelete je Orlando miestom enormnej vitality, rozmanitosti, ohavnosti, nesúladu, vynaliezavosti, možností a nesplnených nádejí, kde žiadny klaun v kostýme nemôže ľuďom povedať, ako žiť, alebo nechať ich parkovať bez pomoci.	Four decades after Disney's fateful flyover, Orlando is a place of enormous vitality, diversity, ugliness, discord, inventiveness, possibility, and disappointed hopes, where no clown in a character costume can tell people how to live, let alone where to park.	0.543243
Keď si na ceste domov tisíce obyvateľov Orlanda v stredu popoludní 2. februára 2005 pustili rádio v aute, boli šokovaní.	On the afternoon of Wednesday, February 2, 2005, thousands in Orlando got a shock when they turned on their car radios for the drive home.	0.261765
Ženská hudobná skupina The Supreme sa rozpadla. Kenny Rogers dostal padáka.	The Supremes had been banished;Kenny Rogers had been given the boot.	0.764407
Bez varovania či vysvetlenia orlandská rádiová stanica FM 100.3, stanica starých dobrých oldiesoviek, zmizla (známa tiež ako Veľká stovka /z angl. The Big 100s/)	Without warning or explanation, FM 100.3, Orlando's famous golden oldies station (known as the Big 100s), had vanished.	0.66883
Vznikla Rumba 100.3, ktorá sa stala novým domovom pre najhorúcejšie latino hity.	Rumba 100.3, new home of central Florida's hottest Latin sounds, had taken its place.	0.748681
Pre fanúšikov oldiesoviek to bolo, akoby im do auta vstúpili Hispánci s magnetofónmi.	To oldies fans, it was as though Hispanics with boomboxes had somehow gotten inside the car.	0.283784
Tento incident presne definuje charakter dnešného Orlanda.	The incident provides a defining parable of Orlando today.	0.663235
Pred 25 rokmi sa Orlando zdalo byť bezpečným nebom pre tých, ktorí hľadali útočisko pred imigrantmi prúdiacimi do Miami a pretvorili život v celej krajine.	Twenty-five years ago, Orlando seemed a safe haven to those seeking to avoid the immigrants pouring into Miami and reshaping life all over the country.	0.636779
Ich slogan bol: Posledný odchádzajúci Američan, prosím, prines vlajku.	Will the last American to leave please bring the flag? the saying went.	0.285
Tak, ako náhly zánik Veľkej stovky preukázal, že Miami bolo ozajstnou predpoveďou a nie pomätením.	But as the sudden death of the Big 100s demonstrated, Miami was a forecast, not an aberration.	0.652215
Dnes žije v orlandskej oblasti viac ako 400 000 Hispáncov, čo tvorí 20 % celej populácie.	Today there are about 400, 000 Hispanics in the Orlando area—20 percent of its entire population.	0.444471
Neoznámené preniknutie stanice Rumba 100.3 naznačuje viac ako len rozširujúcu sa rôznorodosť v Orlande.	The unannounced intrusion of Rumba 100.3 indicates something more than Orlando's expanding ethnic diversity.	0.683516
Jednu generáciu dozadu tajné rozhodnutie Walta Disneyho zmenilo osud Orlanda bez toho, či s tým obyvatelia súhlasili alebo nie.	A generation ago, Walt Disney's secret decision transformed Orlando's destiny without anybody being asked whether they wanted it or not.	0.278182
Ďalšie tajné rozhodnutie tentokrát od diaľkových pracovníkov v gigantickom rádiovom koglomeráte Clear Channel Communications určilo, akú hudbu budú ľudia v Orlande počúvať a týmto marketingovým ťahom odštartovali rast populácie Hispáncov v Orlande.	Now another secret decision, this time by faraway executives at Clear Channel Communications, the giant radio conglomerate, had determined what kind of music people in Orlando would hear. ~~~ The growth of Orlando's Hispanic population itself was touched off by a marketing decision.	0.0841743
Spätne v deväťdesiatych rokoch mala realitná spoločnosť problém s predajom nehnuteľností vo výstavbe zvanej Buenaventura Lakes, a preto sa ich marketingové oddelenie rozhodlo uvádzať svoje reklamy v hlavných novinách v Portoriku v španielčine.	Back in the 1990s, when a real estate company was having trouble selling property in a development called Buenaventura Lakes, their marketing department decided to advertise in Spanish in the major newspapers in Puerto Rico.	0.531722
A tak zrazu obyvatelia začali prúdiť do oblasti Orlanda a vytvárali alternatívu k prevažne kubánskej Miami pre Hispáncov na Floride.	Suddenly Puerto Ricans were flowing into the Orlando area—creating an alternative to predominantly Cuban Miami for Hispanics in Florida.	0.436842
Orlando je dnes také multikultúrne ako New York a zápasí s globalizáciou rovnako ako ktorékoľvek centrum importu a exportu.	Today Orlando is as multicultural as New York, and as much in the throes of globalization as any import-export center.	0.582
Jeho rast priniesol do centrálnej Floridy ľudí s viac ako 70 rozličnými jazykmi.	Its growth has brought people speaking more than 70 languages to central Florida.	2.6528
Nachádzajúce sa južne od Orlanda a východne od Disney Worldu, prevažne kovbojské a hispánske mesto sa za necelých 10 rokov úplne zmenilo.	Kissimmee, south of Orlando and just east of Disney World, has gone from being a cowboy town to mostly Hispanic in less than ten years.	0.547477
A ani Disney World neušiel pred chápadlami rôznorodosti, čo si všimlo i pár turistov, keď ich deti objímali Goofyho alebo Minnie, teda lacné pracovné sily zo Srí Lanky alebo Dominikánskej republiky.	The tentacles of diversity have penetrated Disney World too. ~~~ Few tourists realize it, but when their kids hug Goofy and Minnie they might be embracing low-wage workers from places like Sri Lanka and the Dominican Republic.	-0.0186391
Niektorí sa však sťažujú, že prisťahovalci z rozvojových krajín nie sú skutoční Američania.	Some complain the newcomers from developing countries aren't real Americans.	0.247059
Iní sa zasa sťažujú, že prisťahovalci zo severu nie sú skutoční Floriďania.	Others complain the newcomers from up north aren't real Floridians.	0.269492
Máme dočasných obyvateľov, hovorí Linda Chapinová, bývalá komisárka Orange County.	We have drive-by citizens, says Linda Chapin, a former Orange County commissioner.	0.837121
Ľudia sa sťahujú na Floridu, no nie sú jej oddaní.	People move to Florida, but they don't bring their loyalties with them.	0.164286
V kontexte psychologickej vykorenenosti a morálneho odlúčenia sa vynára otázka, či problémy vznikajúce kvôli nekontrolovanému rastu sa dajú vyriešiť.	In such a situation of psychological rootlessness and moral detachment, the question isn't whether the problems arising from unchecked growth can be solved.	0.443182
Otázkou je, či je vôbec možné ich pomenovať.	It's whether there is any chance of them being addressed at all.	0.173684
Dovolili sme Floride, aby sa stala nákupným centrom, a to je naše veľké nešťastie, hovorí Chapinová.	We've allowed Florida to be turned into a strip mall, says Chapin. This is our great tragedy.	0.622172
V čase, keď stála na čele komisie v Orange County, rozhodla o nekonečnom stavebnom boome.	While she was head of the county commission, she played a major role in unleashing Orlando's nonstop building boom.	0.213158
Navrhla nové kongresové centrum v Orlande spolu s ďalšími projektmi, ktoré mali zaistiť prúdenie ľudí do tejto oblasti.	She masterminded Orlando's new convention center, along with other projects intended to assure an influx of people into the area.	0.276699
Na budove kongresového centra je moje meno vyryté zlatom, na čo je moja mama veľmi pyšná, hovorí.	My name is in gold letters over at the convention center, she says. ~~~ It makes my mother proud.	-0.0056962
 ~~~ Dnes pracuje ako vedúca územného plánovania na Univerzite v Centrálnej Floride, kde rieši problematiku spomalenia rastu mesta a to, ako ho urobiť humánnejším.	These days, as head of urban planning at the University of Central Florida, she thinks up ways to slow down Orlando's growth, and humanize it.	-0.0226891
Chapinová je jednou z mála hnacích síl Orlanda, ktorá sa tu aj narodila.	Chapin is one of the very few movers and shakers in Orlando who was born here.	0.285246
Dom pri jazere, kde stále žije, sa však kedysi nepovažoval za časť Orlanda.	Back then, of course, the lakeside house where she still lives was not considered part of Orlando.	0.210938
	It was way out in the country.	-0.3
Nachádzal sa mimo mesta, v dnešnom centre oboch letísk a Disney Worldu.	Today it's on the downtown side of both the airport and Disney World.	0.515252
V blízkosti sa nachádza nepekná časť South Orange Blosson Trail, ktorú môžeme považovať za štúdiu ohavnosti. Ponúka všetko, od obrovského množstva videí pre dospelých, až po nefalšovanú juhoindickú vegetariánsku kuchyňu.	Nearby, South Orange Blossom Trail is a six-lane case study in ugliness, offering everything from wholesale adult videos to genuine south Indian vegetarian cuisine.	0.434366
V pôvodnom dome Chapinovej je stále to, čo Orlandu najviac chýba - autenticita.	Still, the old Chapin place has what people in Orlando miss the most: authenticity.	0.286765
Sme tu a nikde inde, hovorí plytká bahnitá voda, ťažký vzduch a mach s malými červenými chrobákmi.	We are here; we are nowhere else, say the shallow muddy water, and the heavy air, and the Spanish moss with the little red bugs in it.	0.206024
Chapinová hovorí o dôvodoch, prečo sa zo začiatku mohlo zdať, že zmena a rast môže byť jasným požehnaním, mysleli sme si, že rast dokážeme zvládnuť.	Chapin talks about the reasons why, back in the beginning, change and growth seemed like such unalloyed blessings. ~~~ We thought we could manage growth, she says.	-0.0144
V jej živote myšlienka toho, že vo svete je všetko možné, zmenila Orlando na mesto, ktoré trápia problémy s obyvateľmi a predmestiami.	In her lifetime, a sky's-the-limit scenario has turned Orlando into a city of suburban, and human, dilemmas.	0.565591
No stále sme v Amerike, kde všetko môžeš a dokážeš.	Still, this is can-do America.	0.122222
A tak opäť optimistická Linda Chapinová hovorí: Len kvôli tomu, že sme zničili 90 percent neznamená, že nemôžeme urobiť úžasné veci so zvyšnými desiatimi.	As Linda Chapin, suddenly reverting to optimism, puts it: Just because we've ruined 90 percent of everything doesn't mean we can't do wonderful things with the remaining ten percent!	1.80773
Rozrastanie sa Orlanda môžete sledovať z vesmíru.	You can see Orlando's sprawl from outer space.	0.27
Navštívte stredné školy Cypress Creek High School alebo Meadow Woods Middle School a uvidíte ľudskú komplikovanosť očami študentov.	Go to Cypress Creek High and Meadow Woods Middle School, and you see the human complexity in the eyes of its students.	1.19533
Ako som vyrazil do pohybujúcej sa časti Orlanda, obloha zružovela.	The sky was streaked dawn pink as I headed out to the moving edge of Orlando.	0.274138
Približne 25 kilometrov na juhozápad som prišiel na miesto, kde explózia floridskej populácie zmenila divočinu na rozsiahlu nočnú obytnú časť.	Fifteen miles (24 kilometers) southwest of downtown, I reached the latest spot where central Florida's population explosion has turned wilderness into tract housing overnight.	0.229839
Ak by sa mesiac niekedy zastavil, vyzeralo by to asi takto.	If the moon were ever settled, this is how it would be done.	0.293878
Celé susedstvo so stovkami domov, aby sem okamžite prišlo.	Whole neighborhoods, consisting of hundreds of houses, arrived here instantly.	0.188235
Takto tu ľudia žijú.	So have the people who live in them.	0.1
Demograficky tieto dve školy spadajú do oblasti orlandskej oblasti.	Demographically, these two schools match the Orlando area.	0.253846
Bieli i čierni sú tu iba v menšine a práve ostatní tvoria dominantné etnikum.	Here both whites and blacks are in the minority; other is the dominant ethnicity.	0.281538
Vybral som tieto dve, pretože sú to typické školy, ktoré keď navštívim, nájdem niečo neobyčajné. ~~~ Dve miesta, kde sa viac ako 8 000 študentov a učiteľov snaží prísť na nové spôsoby výuky a spolunažívania.	I picked them because they are typical schools, but when I visited I found something extraordinary—two places where more than 8, 000 students and teachers were finding new ways to learn, and new ways to live together.	0.0671965
Na týchto školách sa nepovažujú za veľké veci iba tie, ktoré deti a ich učitelia vidia v televízii.	At Cypress Creek and Meadow Woods, great events are not just things these kids and their teachers see on TV.	0.274699
Ale najmä tie, ktoré sa dotýkajú ľudských životov.	They impinge on people's lives.	0.128571
Zástupkyňa riaditeľa na strednej škole Cypress Creek sa spamätávala po roku strávenom v Iraku.	At Cypress Creek, the assistant principal, Vanessa Colon Schaefer, was still putting her life back together after more than a year in Iraq.	0.368293
Keď jej oddiel Národnej gardy poslali späť, zanechala priepasť v živote svojej dcéry a školy.	When her National Guard unit was sent there, she left a gap in the life of her daughter, and of this school.	0.4575
Na školách Meadow Woods a Cypress Creek študujú deti z viac ako dvesto krajín sveta.	Kids from nearly 200 countries study at the two schools.	0.15625
Keď sa ich spýtam, za normálnych okolností vykríknu meno svojej krajiny, hovorí Chuck Rivers, riaditeľ školy Meadow Woods.	Normally they shout out their countries when I ask them, says Chuck Rivers, the principal at Meadow Woods.	0.878246
No bol tu jeden malý chlapec, ktorý ledva šepkal, tak som sa ho spýtal, no on stále šepkal to isté.	But one time a little boy just whispered.	-0.0942857
Musel som sa k nemu zohnúť, aby som ho počul.	When I asked him again, he kept whispering, so I bent down to hear him.	0.12973
‘Irak,‘ povedal.	He whispered 'Iraq' in my ear.	0.1125
Rivers bez falošného sentimentu dodáva: Všetko sú to moje deti.	Rivers adds, with no false sentimentality, They're all my kids.	0.572727
Rozprával som sa so študentmi z Kolumbie, Brazílie, Jamajky, Kórey, Filipín, Iránu, Ruska, Slovenska a Indie a chcel som na tomto mieste pochopiť miešanie kultúr.	I talk to students from Colombia, Brazil, Haiti, Jamaica, Korea, China, the Philippines, Iran, Russia, Slovakia, and India—and I've just begun to plumb the mutations.	0.291367
Moja mama je z Nemecka a otec z Madagaskaru, povedalo jedno malé dievčatko.	My mother is from Germany, one little girl says, and my father is from Madagascar.	0.276562
Rozmanitosť tu nie je zámerom, programom alebo životným štýlom.	Diversity is not an objective, or a program, or a lifestyle here.	0.294545
Je to život.	It is life.	0.27
Na strednej škole Cypress Creek som sa rozprával so žiakmi, ktorí dostali prospechové štipendium.	At Cypress Creek I talk with the school's National Merit Scholars.	0.652632
Navštívil som triedy s autistickými, nepočujúcimi lebo inak postihnutými deťmi.	I visit classes where kids are autistic or deaf or otherwise different.	0.25082
Cítil som dôležitosť toho, aby deti zapadli do kolektívu s tými, ktoré sú odlišné, či už mentálne, telesne, rasovo alebo kultúrne.	I sense how important it is for children to find themselves integrated, every day, with kids who are different from them mentally, physically, racially, culturally.	0.218919
Riaditeľka Cypress Creek je žena, riaditeľ Meadow Woods je čierny.	The principal of Cypress Creek is a woman; the principal of Meadow Woods is black.	1.33401
Pamätá si časy rasovej izolovanosti.	He remembers the days of racial segregation.	0.245455
No dnes sa musí naučiť, že rasové bariéry nie sú jediná vec, ktorá sa stala úplne nepodstatnou, nejde tu o žiadne vymývanie mozgov.	Now he is in charge of a learning experience where racial barriers aren't the only things that have become meaningless.	0.273267
Na strednej škole sa deti učia to, čo sa v predchádzajúcich rokoch v škole neučili, napríklad ako dirigovať symfonický orchester, ako cirkuluje krv, ako opraviť vodovodný kohútik, či ako riešiť problémy otvorene a nenásilne.	No dumbing down is going on here. ~~~ At the middle school, kids are studying things I never learned in all my years of schooling: how to conduct a symphony, how blood circulates, how to fix a faucet, how to solve disputes openly and nonviolently.	0.0273399
Keď sme odchádzali, riaditeľ povedal niečo, čo navždy zostane v mojej mysli: Robíme to každý deň.	As we leave, the principal says something that sticks in my mind: We do this every day.	0.254167
V jedno ráno som zažil niečo, čo ľudia v Orlande volajú zážitok diaľnice I-4.	One morningI have what people in Orlando call the I-4 experience.	0.251786
Vyrazil som autom na obedňajšiu schôdzku, z ktorej sa nakoniec stala schôdzka poobedňajšia.	I zoom off in my car for a midday appointment. ~~~ It turns into an afternoon appointment by the time I get there.	-0.0225
Celú hodinu autá stále stoja bez pohnutia.	For most of an hour, every car sits motionless.	0.275676
Po prvýkrát rozumiem tomu, čo ľudia myslia pod pojmom parkovisko I-4.	For the first time I truly understand what people mean when they call I-4 Orlando's parking lot.	0.195
Nič nie je jasnejšie ako to, že Orlando nevyhnutne potrebuje železničné spojenie Disney Worldu, centra, letiska a miest medzi nimi.	Nothing is more obvious than the need for a light- rail system connecting Disney, downtown, the airport, and points in between.	0.428968
Ale ľudia v Orlande milujú svoje autá tak, ako nenávidia platenie daní.	But in Orlando people love their cars as much as they hate paying taxes.	0.295
Kvalita ciest v Orlande sa po nedávno zničenej divočine, na ktorej teraz cesty ležia, už len horšuje.	Orlando's roads, so recently slashed through the wilderness, are already deteriorating.	0.269231
Je to exkluzívny uzavretý obytný objekt, v ktorom sa domy predávajú za milióny dolárov.	It is Orlando's most exclusive gated community.	0.0642857
Domy pri jazere, ktoré už nie sú obrovské ale priam gigantické, však nezodpovedajú cene ani prestíži. ~~~ V Orlande sú výsledky možné vidieť naozaj všade.	Homes sell there for millions of dollars, though the land—your typical lakeside lots—and the houses—McMansions ranging from the merely huge to the stupendously gargantuan—account for neither the prices nor the prestige.	-0.0692308
V zápche máte čas na premýšľanie.	The results are visible everywhere you look in Orlando.	0.103448
Ja som skončil pri rozmýšľaní o tom, aký je rozdiel medzi skutočným obrazom Orlanda a ako si mesto svoj obraz predstavuje.	Being stuck in traffic gives you time to think;I wind up thinking about how different Orlando's image of itself is from reality.	0.285437
Iróniou je, že ľudia sem prídu hľadať disneyovský pokoj a keď ho nájdu, zabudnú na nepokojné rozpory Ameriky bez koreňov.	The irony of Orlando is that people go there in search of Disneyesque tranquillity—and by doing so, they've unleashed upon the place all the rootless, restless contradictions of America.	0.136893
Je tu hustá doprava, vysoká kriminalita, ale obyvatelia si stále vážia to, že nevidia utrápené výrazy ľudí v iných mestách.	Here is big city traffic, big city crime, yet people in Orlando cherish the idea that they have escaped the trials people face in other cities.	0.26
Dnes ráno bola taká zima, že som si v aute zapol kúrenie, i keď väčšinu roka je tu šialené teplo.	On this morning, it is cold, so cold I turn the car heater to high—though at most times of year it is stultifyingly hot.	0.227848
Predo mnou je nadjazd, po ktorom prechádza veľký nákladiak a práve ním si dotváram americký obraz, ktorý Orlando o sebe má.	Ahead of me is an overpass, and just to complete the refutation of Orlando's all-American self- image, a big semi lunges across the overpass.	0.393094
Nápis gigantickými červenými písmenami Lucky Noodles v angličtine aj v čínštine značí, že vezie zásoby do ázijského supermarketu v Orlande.	Lucky Noodles, giant red characters proclaim, both in English and Chinese; it is carrying supplies for Orlando's Asian supermarkets.	0.434348
Z nejakého dôvodu mi nákladiak s pôvabným čínskym písmom pripomína text starej disneyovskej zvučky: Keď si budeš priať pri hviezdach, nezáleží na tom, kto si, to, po čom tvoje srdce prahne, k Tebe príde.	For some reason the truck with the graceful Chinese writing on it reminds me of the lyrics of that old Disney theme song:When you wish upon a star Makes no difference who you are Anything your heart desires Will come to you.	0.277193
Ak pridáš do sna srdce, pieseň pokračuje, žiadne želanie nie je príliš veľké.	If your heart is in your dream, the song goes on to allege, No request is too extreme.	0.281818
Na tému náboženstva sa Disney veľmi nevyjadroval, v jeho viac ako 40 animovaných filmoch len ťažko nájdete zmienku o Bohu a v žiadnom zo zábavných parkov nenájdete kostol.	Walt Disney was silent on the subject of religion; there is scarcely a mention of God in his more than 40 animated movies and none of his theme parks includes a church.	1.62961
Podľa Disneyho je gospel optimistickým posolstvom sebarealizácie, ak niečo veľmi chcete, tak sa vaše sny naozaj splnia.	Instead, the gospel according to Disney is an optimistic message of self-fulfillment, of wanting something so badly that your dreams really do come true.	0.388782
Produkcia pomarančov v Orange County už dávno neexistuje.	Orange County no longer produces oranges.	1.04363
Mráz, choroby a rozvoj krajiny ničil miestne háje.	Frost, disease, and development have destroyed the groves.	0.245455
Čo sa stalo, že prestali produkovať slnečný mok, ako pomarančový džús nazývali v reklamách?	What happens to the land once it stops producing what the juice ads once called liquid sunshine?	0.292405
Jedného dňa som navštívil niekdajší pomarančový háj nazývaný Isleworth.	One day I visit a former orange grove that is now named Isleworth.	0.550909
Ľudia sú ochotní zaplatiť veľa za dom v Isleworthe len preto, že si tým kúpia priamu vstupenku do sna.	People pay so much to get into Isleworth because here too they are buying admission tickets to a dream.	0.296471
V tomto prípade ide o sen stretnúť Tigera Woodsa.	In this case the dream is rubbing shoulders with the likes of Tiger Woods.	0.157143
Keď prišiel Arnold Palmer do Orlanda, najprv si kúpil pozemok a tento čin sa za menej ako 20 rokov stal vzorom, ako vhodne uložiť peniaze pre budúce generácie.	Arnold Palmer first bought land here when he came to Orlando, and in less than 20 years it has become Orlando's equivalent of old money.	1.7469
Neďaleko odtiaľ je v Kissimmee cesta U. S 192 plná motelov na dlhodobý prenájom pre rodiny, ktoré si nemôžu dovoliť prenajať byt, taktiež množstvo golfových mini ihrísk pre tých, čo si chcú zahrať Isleworthe.	Not far away, in Kissimmee, U. S. 192 is full of long-lease motel rooms for families who can't afford to lease apartments, of miniature golf courses for people who will never play at Isleworth.	1.30062
Cesta 192, ktorá ďalej vedie do Centrálnej Floridy a spája diaľnicu I-4 a floridskú cestu Turnpike, sa stala skládkou pre všetko - vrátane snov.	The road connects I-4 with Florida's Turnpike, and it's become a dumping ground for everything, including dreams, that gets funneled down into central Florida.	0.623115
Priamo v blízkosti označenia ponúkajúceho lety vrtuľníkov sa nachádza priestor, kde helikoptéry stoja, roztočia motory a rozkrútia rotory. ~~~ Toto všetko vedľa diaľnice v priestranstve nie väčšom ako dvor rodinného domu.	Near a sign offering cut-rate helicopter rides, the whirring machine sits, engine revving, rotors spinning, right next to the highway, on a lot no bigger than someone's front yard.	0.0408326
Túto odyseu by som mohol ukončiť na tomto mieste, popri tom, ako sme sa stratili v Kissimmee, ale Orlando ma naučilo, že aj na tých najzvláštnejších miestach môže človek nájsť balzam na dušu.	I might end this Orlando odyssey right there, with the great American getaway having left us all lost in Kissimmee, except Orlando has taught me that, even in the oddest places, the human spirit can be exalted.	0.448346
Orlando nám ukázalo, že aj napriek americkému snu zrealizovať utópiu, tým skutočným zázrakom je americká rozmanitosť a nepredvídateľnosť.	Orlando shows us that, despite our American urge to construct utopias, the real wonderland remains our diversity and unpredictability.	0.447638
Na strednej škole Cypress Creek mi jeden študent povedal: V Kissimmee som našiel krásu.	At Cypress Creek High School, one student told me: I found beauty in Kissimmee.	0.664179
V tom čase maturant Eric Strunz bol ako stratený pútnik v duchovnej púšti, kde jej krásu aj našiel.	Eric Strunz, a senior at the time, was a pilgrim lost in a spiritual desert when he found it.	0.430263
Budhistický chrám, priamo tam v Kissimmee, pokračuje.	A Buddhist temple, right there in Kissimmee, Eric said.	0.675
Vyzul som si topánky a šiel do vnútra.	I took off my shoes and went inside.	0.28
Zamiloval som sa do pokoja a ticha.	I loved the calm, the serenity.	0.266667
Zmenilo mi to život.	It changed my life.	0.282353
Po prvýkrát som si uvedomil, že sú aj iné spôsoby, ako porozumieť svetu.	I realized for the first time there were other ways of understanding the world.	0.270492
Neskôr mi Eric poslal email s adresou budhistického chrámu.	Later Eric emailed me the address of the Buddhist temple's website.	0.565385
Zistil som, že Wat Florida Dhammaram nie je ďalšou atrakciou s budhistickou tematikou, kde si zaplatíte vstup, aby ste sa dostali ku karikatúre cudzej kultúry.	I found out that Wat Florida Dhammaram wasn't another attraction with a Buddhist theme, where you paid admission to be herded through a cartoon version of a foreign culture.	0.624095
Bol to skutočný chrám, ktorý bol postavený, aby slúžil pre duchovné potreby rozrastajúcej sa budhistickej komunity v centrálnej Floride.	This was a real temple, built to serve the spiritual needs of central Florida's growing Buddhist community.	0.378623
Až odchodom z Disney Worldu som našiel ozajstný Epcot Ameriky, presne tak, ako keď Erik zacíti Kerouacovho ducha.	By leaving Disney World, I had at last found America's true Epcot, just as Eric had found his Kerouac revelation.	0.451579
Mních mi požehnal, spomenul si.	The monk blessed me, he remembered.	0.267857
Romanovovci na fotke z roku 1913.	The Romanovs, in a 1913 photo.	0.265385
V strede sedí cár Mikuláš II. so svojou manželkou cárovnou Alexandrou.	In the center of the group, Tsar Nicholas II sits with his wife, the tsarina Alexandra.	0.240984
Po boku cárovnej sedí ich dcéra Mária a vzadu stoja dcéry Oľga a Tatiana (zľava).	Behind, from left to right, are their daughters Maria, Olga, and Tatiana.	0.27619
Najmladšia dcéra Anastázia sedí na stolčeku vpravo a ich jediný syn Alexej kľačí vpredu.	Their youngest daughter, Anastasia, is seated on the stool, and Alexei, their only son, kneels in front.	0.248684
V júli ubehlo 100 rokov od rozhodujúcej krvavej noci, keď nastal koniec ruského kráľovského rodu.	On a July night 100 years ago, the family's rule of Russia came to a decisive, bloody end.	2.32196
Vo februári v roku 1917 vypukla v Rusku revolúcia a o mesiac neskôr sa Mikuláš II., cár a absolutistický vládca všetkých ruských území vzdal trónu a stal sa obyčajným Mikulášom Romanovom.	Revolution came to Russia in February 1917, and a month later Nicholas II, emperor and autocrat of all the Russias, abdicated his throne to become plain Nicholas Romanov.	0.374282
Dynastia Romanovovcov, ktorá v roku 1913 oslávila svoje tretie storočie na tróne, čelila revolúcii na domácom území a utrpela krutú prehru v prvej svetovej vojne, veľmi rýchlo a nečakane zanikla.	With revolution at home and catastrophic failure in the First World War abroad, the Romanov dynasty, which had celebrated its third century in power in 1913, came to a swift end.	0.360533
Boľševické vojská väznili Romanovovcov, prevážali ich z miesta na miesto až do krvavej noci v júli 1918. ~~~ Celá rodina bola vyvraždená.	Bolshevik forces held the Romanov family as prisoners, moving from place to place until one bloody night in July 1918.	0.064794
Romanovovci odmietali vidieť prichádzajúcu pohromu, až sa nakoniec stali jej obeťami.	The entire family was wiped out, victims to a fate that they refused to see coming.	0.269565
(Prečítajte si viac o chaotickom roku počas ruskej revolúcie.)	(Read more about Russia's chaotic year of revolution.)	0.25625
Mikuláš možno pocítil úľavu, keď sa vzdal trónu, ktorý zdedil po svojom otcovi Alexandrovi III.	Abdication could have been a relief for Nicholas, who took the throne in 1894 after the death of his father, Alexander III.	0.410671
Opisovali ho totiž ako obmedzeného človeka bez fantázie, ktorý sa nehodil na vládnutie v takých nepokojných časoch ani svojimi schopnosťami, ani náturou.	Described as an unimaginative and limited man, he was suited neither by his abilities nor temperament to rule during such turbulent times.	0.261864
Neustále nerozhodný Mikuláš odkladal svoje rozhodnutia až do poslednej minúty a potom jednoducho zopakoval to, čo mu nedávno niekto poradil.	Chronically indecisive, Nicholas would put off issuing an order until the last minute and then simply repeat the most recent piece of advice he had been given.	0.270492
V Petrohrade koloval vtip o tom, že v Rusku vládli dvaja ľudia – cár a ktokoľvek, kto sa mu prihovoril ako posledný.	A joke making the rounds in St. Petersburg said that the two most powerful people in Russia were the tsar and whoever had spoken to him last.	0.2375
(Pozrite si fotky Petrohradu, Rusko dnes.)	(See photos of St. Petersburg, Russia today.)	0.284211
Mikuláš nebol pokrokový vládca a pevne veril, rovnako ako jeho manželka Alexandra, že má božie právo vládnuť.	Nicholas was not a progressive overlord and firmly believed in his divine right to rule, a view his wife, Alexandra, shared.	0.598227
Zrejme preto boli činy Mikulášovej tajnej polície, desivej a vraždiacej organizácie nazývanej Ochranka, beztrestné.	The Okhrana—his secret police, a terrible and murderous organization—operated with impunity.	0.477711
Ako vodca nebol Mikuláš veľmi úspešný.	As a leader, Tsar Nicholas knew few successes.	0.247059
V roku 1904 bojoval a prehral vo vojne s Japonskom a v roku 1905 čelil revolúcii, ktorá bola nasmerovaná proti jeho autokratickému režimu.	In 1904, he fought and lost a war with Japan, and in 1905, faced a revolution at home against his autocratic regime.	0.495245
V októbrovom manifeste v roku 1905 sa Mikuláš neochotne zaviazal, že vytvorí zákonodarný orgán – Štátnu dumu.	In the October Manifesto of 1905 he grudgingly pledged to create the Duma, an elected legislative body.	2.11288
V snahe udržať si svoju moc cár obmedzil právomoci Štátnej dumy ešte pred jej prvým zasadnutím.	Before it had held its first session, the tsar limited its powers in an attempt to hold on to his governing power.	0.251852
Keď v roku 1914 vypukla prvá svetová vojna, Mikuláš zatiahol národ do konfliktu, ktorý spôsobil vyčerpanie národných zdrojov a stratu miliónov ľudských životov.	When World War I came in 1914, Nicholas led his people into a conflict that would strain the nation’s resources and cost millions of lives.	0.365517
Aj napriek tomuto všetkému bol zaslepený. ~~~ Nevšímal si, že jeho popularita klesá a bol presvedčený, že ho ľudia aj napriek tomu zbožňujú.	Despite it all, he remained blind to his growing unpopularity and was convinced that the people loved him nonetheless.	-0.0252475
No tí mali naňho iný názor.	The people, for their part, took a different view.	0.0391304
Prezývali ho Krvavý Mikuláš.	Their nickname for him was Nicholas the Bloody.	0.126923
(O vstupe USA do prvej svetovej vojny sa dočítate viac tu.)	(Read about the U. S. entry into World War I.)	0.205263
Kameňotlač z 19. storočia znázorňuje korunováciu cára Mikuláša II.	A 19th-century lithograph depicts the coronation of Tsar Nicholas II.	0.589831
Cárska koruna, ktorou bol korunovaný Mikuláš II. v roku 1896. Prvýkrát bola použitá v roku 1762 pri korunovácií Kataríny II.	Used to crown Nicholas II in 1896, the Imperial Crown was first used at the coronation of Catherine the Great in 1762.	0.27551
Zdobí ju takmer 5 000 precízne uložených diamantov.	It is encrusted with nearly 5,000 carefully arranged diamonds.	0.233333
Fabergého vajíčka, ktoré pre cára každú Veľkú noc vyrábala klenotnícka dielňa Carla Petra Fabergého v Petrohrade od roku 1885, patria medzi najznámejšie poklady.	Perhaps the most famous treasures, jeweled eggs were made for the tsars every Easter since 1885 by the House of Fabergé in St. Petersburg.	0.237931
Vajíčko z roku 1913 zobrazené na obrázku bolo vyrobené pri príležitosti tristého výročia založenia dynastie.	The 1913 egg, shown here, was created to mark the tercentenary of the dynasty’s founding.	2.2875
Miniatúrne portréty cára Mikuláša II. a jeho najstaršej dcéry Oľgy, ktoré nakreslil Johannes Zehngraf v 90. rokoch 19. storočia. Portréty sú uložené na zlatých a drahokamami vykladaných podstavcoch zelenej nefritovej farby z dielne Carla Petra Fabergého.	Painted by Johannes Zehngraf in the 1890s, these miniature likenesses of Tsar Nicholas II and his eldest child, Olga, are mounted on gold- and jewel-inlaid jade pedestals, created by the House of Fabergé.	0.394968
Iba málo predmetov tak dobre vyjadruje prepojenie nábožnosti a márnivosti Romanovovskej dynastie ako práve set týchto zlatých nádob, ktoré sa používali na omšiach.	Few objects better express the Romanov dynasty’s blend of piety and conspicuous consumption than this set of gold vessels used to celebrate Mass.	0.381452
V 17. storočí ich dal vyrobiť cár Fiodor III. Alexejevič a sú vykladané 10 typmi drahokamov.	Commissioned by the 17th-century tsar Fyodor III, they are inlaid with 10 types of jewels.	2.3586
V súčasnosti sú uložené v Zbrojnici moskovského Kremľa.	State Armory, Moscow.	-0.135
Katarínsky palác, ktorý slúžil ako letné sídlo cárov, bol postavený za vlády Kataríny II. (1762-1796) v mestečku Cárske Selo blízko Petrohradu.	The Catherine Palace, built by Catherine the Great (r. 1762-1796) in the town of Tsarskoye Selo near St. Petersburg, was the summer residence of the tsars.	0.419428
Neďaleký Alexandrovský palác, rovnako postavený za vlády Kataríny II., bol obľúbeným sídlom Mikuláša II.	The nearby Alexander Palace, also built in Catherine’s reign, was Nicholas II’s favorite residence.	0.282759
Po jeho abdikácií v roku 1917 tu bol väznený spolu so svojou rodinou.	after his abdication in 1917, Nicholas and his family were held captive there.	0.253448
Kráľovská rodina Mikuláš bol veľmi rodinne založený.	Royal Family Nicholas was, however, a family man.	0.272093
Miloval svoju ženu Alexandru a ona milovala jeho.	He loved his wife, Alexandra, and she loved him.	0.285366
Mali šťastie, že ich osud spojil v období, keď si panovníci vyberali partnerov zvyčajne podľa toho, či vyhovovali ich panovníckemu rodu.	They were lucky to have such a match at a time when the general rule was that monarchs wed for dynastic convenience rather than affection.	0.294783
Svadbu mali v roku 1894 a postupne sa im narodili štyri dcéry: Oľga, Tatiana, Mária a Anastázia.	Married in 1894, they had four daughters, Olga, Tatiana, Maria, and Anastasia in succession.	0.49625
Ich vytúžený syn a dedič trónu Alexej sa narodil v roku 1904 a bol ich posledným dieťaťom.	Alexei, the longed-for son and heir, was their last child, born in 1904.	0.231148
Podľa všetkého boli Romanovovci šťastnou a milujúcou rodinou.	By all reports, the Romanovs were a happy and devoted family.	0.616026
Na fotke z roku 1910 je päť detí ruského cára Mikuláša II. osem rokov pred tým, ako ich vojna a revolúcia násilným spôsobom pripravila o život.	The five children of Tsar Nicholas II of Russia in a 1910 photo, eight years before war and revolution would sweep them all to a violent death.	1.63079
Vpravo dole je obrázok znázorňujúci cára Mikuláša II. a jeho ženu Alexandru na počesť ich návštevy Francúzska v roku 1896.	Below right, a plate depicting Tsar Nicholas and his wife, Alexandra, in honor of the couple’s visit to France in 1896.	0.573714
Alexandra, rodená Nemka a vnučka britskej kráľovnej Viktórie, bola silnejšia a pôsobivejšia osobnosť ako jej manžel.	German by birth and granddaughter of Britain’s Queen Victoria, Alexandra possessed a more powerful and imposing character than her husband.	0.420588
Pôsobila introvertne a neprístupne, čím stratila sympatie ruského ľudu, ktorý ju videl ako outsidera.	An introverted and distant manner alienated her from the Russian people, who saw her as an outsider.	0.285882
Na rozdiel od jej manžela si však dokázala priznať, že nie je obľúbená, čo viedlo k tomu, že zostala veľmi citlivá, paranoidná a musela mať veci pod kontrolou.	Unlike her husband, Alexandra recognized her own unpopularity, which made her highly sensitive, controlling, and paranoid.	0.230556
(Prečítajte si tiež ľúbostný príbeh, ktorý sa skrýva za korunovačnými klenotmi kráľovnej Viktórie.)	(Also learn the love story behind Queen Victoria's crown jewels.)	0.136842
Sigmund Freud raz poznamenal, že v rodine sa všetko krúti okolo najzraniteľnejšej osoby.	Sigmund Freud once remarked that a family tends to organize itself around its most damaged member.	0.701299
U Romanovovcov mohlo ísť o Alexandru.	For the Romanovs that could have been Alexandra.	0.218182
Svojou precitlivenou povahou si vynútila stálu pozornosť dcér a manžela, ktorí si o ňu robili starosti.	Her high-strung temperament ensured the constant attention and solicitude of her husband and daughters.	0.293258
Medzi najstaršou a najmladšou veľkokňažnou bol šesťročný rozdiel. ~~~ Alexandra sa spoliehala na všetky svoje dcéry a udržovala medzi nimi dobrý vzťah.	Six years separated the oldest from the youngest grand duchess;Alexandra relied on all of them and kept them close.	-0.0489796
Staršie sestry Oľga a Tatiana boli v rodine milo nazývané veľká dvojka a mladšie sestry Máriu a Tatianu nazývali malou dvojkou.	The family fondly nicknamed the older daughters Olga and Tatiana the Big Pair, and the younger sisters Maria and Anastasia, the Little Pair.	0.405808
Na najmladšom Alexejovi lipli všetci členovia rodiny, no predovšetkým Alexandra.	All of the family, especially Alexandra, doted on the youngest child, Alexei.	0.277612
Dedič trónu sa narodil s hemofíliou, ktorú zdedil od rodiny z matkinej strany.	The heir to the throne was born with hemophilia, which came from Alexandra’s side of the family.	0.237313
Jeho zdravie sa stalo stredobodom ich života.	His health became the main focus of their lives.	0.2925
Akákoľvek činnosť pre neho predstavovala nebezpečenstvo.		-0.3
Obyčajné škrabnutie alebo drobné poranenie mohlo spustiť katastrofickú vlnu krvácania.	Nearly any activity carried the risk of a knock or cut that could trigger catastrophic bouts of bleeding.	0.257692
Počas Alexejovho zotavovania spávala Alexandra celé týždne na zemi pri kraji jeho postele.	Alexandra would sleep on the floor by his bedside during the weeks of recuperation.	0.480483
Alexej bol jemný, sem-tam nezbedný chlapec rozmaznávaný matkou a sestrami.	The boy was gentle, with a mischievous streak and spoiled by his mother and sisters.	0.55
V čase, keď sa rodiny patriace k vyššej spoločenskej vrstve snažili, aby boli ich deti samostatnejšie, u Romanovovcov to bolo opačne.	In a period where parents of the upper classes cultivated a distant relationship with their children, Alexei’s physical dependence bonded him tightly to his mother and father.	0.341627
Alexej sa ešte viac naviazal na svojich rodičov, pretože bol na nich fyzicky odkázaný. ~~~ Na obrázku z roku 1913 je zobrazený približne deväťročný Alexej.	Alexei, age eight or nine, gazes into the camera while playing with his mother’s pearl necklace in this 1913 image.	1.39018
Hľadí na fotoaparát a hrá sa s perlovým náhrdelníkom svojej matky.		-0.3
Romanovovci sa preto stali zraniteľnými.	It also made them vulnerable.	0.173077
Keď sa objavil niekto, kto to mohol zneužiť, úplne mu podľahli.	When someone came along who could exploit that vulnerability, they fell for him completely.	0.161111
Grigory Rasputin sa narodil v západnej Sibíri a sám seba nazval svätým mužom.	Grigory Rasputin, born in western Siberia, was a self-proclaimed holy man.	0.795385
Pre jeho nemravné správanie, liečivú moc a schopnosti vidieť budúcnosť mali o ňom ľudia rôzne názory.	He had a mixed reputation for licentious behavior, healing powers, and the ability to see the future.	0.472982
Či bol pouličným predavačom alebo mal nadprirodzené schopnosti nebolo jasné.	Whether he was a huckster or believed he had supernatural powers is unclear.	0.286154
Romanovovci mu rozhodne verili a on využíval vplyv, ktorý mal nad kráľovskou rodinou, predovšetkým nad Alexandrou.	The Romanovs definitely believed in him, and he wielded powerful influence over the royal family, especially Alexandra.	0.288
Nádej v uzdravenie	Healing Hopes	0.207692
Keď sa Rasputin prvýkrát stretol s Romanovovcami, cárovná bola zúfalá.	When Rasputin first met the Romanovs in 1905, the tsarina was desperate.	0.572727
Revolúcia v roku 1905 takmer zvrhla monarchiu.	The 1905 revolution had almost seen the monarchy overthrown.	4.3372
V predošlý rok sa im narodil dedič trónu Alexej, v ktorého dúfala. Jeho hemofília však nebola len osobnou tragédiou, bola taktiež hrozbou pre celú dynastiu.	The birth of Alexei the previous year gave them the heir she had been hoping for, but his hemophilia was not only a personal tragedy but also a threat to the dynasty.	0.293233
Táto situácia politickej krízy a materinského utrpenia umožnila Rasputinovi votrieť sa do rodiny.	This situation of political crisis and maternal agony enabled Rasputin to insinuate himself into the family.	0.272093
V roku 1908 postihlo Alexeja kritické obdobie krvácania a Rasputin zmiernil chlapcovu bolesť.	In 1908 Alexei suffered a severe bleeding episode and Rasputin was able to ease the boy’s pain.	3.07821
Mystik údajne varoval Mikuláša a Alexandru, že zdravie dieťaťa bude spojené so silou dynastie.	The mystic allegedly warned Nicholas and Alexandra that the child’s health would be linked to the strength of the dynasty.	0.219512
Rasputinova schopnosť udržať dieťa zdravé mu zaistila miesto v paláci a moc ovplyvniť cára.	Rasputin’s ability to keep the child healthy would secure him a place in the palace and the power to influence the tsar.	0.420253
Grigori Rasputin (zobrazený na nedatovanom obrázku) sa narodil ako roľník. ~~~ Bol mystik a jeho vplyv na cárovnú vyvolal obrovské rozhorčenie, ktoré vyvrcholilo k jeho vražde v roku 1916, v predvečer revolúcie.	Grigory Rasputin (above in an undated image) was a peasant-born mystic whose influence on the tsarina stoked huge resentment, culminating in his murder in 1916, on the eve of revolution.	0.115478
Tento vzťah možno pomohol cárovičovi, no zmaril Alexandrinu reputáciu a ešte viac ju odlúčil od ruského ľudu.	The relationship may have helped the tsarevitch, but it wrecked Alexandra’s reputation and further distanced her from the Russian people.	0.220213
Šírili sa klebety, že súčasťou Rasputinovho zhýralého správania bolo zvádzanie cárovnej.	Rumors swirled that Rasputin’s debauched behavior included seducing the tsarina.	0.270833
Hoci určite nebol jej milenec, mal však aféry s nespočetným množstvom žien na Romanovovskom dvore.	Although he almost certainly was not her lover, he did have affairs with untold numbers of women at the Romanov court.	0.250588
Mikuláš ignoroval žiadosti, aby Rasputin opustil dvor, čím ešte viac rozhorčil ruský ľud.	Nicholas ignored the calls to remove Rasputin from court, further angering the Russian people.	0.498901
Mikulášova snaha udržať svoju rodinu šťastnú však zatienila blížiacu sa hrozbu.	Keeping his wife happy and his child happy kept Nicholas from removing the threat.	0.3
(Prečítajte si ako náboženstvo ruského cára dnes užíva zvýhodnené postavenie.)	(See how the faith of the Russian tsars now enjoys favored status.)	0.231579
V septembri 1915 počas prvej svetovej vojny cestoval Mikuláš na front, aby osobne prevzal velenie nad ruskými vojskami.	In September 1915, during World War I, Nicholas II traveled to the front to take personal command of Russian forces.	0.284694
Cárovná sa postarala o vnútorné záležitosti. ~~~ Rasputinov vplyv na ňu zažal byť evidentný, keď vybrala nekompetentných ministrov.	The tsarina saw to domestic affairs, and Rasputin’s influence on her became evident in her choice of incompetent ministers.	-0.0113208
Straty na fronte a Rasputinove riadenie doma postavilo ruských ľudí proti cárovi a jeho rodine.	Losses on the front and Rasputin’s conduct at home turned the Russian people against their tsar and his family.	0.256098
Dozrel čas na revolúciu.	The time was ripe for revolution.	0.204545
Život v zajatí	Life in Captivity	0.230769
Len čo sa boľševici ujali moci v novembri 1917, Romanovovci sa stali esom v rukáve a súčasne aj problémom.	For the Bolsheviks, once they took power in November 1917, the Romanovs simultaneously became a bargaining chip and a headache.	0.532584
Rusko potrebovalo vyjednať svoj odchod z prvej svetovej vojny a zároveň sa snažilo vyhnúť cudzej invázii.	Russia needed to negotiate its exit from World WarI while also avoiding a foreign invasion.	0.4375
Nepriatelia krajiny sa prizerali, čo sa stane s niekdajšími panovníkmi. ~~~ No pokiaľ by Romanovovci zostali nažive, navždy by zostali symbolom monarchistického hnutia.	The country’s enemies would be watching what happened to the former rulers, but if the Romanovs remained alive they would forever be a symbol for the monarchist movement.	-0.00208333
Niektorí ich chceli poslať do exilu, iní ich chceli postaviť pred súd za ich zločiny a ďalší chceli, aby nadobro zmizli.	Some wanted them sent into exile, some wanted them put on trial for their perceived crimes, and some wanted them to disappear, for good.	0.261386
Rodinu najprv vyslali do paláca v Cárskom Sele, no kvôli obavám o bezpečnosť boli neskôr poslaní do Toboľska, na východ od pohoria Ural.	At first the family was sent to the palace at Tsarskoye Selo. ~~~ Security concerns then sent them to Tobol’sk, east of the Ural Mountains.	0
Nechovali sa k nim zle a dokonca sa zdalo, že Mikuláš je spokojný.	They were not treated badly, and Nicholas even seemed to thrive.	0.3
Užíval si dedinský život v prírode a nechýbal mu stres z cárskych povinností.	He enjoyed the outdoor, rural life and did not miss the stress of being tsar.	0.290625
Rodina si zanechala veľké množstvo zamestnancov – celkovo 39 sluhov.	The family retained a generous staff: 39 servants altogether.	3.56667
Uchovali si veľa z ich osobného vlastníctva, čo zahŕňalo aj ich milované rodinné albumy potiahnuté kožou.	They kept many of their personal possessions, including their beloved family leather-bound photograph albums.	0.28022
Aj počas prvých dní ich väznenia mohli stále snívať o šťastnom konci.	It was still possible in these early days of their imprisonment to dream of a happy ending.	0.213559
Mohli odísť do exilu do Anglicka za ich britským bratrancom, kráľom Jurajom V., alebo sa mohli uchýliť v rezidencii na Kryme, kde by prežili množstvo veselých letných mesiacov.	They might reach England and live in exile with their British cousin King George V. ~~~ Better still, perhaps they would be allowed to retire to their estate in the Crimea, the scene of many happy summers.	-0.019
Neuvedomovali si, že každá úniková cesta sa postupne zatvárala, až kým nezostala len jedna, tá najhoršia – cesta do Jekaterinburgu.	They did not understand that, little by little, each escape route was closing until only one was left, the worst one: the road to Yekaterinburg.	0.278761
Šesť členov rodiny Romanovovcov sedí na vrchu strechy boli väznení od leta 1917 do jari 1918.	Six of the Romanovs sit on the roof of the country estate in Tobol’sk, where they were held from summer 1917 to spring 1918.	2.33031
Tatiana a Alexandra pracujú v záhradách Alexandrovského paláca v Cárskom Sele v roku 1917.	Tatiana and Anastasia, working in the gardens of the Alexander Palace, Tsarskoye Selo, 1917.	0.692308
Anastázia, Tatiana, Oľga a Mária v Alexandrovskom paláci, Cárske Selo, 1917.	Anastasia, Tatiana, Olga, and Maria at the Alexander Palace, Tsarskoye Selo, 1917.	1.02761
Po vypuknutí osýpiek si sestry podľa vtedajších liečebných postupov oholili vlasy.	After a bout of measles, the sisters had shaved their heads, following the medical procedure of the time.	0.234247
Ipatievov dom z roku 1928, kde boli Romanovovci a ich služobníctvo zavraždení.	The Ipatiev House, where the Romanovs and their servants were killed, appears in this 1928 photo.	0.233824
Na obrázku je zobrazený suterén Ipatievovho domu, kde rodinu spolu so služobníctvom zaviedli a následne v júli 1918 zabili.	The family and their servants were taken to the basement of the Ipatiev house, shown here, and killed in July 1918.	0.26875
Najviac radikalizované mesto v Rusku Jekaterinburg bolo silne komunistické a fanaticky anti-cárske.	The most radicalized city in Russia, Yekaterinburg was strongly communist and fanatically anti-tsarist.	0.289888
Išiel by som naozaj kamkoľvek, len nie na Ural, povedal Mikuláš, keď vlak zastavil na konečnej stanici.	I would go anywhere at all, only not to the Urals, Nicholas is reported to have said as the train approached his final residence.	0.235227
Rodina zostala vo veľkej budove pomenovanej Ipatievov dom po jej bývalom majiteľovi.	The family stayed in a large building known as the Ipatiev House, after its former owner.	0.295946
Vysoká drevená palisáda bola vytvorená za účelom odrezať rodinu od vonkajšieho sveta.	A high wooden palisade was constructed to cut off the outside world.	0.212069
Keď chceli ísť von, mohli ísť na záhradu.	They had the use of a garden for exercise.	0.3
Na všetko dohliadal veliteľ Avdejev. Bol skorumpovaný (jeho muži beztrestne okrádali Romanovovcov), ale nie krutý.	The man in charge, Avdeev, was corrupt (his men stole freely from the Romanovs) but not cruel.	0.216456
Strážcovia boli obyčajní muži naverbovaní z miestnych závodov.	The guards were ordinary men, recruited from local factories.	0.288889
Romanovovci si postupne začali zvykať na svoj trest.	As time went on they became familiar and even friendly with their charges.	0.18913
Netrvalo to však dlho.	It couldn’t last.	0.225
Avdejeva na príkaz miestnych boľševikov vystriedal Jakov Jurovskij. ~~~ Jurovskij bol muž, ktorý mal zorganizovať ich vraždu.	The local Bolsheviks replaced Avdeev with Yakov Yurovsky, the man who would orchestrate their murders.	-0.0337079
Zastavil rozkrádanie, ktoré bolo za Avdejeva beztrestné, no zaviedol tvrdší režim a najal striktnejších a disciplinovanejších strážnikov.	He stopped the petty thieving that had gone unpunished by his predecessor, but he instituted a much harsher regime and recruited stricter, more disciplined guards.	0.422404
Udržoval si vzdialenejší ale profesionálny vzťah s Mikulášom a Alexandrou, aj popri plánovaní ich vraždy.	He maintained a distant but professional relationship with Nicholas and Alexandra, even as he planned their deaths.	0.461413
Dokonca sa zdalo, že Mikuláš, ktorý bol znova raz na omyle, ho mal rád.	Nicholas—getting it wrong yet again—even seemed to like him.	0.266038
Mikuláš II. spolu s Alexejom ako kontrolujú vojská v roku 1915.	Nicholas II and Alexei reviewing troops in 1915.	0.547619
Posledné dni	The Last Days	0.3
Poslední sluhovia, ktorí videli Romanovovcov nažive, boli štyri ženy. ~~~ Priviezli ich z mesta, aby upratali Ipatievov dom.	The last civilians to see the Romanovs alive were four women who had been brought in from the town to clean the Ipatiev House.	-0.00432692
Marija Starodumovová, Jevdokija Semenovová, Varvara Driaginová a neznáma štvrtá žena poskytli rodine malý pocit úľavy a posledný kontakt s vonkajším svetom.	Mariya Starodumova, Evdokiya Semenova, Varvara Dryagina, and an unidentified fourth gave the family a small amount of relief from the boredom of their confinement, and one final contact with the outside world.	0.480756
Výpoveď týchto žien poskytla najprenikavejší a ľudský opis odsúdenej rodiny.	The testimony of these women has given the most penetrating and humane portrait of the doomed family.	0.220588
Slúžky, ktoré mali zakázané komunikovať s Romanovovcami, mali predsalen šancu pozorovať ich veľmi zblízka.	Forbidden to speak to the Romanovs, the cleaners nevertheless had the chance to observe them at close quarters.	0.296809
Prekvapene zistili, že na rozdiel od príbehov je skutočnosť úplne iná. ~~~ Romanovovci sa im nezdali arogantní, ako sa šírila anti-cárska propaganda.	At first, they were struck by the contrast between the tales of the family’s arrogance disseminated by anti-tsarist propaganda and the modest people they found before them.	-0.0222656
Naopak, pred slúžkami stáli skromní ľudia.	The grand duchesses were ordinary girls.	0.283333
Veľkokňažné boli obyčajné dievčatá. ~~~ A úbožiak Alexej pripomínal Semenovovej stelesnenie utrpenia.	As for poor, broken Alexei, he looked to Semenova like the epitome of delicate suffering.	-0.0276316
Rovnako ako veľa ďalších pred ňou, aj Semenovovú uchvátili Alexejove oči.	Like so many before her, she was particularly struck by his eyes, which were soft and callow, but which appeared to Semenova to be full of sadness.	0.028125
Boli nežné a nezrelé, no jej sa zdali plné smútku.	The family, however, was delighted with the diversion.	0.257143
Rodina mala radosť z rozptýlenia. ~~~ Sestry sa dali do drhnutia dlážky, čím získali možnosť komunikovať so slúžkami aj navzdory pravidlám.	The sisters threw themselves into helping scrub the floors, taking the opportunity to speak with the cleaners in defiance of house rules.	-0.0025641
Semenovová povedala Alexandre pár milých slov.	Semenova managed to say a few kind words to Alexandra.	0.271429
Jedna zo scén, ktorú si Semenovová a Starodumovová pamätajú veľmi jasne, bola, keď si Jurovskij sadol vedľa cároviča a pýtal sa na chlapcovo zdravie.	One of the scenes Semenova and Starodumova both remembered with great clarity was when Yurovsky sat down next to the tsarevitch and inquired after the boy’s health.	0.271654
Scéna nezvyčajnej vľúdnosti a solidarity je z dnešného pohľadu hrozivá.	A scene of rare kindness and sympathy made retrospectively sinister by the fact that Yurovsky was perfectly aware that within a short time he would be the child’s executioner.	0.167965
Jurovskij v tom čase veľmi dobre vedel, že za krátky čas bude práve on chlapcovým vrahom.	The visit to the Ipatiev House made a deep impression on the women.	0.4125
Návšteva Ipatievovho domu zanechala v ženách hlboký dojem.		-0.3
Romanovovci mali byť zavraždení, pretože boli hlavným symbolom autokracie.	The Romanovs were to be killed because they were the supreme symbols of autocracy.	0.286567
Ironické však bolo, že v Jekaterinburgu ich boľševici premenili na náprotivok aristokratov.	The irony was that, in Yekaterinburg, the Bolsheviks had turned them into the opposite of aristocrats.	0.274074
Slovami Jevdokije Semenovovej: Neboli to bohovia.	In the words of Evdokiya Semenova, they were not gods.	0.293333
Vlastne boli obyčajní ľudia ako my.	They were actually ordinary people like us.	0.232258
Jednoduchí smrteľníci.	Simple mortals.	0.16
V noci 16. júla bol do Moskvy odoslaný telegram, ktorý informoval Lenina o rozhodnutí vykonania vraždy.	On the night of July 16, a telegram was sent to Moscow informing Lenin of the decision to carry out the murders.	0.289888
O pol druhej ráno vyhnali rodinu a 4 služobníčky z postele. ~~~ Jurovskij im oznámil, že boje medzi červenou a bielou armádou sú hrozbou pre mesto a pre ich vlastné bezpečie musia ísť dolu do suterénu.	Rousing the family and the four servants from bed at 1:30 a. m. , Yurovsky informed them that fighting between Red and White forces was threatening the city and that they must be moved down to the basement for their own safety.	-0.0189759
Alexandr Avdonin narodený v Jekaterinburgu sa v roku 1907 spojil s ruským filmárom Gelijom Rjabovom, aby našiel pohrebisko siedmich Romanovovcov.	Yekaterinburg-born geologist Alexander Avdonin teamed up with Russian filmmaker Geli Ryabov in the 1970s to find the burial place of the seven Romanovs.	0.433408
Vďaka jeho predchádzajúcemu zamestnaniu na Ministerstve vnútra ZSSR mal Rjabov prístup k tajným spisom, ktoré obsahovali cenné stopy.	Because of his previous employment with the Soviet Ministry of Internal Affairs, Ryabov was able to access classified documents that contained valuable clues.	0.248718
Publikácia z roku 1926 opísala miesto hrobu ako močaristé. ~~~ No fotka z roku 1919 ich splietla.	One 1926 publication described the grave site as a swampy place, while a 1919 photo of a bridge intrigued them.	0.127778
Ich tím, ktorý pracoval v utajení, vypátral toto miesto a v máji v roku 1978 odhalili hrob.	Their team, working secretly, was able to locate the structure and in May 1979 uncovered a grave.	0.442982
Obávajúc sa sovietskej odvety, rozhodli sa udržať ich objav v tichosti.	Fearful of Soviet reprisals, they decided to keep their discovery quiet.	0.295161
Na hornej fotke je zobrazený brezový les, ktorý sa nachádza približne 16 kilometrov severne od Jekaterinburgu. ~~~ Pravoslávne kríže tu označujú miesto masového hrobu, kde bolo pochovaných deväť z jedenástich členov romanovovskej domácnosti.	In the photo above, amid birch forests 10 miles north of Yekaterinburg, Russian Orthodox crosses mark the site of the mass grave where the bodies of nine of the 11 victims of the Romanov household were buried.	-0.0301724
Po páde Sovietskeho zväzu bol Avdoninov nález zverejnený.	As the Soviet Union fell, Avdonin’s find was made public.	0.287755
V roku 1997 sa začali výkopové práce, ktoré odhalili, že v hrobe sa nachádzalo len deväť osôb: piati Romanovovci a štyria sluhovia.	In 1991 an official excavation began, revealing that the grave held only nine people: five Romanovs and four of their servants.	0.291667
Sovietsky forenzný znalec Sergej Abramov zobrazený hore na fotke použil rozmery lebiek, aby dôkladne identifikoval kosti, zatiaľ čo britskí vedci odobrali mitochondriálnu DNA z pozostatkov a porovnali ju s DNA žijúcich príbuzných.	Soviet forensic expert Sergei Abramov, above, used cranial measurements to painstakingly identify the bones, while British scientists took mitochondrial DNA from the remains and compared it to known relatives.	0.37033
V roku 1993 vyhlásili, že pozostatky patrili Mikulášovi II., Alexandre, Oľge (jej lebka je zobrazená hore na obrázku), Tatiane a Anastázii.	In 1993 it was announced that the remains were Nicholas II, Alexandra, Olga (whose skull is shown above), Tatiana, and Anastasia.	1.77273
V blízkosti miesta, kde ich objavili, našli v roku 2007 ďalšie ľudské pozostatky. ~~~ DNA analýzy ukázali, že patria Márii a Alexejovi.	In 2007 human remains were found buried near the first grave, and DNA analysis showed them to be Maria and Alexei.	1.125
Nakoniec bol výsledok tragickej noci jasný: Všetci zahynuli.	At long last, the outcome of that terrible night was clear: All had perished.	0.238889
Nikto neprežil.	There were no survivors.	0.16
Pozostatky Romanovovcov nájdené v hrobe boli do 17. júla 1998 (osemdesiat rokov odo dňa ich vraždy) v pokoji uchované v Katedrále svätého Petra a Pavla v Petrohrade. ~~~ Nachádza sa tam tradičné miesto hrobiek ruských imperátorov.	The Romanov remains found in the large grave were held in storage until July 17, 1998, when they were laid to rest in the traditional burial place of the tsars, St. Petersburg’s Sts. Peter and Paul Cathedral, 80 years to the day of their murder.	-0.00538462
