Síce veľmi známe, no nie tak celkom presné, bolo Borgesove tvrdenie, ktorým dokazoval pravosť Koránu. ~~~ Podľa neho je dôkazom pravosti Koránu to, že sa na jeho stránkach nevyskytujú ťavy, ktoré boli úplnou samozrejmosťou, a preto ich nebolo nutné vôbec spomenúť.	In a famous but not quite accurate remark, Borges argues that a proof of the authenticity of the Koran is that you can find no camels in its pages; they were so taken for granted that there was no need for them to be mentioned.	0.0250836
Borges mal námietky proti nahrádzaniu miestneho koloritu v dielach autorov Južnej Ameriky. ~~~ Ani v tomto sa O’Crohanon názor nemení.	Borges was arguing slyly against the substitution of local colour for reality in South American writing, but even on this small count, O Crohan is constant.	0.0178846
Na ostrove žili somáre, no O’Crohan ich v diele spomína len dvakrát.	There were donkeys on the island but they are only twice mentioned.	0.294737
Neobjavili by sa vôbec, ani jedno jediné oko by ich nezazrelo počas návratu domov z rašeliniska. ~~~ Keď prišli súdni zriadenci zabaviť majetok, jediné, čo našli, bol iba starý somár na druhom konci ostrova, ktorému na polomŕtvom tele svietili len jeho živé oči.	They would not have appeared at all, had not a creel been blown out to sea off one of them when drawing home the turf, and when the bailiffs came to seize property, all they could find was an old donkey at the other end of the island with nothing alive but the two eyes in the head.	-0.00409091
Taká je jednoduchosť, ktorá spôsobuje, že ľudia a elementy sú občas rovnakí, ako opilci, ktorí spolu čakajú na koniec búrky v Dingle.	Such is the simplicity that sometimes even people and elements are equated, as the drunkards and spent storm in Dingle.	0.407214
Popravde, spojili sa, aby mu zabránili skoncovať s prácou v meste a vrátiť sa na ostrov.	In full cry, they had both converged to prevent him concluding his business in the town and returning to the island.	0.206757
Celý dej je úplne nezávislý, no podstatné je, že by sa mohol poľahky odohrávať na brehoch Bretónska či Grécka, ako aj na polostrove Dingle.	So free is all the action of everything but what is essential, that it could as easily have taken place on the shores of Brittany or Greece as on the Dingle Peninsula.	0.248718
Objavuje sa tu jedna neodbytná fráza, ktorá sa opakuje v celej knihe ako refrén, lá dar saolé.	There is one haunting phrase that echoes like a refrain throughout the book, lá dar saolé.	0.81757
Flower prekladá túto frázu jednoducho ako "deň našich životov", pravdepodobne však nie je možné ju preložiť.	Flower translates it simply as `a day of our lives`, but it is probably untranslatable.	0.406419
Vyjadruje to celkový zmysel ľudského života, ktorý je vytvorený zo všednosti jednotlivých dní.	It conveys the whole sense of the life of a person being formed by a succession of single days.	0.280769
Keď sa ospravedlňoval za márnenie času opíjaním sa, ktoré mu malo pomôcť zabudnúť na biedu, skutočný zmysel sa vytratil rovnako ako mince z jeho peňaženky.	When he apologises for the waste of a day in Dingle in relief of hardship through drunkenness, there is the physical sense of the day being taken out of the succession of days and squandered like the actual coins in their pockets.	0.168182
Základnou jednotkou času v celej knihe je deň.	The basic unit of time throughout the book is the day.	0.2625
Ak súvislosť medzi priestorom a činnosťou slúži na vzájomné zjednodušenie, myslím si, že tento zvláštny zmysel nadčasovosti – existencia mimo času, ktorý má kniha, vychádza z dňa. ~~~ Jediný deň sa nepretržite prelieva priestorom a dejom.	If the interdependence of scene and action serve to reduce one another to bare essentials, I think the strange sense of timelessness that the book has - of being outside time – comes from the day, a single day breaking continually over the scene and the action.	0.0975369
Dokonca aj stravovanie je podmienené týmto zákonom.	Even mealtimes are conditioned by this law.	0.236842
V knihe spomína len dve jedlá – raňajky a večeru.	There are only two meals, the morning and evening meal.	0.256098
Človek sa ráno naje tak, aby dokázal vydržať celý deň a doplnil zásoby opäť večer.	One eats enough in the morning to get through the day and restores oneself again at its end.	0.269565
Činnosť stále dookola začína a končí.	There is a continual setting out and a returning.	0.646753
Obavy na seba nedajú dlho čakať: na jednej strane zisk, na druhej strata šťastia, neustále čakanie na moment, ktorý môže priniesť kúsok šťastia – medené skrutky z vraku lode, sudy plné ropy, debny s čajom. Človek však musí byť rovnako ostražitý, keď sa chce vyhnúť nebezpečenstvu - chvíli, v ktorej sa zrazu zjaví v sieti žralok, alebo tej, keď znenazdajky príde búrka. ~~~ A dajme tomu, že taký obozretný by mal byť človek aj na mori, aby sa jedného dňa neutopil.	The concerns are immediate: a boon to be won or lost, a constant alertness to take advantage of any sudden windfall – copper bolts from a wrecked ship, barrels of oil, chests of tea; the same alertness to thwart danger – the sudden shock of the shark in the net, the storms; and, presumably, the same alertness throughout a day at sea, to escape drowning.	0.0150766
Nie je možné nájsť dva rovnaké dni, ani dve rovnaké osoby.	No two days or two persons are alike.	0.125806
Nevieme predpokladať, čo môžu priniesť.	There is no way to foretell what they might bring.	0.25
Plánovať dopredu je také bezvýznamné ako obzerať sa späť s ľútosťou.	To plan ahead is as useless as to look back in regret.	0.197727
Samozrejme, že prichádzajú aj sklamania. ~~~ Ale keď sa objavia, reakcia ľudí ja stále rovnaká.	Certainly, there are disappointments, but they are always greeted in the same way.	-0.0211268
Príhody, o ktorých hovorí len stroho, často dopadnú inak, než ľudia predpokladajú: napríklad nečakaný únik pred smrťou, alebo nečakané príchod šťastia.	Events, we are told laconically, often turn out differently from what people expect, which is as applicable to an escape from death as it is to sudden good fortune.	0.288636
Vládne tu poverčivý strach z predvídateľných udalostí, akoby práve ľudská snaha stačila na to, aby privolala hnev prírody.	There seems to be a superstitious fear of predicting events, as if the very human attempt itself may be enough to incur the wrath of nature.	0.271698
Dôvody nie sú vôbec dôležité.	Motives are of no importance.	0.3
O’Crohan neskúma, prečo sa ľudia chovajú tak či onak, prečo udalosti dopadnú tak a nie inak.	O Crohan never examines why people behave in such and such a manner, why an event turns out one way and not another.	0.411086
Podstatné je to, čo sa deje.	What happens is all.	0.2
Rovnaký názor uplatňuje pri problémoch s peniazmi.	The same view is taken of the spending of money.	0.2625
Ak by sme počas týchto dní šetrili libry tak ako po minulé roky, verím, že by nás chudoba nepostihla tak skoro.		-0.3
Ľudia hovoria, že koleso sa krúti stále dookola, a je to pravdivé príslovie, pretože v časti sveta, ktorú som poznal, sa otočilo mnohokrát.	If we had been as careful of the pounds in those days as we have been for some years past, it is my belief that poverty wouldn`t have come upon us so soon.	0.284746
Ľudia hovoria, že koleso sa krúti stále dookola, a je to pravdivé príslovie, pretože v časti sveta, ktorú som poznal, sa otočilo mnohokrát. ~~~ Keby sa svet v okolí Blasketských ostrovov trochu zlepšil, a Boh nám dal trochu šťastia, myslím si, že by sme sa nemuseli starať o to, ako s ním naložiť, vždy je možnosť "ľahko získať, ľahko stratiť".	…People say that the wheel is always turning, and that`s true saying, for in the part of the world that I have known it has turned many times; and if the world improved a bit round the Blaskets at that time, and God have us that much good fortune, I fancy we didn`t take the care we should have done of it, for `easy come, easy go` is always the way.	0.0384053
Môžeme vidieť, že keď mali dostatok peňazí, míňali vďačne a s radosťou, nepomysleli na zajtrajšok, ktorého sa možno ani nedožijú.	What shows through is that when they had plenty they spent if gratefully and joyously, without thought of the morrow they might never see.	0.286486
Keď boli v núdzi, snažili sa vydržať najlepšie ako vedeli.	When they went without, they tried as best they could to endure.	0.276
Prenikavý zmysel neustále sa opakujúceho dňa dáva knihe svoju nadčasovú kvalitu, ktorá sa prehĺbi oveľa viac tým, že ľudia a priestor vyzerajú akoby stáli mimo histórie.	If the strong sense of the day, the endlessly recurring day, gives to the work its timeless quality, this is deepened still more by the fact that people and place seem to stand outside history.	0.268966
Akoby nik nepočul vzdialené burácanie nového Írska.	The distant rumblings of a new Ireland are brushed aside.	0.280435
V období, keď k nám posielali lode, začalo sa v Írsku hovoriť o samospráve, alebo miestnej správe, ako to označujú v inom jazyku.	Just at the time that these companies were sending their boats to us, the talk was beginning throughout Ireland about self-government, or Home Rule, as it is called in another language.	0.291667
Vždy som rybárom hovoril, že miestna správa prišla k Írom, ktorí to ani len netušili, a že to celé začalo na Blasketských ostrovoch až teraz, keď k našim prahom prichádzalo žlté zlato z Anglicka a Francúzska, aby zaň nakúpili naše ryby a vyhli sa nášmu prekliatiu.	I often told the fishermen that Home Rule had come to the Irish without their knowing it, and that the first beginning of it had been made in the Blaskets now that the yellow gold of England and France was coming to our threshold to purchase our fish, and we didn`t give a curse for anybody.	0.468308
Rovnako drsný a nezávislý realizmus využíva v jazyku, ktorým píše a hovorí.	The same harsh independent realism is reserved for the language he writes and speaks.	0.263077
Mnoho lenivcov tvrdilo, že náš jazyk je nepoužiteľný. ~~~ To však nebol môj prípad.	I hear many an idle fellow saying that there`s no use in our native tongue; but that hasn`t been my experience.	-0.0471429
Len vďaka nemu som mohol žobrať o chlieb!	Only for it I should have been begging my bread!	0.257143
Neplatia žiadne dane.	They pay no taxes.	0.225
Na polostrove Dingle radšej nechajú lode zhniť, než by mali zaplatiť prenájom.	They`ll let the boasts rot in Dingle before they`ll pay rent.	0.457692
Žena v zápale hnevu, ktorá sa snaží vyhnúť súdnym zriadencom prichádzajúcim na breh, radšej zdvihne svoje dieťa, aby po nich hodilo kameň, keďže ho nemôže zdvihnúť .	A woman in her madness to prevent the bailiffs coming ashore will lift her own child to hurl when she cannot lay hand on a rock.	0.196154
Môžu len dúfať v trošku slávy.	They can hope for little fame.	0.3
Sláva sa nalepí na akúkoľvek významnú udalosť ako dôkaz toho, že sa udiala. ~~~ Žena z rodiny Manningovcov, skutočne obdivuhodná žena.	Fame is literally the news that sticks to any remarkable event, insofar as it happened and was witnessed.	-0.0421348
Bola to ona, ktorá skoncovala so zriadencami, ktorí sem chodievali deň čo deň a ničili chudobných, ktorí nemali z čoho žiť, len z hladu.	A woman of the Manning family, a marvelous woman, She it was who finished the bailiffs and the drivers who used to come here day after day ruining the poor, who had nothing to live on but famine.	0.421579
Správca vyliezol na strechu jej domu a začal ho rúcať priamo na ňu a na kŕdeľ jej drobných detí.	A bailiff climbed on to the roof of her house and started knocking it down on her and on to her flock of feeble children.	0.227848
Schytila nové nožnice, otvorila ich – jeden hrot smeroval na jednu stranu, druhý na opačnú.	She seized a pair of new shears and opened them – one point this way, the other that.	0.44837
Smelá a rozčúlená žena!	A stout woman and a mad woman!	0.842857
Správca si nič nevšimol, až kým mu jeden hrot nevrazila priamo do chrbta.	The bailiff never noticed anything till he felt the point of the shears stuck right into his behind.	0.193548
Tentokrát nevideli v diere stropu strechu domu, ale kaluž jeho krvi.	It wasn`t the roof of the house that came in through the hole this time, but a spurt of his blood.	0.198305
To bol posledný súdny zriadenec, ktorého sme kedy videli.	That`s the last bailiff we`ve seen.	0.116129
Dokonca aj získanie dôchodku je zobrazené s hlbokou nedôverou.	Even the boon of the pension is viewed with deep suspicion.	0.27
Mám už len dva mesiace na odchod, kým nadíde ten deň – deň, na ktorý sa vonkoncom neteším.	I have only two months to go till that date – a date I have no fancy for.	0.368421
Podľa mňa je to varovanie pred prichádzajúcou smrťou, aj keď je veľa ľudí, ktorí budú radšej starí s dôchodkom, než mladí a bez neho.	In my eyes it is a warning that death is coming, though there are many people who would rather be old with the pension than young without it.	0.409189
Zobrazuje rozľahlé miesta, akými sú Dingle či Amerika, ktoré rázne zjednoduší na obyčajné ostrovy.	Such farflung places as Dingle and America are brought in and ruthlessly reduced to the simplicities of the island frame.	0.440698
Amerika je krajinou driny, deor allais.	America is the land of sweat, deor allais.	1.14857
Jeho sestre bola v Amerika a žila v akejsi nore, kde by skôr mohli žiť zajace.	His sister had been there and could live where a rabbit could, like all the rest who had spent time there.	0.368658
Tak žili aj ostatní, ktorí tam prišli.	His brother had been there. We see how it has changed him as they fish for the lobsters.	-0.0545455
Aj jeho brat tam žil a vidíme, že ho úplne zmenil lov homárov. . . . ako som sa len musel nadrieť v Amerike, aby som zarobil dva šilingy, a tu stačí, keď spustím sieť do vody do hĺbky štyroch metrov!		-0.3
. . . ako som sa len musel nadrieť v Amerike, aby som zarobil dva šilingy, a tu stačí, keď spustím sieť do vody do hĺbky štyroch metrov!	…how I should have had to sweat in America to make two shillings, and all I have to do here is to pull up a pot through two fathoms of water!	0.501442
Keby niektorí ľudia v Amerike vedeli, že sa peniaze dajú zarobiť tak ľahko, nedokázali by leňošiť.	…there are people in America who, it they could come by money as easily as this, would never slumber or sleep.	0.451471
Hádzali by siete do mora celé hodiny.	They`d be pulling up all the time.	0.268966
Vidíme O’Crohanovu obozretnosť, aj to, ako Ameriku dokreslil do rámca ostrova.	We see O Crohan`s wariness, and how America, too, is etched into the island frame.	0.3
Skutočne som mu dôveroval tak veľmi ako to len šlo, i keď vo všeobecnosti táral dve na tri a občas sa objavilo čosi, čo nalomilo moju dôveru.	I believed him well enough so far as that went, though he blethered a lot generally, and I often had some difficulty in believing him.	0.401871
Nebol som taký ignorant, že by som nechápal ako to bolo v zahraničí – ťažká práca, predák, ktorý vás špehuje, občas aj dvaja.	I wasn`t so ignorant that I couldn`t understand how it was in countries overseas – hard work, and the ganger spying on you, two of them sometimes.	0.375962
Hrubé správanie v Amerike, ktoré je založené na sebeckosti, ohrozuje zvyky, a zvyky sú ich jediným zákonom, strážcom ich jemnej a krehkej vzájomnej závislosti.	America coarsens manners and, with the emphasis on self-seeking, endangers custom, and custom is their only law, the guardian of their delicate and fragile interdependence.	0.273723
Zaznieva tu jasný tón podráždenia.	We hear the clear tone of exasperation.	0.270968
Nedáva to žiadny zmysel.		-0.3
Ani v mysli človeka, ani v mysli ostrovana.	This makes no human or island sense.	0.241935
Možno si myslíte, že je niečo na tom, čo povedal.	You might think there was something in what he said.	0.278049
Stále však musíte brať do úvahy, že úbohý hriešnik v tom nemôže pokračovať rovnako vo dne aj v noci.	Still you have to consider that a poor sinner can`t keep at it night and day alike.	0.233824
Patrik, brat, si neváži hŕstku neznámych.	Pats, the brother, brings no respect to the table of strangers.	0.162162
Je špinavý a nič ho nezaujíma.	He is dirty and does not care.	0.288
Je tu viditeľný rozdiel.	We see the difference.	0.27
Teraz je možné vidieť, ako ponechal jednotlivca len s jeho vlastnými prostriedkami, prevažne v prírodnom prostredí.	It can be seen by now, how the individual is left very much to his own devices in a setting provided mostly by nature.	0.284375
Jeho obavy sú vždy blízko, môže získať či stratiť svoj život, alebo získať isté výhody.	His concerns are always near, a living to be won or lost, some small advantage to be gained.	0.291892
Sotva žijú ináč než zvery, sú ponechaní na milosť toho, čo im môže priniesť deň; no zvyky nás opäť privádzajú k spoločnosti, kde znova vidíme rovnaké vnímanie reality, rovnakú jednoduchosť formu podmienenú rovnakými potrebami.	They live hardly differently to beasts, always at the mercy of what the day may bring; but custom brings is to the social, and here again we find the same view of reality, the same simplicity of form conditioned by the same necessity.	0.38416
Tak ako je deň jednotkou času, mravnou jednotkou je rodina.	As the day is the unit of time, the family is the moral unit.	0.287755
E. R. Dodds nádhernou jednoduchosťou zovšeobecňuje v diele Gréci a Iracionalita (The Greeks and the Irrational) keď hovorí, že "Náboženstvo vzniká zo vzťahu človeka k celkovej spoločnosti a morálka zo vzťahu k blížnemu".	E. R. Dodds generalizes with beautiful simplicity in The Greeks and the Irrational, when he says that "Religion grows out of man`s relationship to his total environment and morals out of his relations to his fellow man."	0.822925
V rámci mravnej jednotky rodiny sú na prvom mieste rodičia, ktorí sú nedotknutí.	In the moral unit of the family, the parents come first and are inviolate.	0.266129
Keď sa Patrikovi synovia vytratia do Ameriky a opúšťajú svojho otca, O’Crohan je nesmierne pohoršený.	When Pats’ sons disappear into America, abandoning their father, O Crohan’s shock at the impiety is palpable.	0.279545
Ide o najhorší hriech, pretože život syna je takmer pokračovaním toho otcovho.	This is the worst possible offence, since a son`s life is almost a continuation of the father’s.	0.242647
Bratia a sestry sú ďalší v rámci mravnej jednotky, ktorá sa rozprestiera nad všetkými pokrvnými príbuznými i tými, ktorí sú pripojení manželským zväzkom, a nakoniec aj nad dobrými susedmi.	Brothers and sisters come next in the moral unit, which extends to blood relations and to those linked to the family through marriage, and finally to good neighbours.	0.255
Strachoval som sa o loď, ktorá ma tam nechala, aj o príbuzných, hoci na lodi nebol nik z rodiny, no človek sa vždy strachuje o dobrých susedov.	I was terrified for the boat that had left me and no wonder for some others of my kin were in her and besides even if I had no relation of board a man is often worried about good neighbours.	0.320702
K predstave rodiny takisto patrí aj sexuálny pud.	The sexual instinct, too, is subordinate to the family.	0.265116
Je to zdravý pud.	It is a healthy instinct.	0.16
Vidíme ho počas nocí plných tanca či bezhlavých stretnutí s dievčatami na horách. ~~~ O’Crohan sa sám chváli, že navzdory zdraviu, mladosti či dlhým nociam, počas svojho života na ostrove nikdy nemal problémy v sexuálnom živote.	We see it so in the nights dancing, the uninhibited encounter with the girls on the mountain, and O Crohan boasts that in all his years on the island, in spite of health and youth and long nights, not once did a sexual irregularity occur.	-0.0015544
J. M. Synge, ako pozorný outsider, hovorí o obyvateľoch ostrova Aran: Sexuálny inštinkt na ostrove nie je slabý. ~~~ Je však výrazne podriadený rodine a zriedka vedie k nejakým anomáliám.	As an observant outsider, Synge, notes about the Aran Islanders: The direct sexual instincts are not weak on the island, but they are so subordinated to the instinct of the family that they rarely lead to irregularity.	0.0219572
Tunajší život je stále naklonený patriarchátu a ľudia sa vzdialili od romantickej lásky, ako aj od výbušného života divocha.	The life here is still at almost a patriarchal stage and the people are as fat from the romantic moods of love as they are from the impulsive life of the savage.	0.38271
Manželstvo O’Crohana funguje na rovnakom princípe.	O Crohan`s own marriage is made in an identical mode.	0.293333
Bol zamilovaný, ak to tak môžeme nazvať v danom kontexte.	He was in love, if we can call it such in this context.	0.265909
Vyzerá to ako nevyhnutnosť, keď sa obracia chrbtom od milovaného dievčaťa ("v tom čase najpôvabnejšieho dievčaťa na svätej zemi") a sleduje, ako mu pripravujú svadbu, akoby pozoroval úplne inú osobu, postavu z dramatickej hry.	It is with a sense of inevitability that he turns away from the girl of his heart (`The most lovely girl on blessed earth at that time`) and watches the marriage being arranged, as if he were observing a separate person, a person in a drama.	0.381075
Najviac ho zaujíma snaha a drina členov rodiny, ktorí medzi sebou bojujú, aby mohli rozhodnúť o tom, ktoré dievča ho bude mať. ~~~ Ako keby dúfali, že keď vyberú dievča podľa seba, bude to pre nich doma jednoduchšie.	What interests him most is the pull and tug of the different family factions as they battle to decide which girl will get him, in the hope that the house will be more useful to them if they can install their own favourite.	-0.00167598
Napokon víťazí jeho sestra.	It is his sister who wins.	0.259091
Snaží sa presvedčiť rodičov, že "najpôvabnejšie dievča na svätej zemi" žije príliš ďaleko.	She persuades the parents that the family `of the most lovely girl on blessed earth` live too far away.	0.273418
Jej rodina pochádza z ostrova Inishvickaullaun, niekoľko míľ južnejšie. ~~~ V prípade núdze by trvalo večnosť dostať sa tam.	They live on Inishvickaullaun, on island a few miles to the south, an eternity away in any emergency.	0.100781
Podľa nej nikdy nebudú schopní podať ich rodine pomocnú ruku a tiež, že ktokoľvek by s nimi chcel ťahať za jeden povraz, berie na seba veľkú zodpovednosť.	She argues that anybody making an alliance with such a family was taking on a great responsibility and that they would never be in a position to lend much of a hand.	0.393189
Sama vybrala skvelé, chytré dievča, ktorého rodina žije v dedine, a vždy sú po ruke, keď treba.	She herself had picked an excellent, knowledgeable girl whose people lived in the village and could be relied upon when needed.	0.195
Keď bolo všetko dohodnuté, o manželstve už nepadlo ani slovo.	Once it was arranged, we hear no more about the marriage.	0.26875
Na náhrobnom kameni je napísané: "O Týždeň nato sme sa zosobášili, Tomas O’Crohan a Maire Keaneová, posledný týždeň Fašiangov, rok 1878."	It is tombstone writ: `A week from that day we were married, Tomas O Crohan and Maire Keane in the last week of Shrove in the year 1878.`	0.553808
Neskôr sa objavovali už len správy o samých problémoch - zdravotných komplikáciách jeho ženy, jej následnej smrti a o úmrtiach jeho detí.	All we hear afterwards is a catalogue of troubles, his wife`s failing health and death, the deaths of their children.	0.388312
Rovnako ako lá dar saol, aj ďalšia obľúbená fráza – rithe mo laethse či i rithe mo bhearthain – sa v knihe objavuje viackrát.	In the same way as lá dar saol, another equally haunting phrase - rithe mo laethse or I rithe mo bhearthain – echoes throughout the book.	1.47087
Flowerov doslovný preklad znie "v toku mojich dní", no podľa mňa to má predstavovať príliv sily a krás mladosti, ktorý zalieva celé pobrežie, a potom postupne a pomaly ustupuje.	`In the running of my days` is Flower`s literal translation, but it has, I feel, more of the sense of a great tide filling the strand with the vigour and glory of youth, coming to a fullness, and then gradually and weakly withdrawing.	0.514
Venuje tomu takú neobyčajnú pozornosť, akoby zobrazenie času, v ktorom príliv ustúpil, bolo posvätným obradom.	He goes to extraordinary care, as if it were a religious rite, to point out the time in his life when the tide turned.	0.296875
Zdá sa mi, že v tomto bode sú náboženské, poetické a poverčivé predstavy úzko späté.	It seems to me that it is here that the religious, the poetic, and the superstitious instincts are very close.	0.211268
Zdôrazňuje moment medzi tým, keď ho básnik vyrušil pri sekaní rašeliny a tým, keď sa doňho zamilovalo dievča: "Pre jeden deň, ktorý sme strávili spolu, šesť dní bol proti mne".	He marks the point between the day the poet kept him from cutting the turf and the girls fell upon him on the mountain: `From that day out, for the one day that went with me six went against me.`	0.281757
Dovtedy sa pobrežie napĺňalo ako sa srdce napĺňa srdečnosťou a potešením, mórchroí agus scléip; no zrazu nastáva odliv, ktorý je plný nepríjemných vecí.	Up to that time the strand was filling, there was the great heart and the fun, mórchroi agus seléip; but from that marked time on, we are in the ebb tide, and there was much to go against him in that withdrawal.	0.333397
Útechu našiel, kdekoľvek to šlo.	He found solace where he could.	0.277778
O smrti jeho syna: "Len jediná vec nás upokojovala.		-0.3
Na jeho tele sa nenašla ani jediná rana, ktorá by ho poškvrnila, aj keď to bol obrovský útes. ~~~ Ostávalo nám len jediné, a to zmieriť sa s tým." ~~~ Opiera sa o dávne nezmenené úslovia, "tí, ktorí pokračujú, nemôžu živiť tých, ktorí zostávajú" alebo "aj my by sme mali položiť naše veslá a ísť ďalej".	Of his son`s death: `We had only one comfort, there was no wound or blemish anywhere on his body though it was a steep fall from a cliff, and we had to put up with it and plough on and be satisfied`; and he leans on the old constant truisms, `those that pass cannot feed those that remain`, and `We too had to put our oars out and drive on.	-0.12391
Nič sa nemení, ani smrťou jeho manželky či syna, ktorý skonáva pri snahe zachrániť v mori Dublinčanku.	It is no different when his wife dies, or when his son dies trying to rescue the Dublin girl from the sea.	0.296512
Myslí len na to, aby ho rodičia toho dievčaťa nepovažovali za hlupáka, ktorý ich nebude nenávidieť zato, že jeho syn zomrel pri pokuse zachrániť ich dcéru, až kým nepochopí, že jeho syn mohol zomrieť kedykoľvek, príčina nebola dôležitá.	All that concerns him is that the girl`s parents shouldn`t think him stupid enough to feel enmity towards them because his son died trying to save their daughter, since he understood perfectly well that his son had to die sometime anyhow and the occasion was not important.	0.258
Smrť je vlastne len účasť.	Death is like a roll call.	0.286364
Neznamená to nič iné, než potvrdiť svoje meno na zozname a ísť ďalej.	There is nothing for it but to endure and go on.	0.403846
Každý jeden nový deň zaťažuje svet svojimi potrebami, ktoré neberú na vedomie smútok.	Each new day will break on the world with its own claims, demands that care nothing for the blindness of sorrow.	0.222973
Keďže smútok zaslepuje, je viac než zbytočný, je to akási porucha, pretože nový deň sa nebude zaoberať spomienkami na minulosť.	Sorrow, because it blinds, is worse than useless, it is an impairment, and the action required be the new day will not trouble itself with personal history.	0.23945
V tomto okamihu opäť pomáha rodina.	Here the family unit brings help once more.	0.241935
Každú noc sa strýko Diarmuid snaží uľahčiť ich trápenie zlými správami – stratená loď so stovkami cestujúcich, skaly zasypali pracovníkov v bani – dodať im odhodlanosť, prebrať ich odvahu.	Each night, Uncle Diarmuid calls to the house in an attempt to lighten trouble with news of worse – a ship lost at sea with hundreds on board, a wall of rock falling on all the workers of a mine – to put hearth in them, to renew their courage.	0.536646
Jediná vec, s ktorou si ľudia nedokážu dať rady, je šialenstvo.	The only thing they seem unable to deal with is madness.	0.255319
O’Crohan tvrdí, že smrť je v podstate skvelá, až na určité detaily, ktoré sa vznášajú nad úbohými hriešnikmi.	Death is a fine thing, O Crohan says, besides certain things that hang over poor sinners.	0.228
Keď sa pomätie syn Diarmuida, spoločnosť sa zrazu bojí pomôcť mu či dotknúť sa ho.	When Diarmuid`s son goes mad, the community appears to be afraid to help or touch the mad one.	0.26087
Keď O’Crohana, obyčajne sa chvastajúceho svojou ochotou pomáhať, požiadajú, nech zoženie ľudí, ktorí by chlapca vzali do Dingle, ten len smutne poznamená, že s ním môžu rátať.	OCrohan, who is usually so boastful of his readiness to give help, when asked to make up a crew to take the boy to Dingle, says mournfully that at such moments, all one can do is to stand up and be counted.	0.482286
Neskôr sa chlapec utopí, jeho telo nájdu a prinesú na breh a ľudia v Castlepointe len s neistotou, zdanlivým nepokojom a v zhone hovoria o tom, že chlapec odišiel k Bohu.	When the boy drowns himself and they find the body and bring it ashore, it is with a tentativeness, haste and deep unease that he is left with God in Castlepoint.	0.375705
Postupne sa dostávame na koniec príbehu.	We have come close to the end of a story.	0.272727
Mohli sme vidieť, ako sa všetky veci zredukovali len na svoju podstatu a sú bezprostredné a skutočné.	We have seen how all things are reduced to their essentials and are immediate and concrete.	0.264935
Existujú len do takej miery, do akej si to vyžaduje dej.	They only exist insofar as it is necessary to the action.	0.543617
Všetky záhadné a vzdialené miesta sú zobrazené a zjednodušené len do obrazu ostrova.	All mysterious and far-flung places are brought in and reduced to the island frame.	0.291549
Samotný deň prichádza, aby vniesol do deja svetlo.	The single day breaks over this world to bring light for the action.	0.211364
Tento bezprostredný dej napĺňa deň svojou nádejou a obavami, odlivom a prílivom, bez ohľadu na to, čo bolo alebo ešte len bude. ~~~ Všetko v tom jednom obraze smeruje do svojho záveru.	This immediate action, its hopes and ots stresses, its ebb and flow, fills the one day without regard to what went before or will come after, All runs to its conclusion in that single frame.	-0.00392157
Činnosti, ktoré by potrebovali mesiace či roky, sa zjednodušia natoľko, že sa prispôsobia rytmu dňa.	Actions that require months or years are so reduced that they seem to take on the rhythm of the day.	0.281707
Nasledujúci úsek, ktorý vyslovil George Moore, by mohol byť predlohou románu alebo novely a znie: "Martin žil len rok po svadbe.	The following passage could be the material of a novel or a long story running to many pages, by George Moore, say: `Martin lived only a year after his marriage, and then my sister had to return to her own people, for one of Martin`s brothers came back to live with the old people.	0.515179
Potom sa moja sestra rozhodla vrátiť k dôchodcom kvôli Martinovmu bratovi.	They wouldn`t give Maire anything, though Martin left a boy child.	0.257895
Oni by Maire nedopriali nič, hoci ona dala Martinovi syna.	Maire left the boy with us and went off to America.	0.515584
Rozhodla sa nechať chlapca nám a odišla do Ameriky.	After three years there, she came home again.	0.261538
Po troch rokoch sa vrátila späť.	She had the law on them and got the father`s share for the son.`	0.0428571
Získala na svoju stranu právo a s ním aj nárok na svojho syna."	The shape and rhythm of the story is completely that of a single day.	0.48544
Forma i štýl tohto príbehu sa celkom zhoduje s priebehom dňa. ~~~ Ľudia sú tiež zobrazení len v základných líniách, až pokým sa neprejavia ich výrazné identity.	People, too, are presented only in their essential outline, and that is only insofar as their striking identities are visible to the eyes of those around them.	0
Nakoniec sa prejavuje jednoduchá hrdinská poézia bez akýkoľvek nápadných metafor či obrazov; no na druhej strane, keď postupujeme ku koncu knihy – "bralo uprostred rozsiahleho mora a príboj znova a znova naráža priamo naň" – musíme sa vzdať domnienok, aby sme neboli dôverčiví, pretože to nesedí s povahou štýlu.	What emerges finally is a simple, heroic poetry, not in the sense of any striking metaphor or image; on the contrary, when we come on one towards the end of the book – the `crag in the midst of the great sea, and again and again the blown surf drives right over it` - we are almost inclined to suspend belief, at least to become suspicious, since it is so out of character with the style.	0.424528
Poézia sa vsiakla do celej knihy ako voda alebo morský vzduch v danej oblasti, jeho forma videnia a myslenia je taká stála ako jeho snaha nájsť formu vyjadrenia.	The poetry, rather, seeps through the book as a whole, like water or the sea air round the place itself, so persistent is the form of seeing and thinking, and this, equally persistently, seems all the time to fund its right expression.	0.270115
Aj napriek uzavretému rámu ostrova sa nám otvára zobrazenie celej existencie.	Unwittingly, through the island frame, we have been introduced into a complete representation of existence.	0.185294
Na konci O’Crohan spomína písanie aktuálnej knihy.	Towards the end of the book, he talks of the actual writing of the book.	0.206667
Tvrdí, že oslobodil dni zo zabudnutia, uzrel ich vlastnými očami, uvedomil si aj to, čie bremeno niesol na chrbte, a rabhas ag broc leis, ďalšia fráza, ktorá nemá výstižný preklad v angličtine.	He has, he says, rescued the days from forgetfulness, those days he has seen with his own eyes and whose burden he has borne, a rabhas ag broc leis, another phrase that cannot be properly rendered into English.	0.7343
Napĺňa ho predstava večnosti, keď všetko zmizne, a jediné, čo ostane, bude jeho život a život jeho susedov, kde nebol žiaden spor.	Then he looks forward to a dream of eternity, when all this will have vanished, and all that will be left is his account of his own life and the lives of his neighbours, without a bitter word ever having passed between them.	0.361779
Kniha je popretkávaná nepotlačovaným homérovským chvastaním, ktoré muselo zmiasť pôvodných editorov.	An uninhibited Homeric boasting runs through the book. It must have disturbed the original editors.	0.282558
Väčšinu buď zjemnili alebo vynechali.	Much of it has been either toned down or edited out.	0.220588
Je to viditeľné vo Flowerovom preklade, ktorý vznikol podľa verzie Seabhaca.	This can be seen in Flower`s translation, which is based on the version that the Seabhac put together.	0.214925
Vo vydaní z roku 1929 O’Crohan prehlásil, "Som hrdý na to, že som opísal svoj príbeh i príbeh mojich susedov."	In the 1929 edition O Crohan says, "I am proud to set down my story and the story of my neighbours."	1.83069
No v origináli stojí, "Ešte niečo" (charakteristický dodatok), "neexistuje taká krajina alebo susedská štvrť či národ, v ktorých by jeden človek nemohol zvíťaziť nad ostatnými!	But the original text is: "One other thing,` (a characteristic addition) `there`s not a country or neighbourhood or nation in which one person doesn`t triumph above all others!	0.294
Tugann an craobh leis."	Tugann an craobh leis."	2.7
Pokračuje, "Teraz sa po prvýkrát rozhorel plameň na ostrove, o ktorom nikto doteraz nepísal.	He continues, "Now, from the first time the fire was lit on this island no one has written about its life or its people.	0.2325
Preto craobh alebo prút víťazstva patrí tomu, kto to urobil!"	That leaves the craobh or the branch of victory with the person who did it."	0.516123
A síce, taký an t-uasal je O’Crohan.	And that is, namely, an t-uasal O Crohan.	1.01129
V závere sa vo svojich myšlienkach a pocitoch vracia opäť k predstave večnosti, a tak posledná veta tvorí akúsi základnú charakteristiku: Keď som mal osem rokov, mama zvykla ťažiť rašelinu, vďaka tomu som mohol chodiť do školy.	Then, at the conclusion, with that sure instinct which I find throughout the book, a persistent way of thinking and feeling finding naturally its right expression, he returns to the final dream of eternity, and the last sentence gathers in all the primary characteristics.	0.319572
Keď som mal osem rokov, mama zvykla ťažiť rašelinu, vďaka tomu som mohol chodiť do školy.	My mother used to go drawing turf when I was eight years old, so that she could have me at school.	0.284
Dúfam, že ona a otec (dvaja nedotknutí) zdedia sväté kráľovstvo a ja i každý, kto si prečíta túto knihu, sa s nimi opäť stretneme na rajskom ostrove.	I hope that she and my father (the two inviolates) will inherit the blessed kingdom and that I and every single person that will read this book will meet up with them again in the island of paradise.	0.205645
Verím, že tento ostrov leží bližšie pri Olympe než pri Rímskej nebeskej bráne, ku ktorej sme sa ako deti modlili.	I believe that this island lies closer to Mount Olympus than it does to the Roman gate of heaven that we used to pray to in our youth.	0.258947
Už keď sa veci stali tak, ako sa stali, každý má svoj vlastný príbeh.	Now that things have gone the way they have, everyone’s got a story.	0.3
Každý vám povie o tom, ako oni alebo ich známi, a už len podľa štýlu, ako to povedia, je jasné, že tým aj tak myslia seba, poznali Jacka.	Everyone’ll tell you how they or their friend, which you can see in the way they say it they want you to think means them, knew Jack.	0.39881
Možno o tom, ako mu pomohli a boli súčasťou jeho plánov.	Maybe even how they helped him, how they were part of his schemes.	0.248936
Väčšinou im však dôjde, že je to pritiahnuté za vlasy, takže to skončí len pri tom, ako oni alebo ich známi boli raz v správny čas na správnom mieste a videli ho utekať po strechách. ~~~ Peniaze mu lietali z tašky a pod ním sa ho milícia márne snažila dolapiť.	Mostly though of course they know that’s too muchand it’ll just be how they or their friend was there one time and saw him running over the roofs, money flying from his swag-bags, militia trying and failing to track him down below.	-0.000615213
Niečo také.	That sort of thing.	0.136364
"Môj kamoš raz videl Chrobáka Jacka," povedia, "len na okamih."	My mate saw Jack Half-a-Prayer once, they’ll say, just for a moment.	0.283636
Akoby sa snažili byť skromní.	As if they’re being modest.	0.275
Má to byť z úcty.	It’s supposed to be respect.	0.564286
Veria, že ju takto prejavujú, vzhľadom na to, čo sa stalo.	They reckon they’re showing their respect, with everything that’s happened.	0.189796
Samozrejme, že to tak nie je.	They ain’t, of course.	0.225
Zlietajú sa naňho ako supy a mne sa z nich zdvíha žalúdok.	They’re like dogs on his corpse and they disgust me.	0.272727
Hovorím vám to, aby ste pochopili, čo mám na mysli.	I tell you that so you know where I’m coming from.	0.285366
Pretože si uvedomujem, ako môže znieť to, čo sa vám chystám povedať.	Because I know how what I’m about to say might sound.	0.204545
Chcem, aby ste vedeli, čo tým myslím, keď poviem, že ja som Jacka poznal.	I want you to know where I’m coming from when I tell you that I did know Jack.	0.295082
Naozaj.	I did.	0.2
Pracoval som s ním.	I worked with him.	0.28125
Nepochopte ma zle, nebol som nijako výnimočný, ale bol som súčasťou toho celého.	I was lowly, don’t get me wrong, but I was part of the whole thing.	0.216667
A prosím, nemyslite si, že zo seba robím niečo viac, prisahám, že sa tu nenaparujem.	And please don’t think I’m talking myself up, but I swear to you I ain’t being arrogant.	0.291549
Ja nie som nič dôležité, ale práca, čo som robil, tá preňho dôležitá bola.	I’m nothing important, but the work I did, in a little way, was crucial to him.	0.285484
Len toľko k tomu.	That’s all I’m saying.	0.2
Takže.	So.	0.075
Takže asi chápete, že ma celkom zaujalo, keď sa nám dostal pod ruky človek, ktorý Jacka zradil.	So you can understand that I was pretty interested when I heard we’d got our hands on the man who sold Jack out.	0.25875
Aj takto sa to dá povedať.	That would be one way of putting it.	0.190909
To by bolo veľmi zjemnené.	That would be mild.	0.194118
Povedzme, že som sa postaral o to, aby som sa s ním zoznámil.	I made it my business to meet him, let’s put it that way.	0.273913
Pamätám si, keď som sa po Jackovom úteku prvý raz dopočul, čo má za lubom.	I remember the first time I heard what Jack was up to, after he escaped.	0.289831
Bol natoľko odvážny, až si ho všimli.	He was daring enough that he got noticed.	0.271875
"Počul si o tej pretvore, ktorá spáchala tú lúpež?" spýtal sa ma ktosi v krčme.	Did you hear about that Remade done that robbery? someone said to me in a pub.	0.290625
Dal som si pozor, aby som nijako nezareagoval.	I was careful, couldn’t show any reaction.	0.275676
Keď som sa zoznámil s Jackom, niečo som pocítil, viete?	I’d felt something when I met Jack, you know?	0.228947
Rešpektoval som ho.	I respected him.	0.24
Nechvastal sa, ale mal v sebe oheň.	He wasn’t boastful, but he had a fire in him.	0.23
Aj tak som si nemohol byť istý, že z neho niečo bude.	Even so, I couldn’t be sure he’d come to anything.	0.292857
Počas jeho prvého záťahu sa mu podarilo ukradnúť stovky noblí a rozdať ich na ulici.	That first job, he got away with hundreds of nobles and gave it away on the streets.	0.291304
Získal si tým lásku najchudobnejších zo Psej štvrte.	He scored himself the love of the Dog Fenn poor that way.	0.293478
Všetkých tým nadchol a uverili, že nie je len obyčajný gangster.	That was what had people all excited, told them he was something else than your average gangster.	0.402727
Nebol prvý, kto to urobil, no bol jedným z mála.	He weren’t the first to do that, but he was one of few.	0.542727
Na mňa však ani tak nezapôsobilo, čo s tými peniazmi spravil, ale skôr to, odkiaľ ich ukradol.	What got me wasn’t so much what he did with the money as where he stole it from.	0.229687
Z vládnej budovy.	It was a government office.	0.15
Kde skladujú peniaze z daní.	Where they store taxes.	0.242857
Každý vie, aké sú takéto miesta zabezpečené.	Everyone knows what the security on those places is like.	0.223077
Vedel som, že jediný dobrý dôvod, prečo by také niečo urobil bol ten, že chcel celý systém poslať dokelu.	And I knew that there was no way he’d have done something like that without it being a screw you.	0.265823
Urobil to preto, aby im všetkým ukázal, a ja som ho za to obdivoval.	He was making a point, and my good bloody godsbut I admired that.	0.503175
Bolo to vtedy v tej krčme, keď mi došlo, čo dokázal a ako sa mu ten nočný prepad podaril, ako sa v jeho novom tele vyšplhal, prikrádal a prebojoval dovnútra. ~~~ Ako sa len tak vyparil, pričom mu to sťažovala váha peňazí. ~~~ Vtedy mi došlo, čo v ňom je.	It was then, in that pub, when I realised what he’d done, how he must have made that night-raid work, how he must have climbed and crept and fought his way in, with his new body, how he must have been able to vanish, weighed down with specie, that I realised he was something.	-0.0921864
V tej chvíli som vedel, že Chrobák Jack nie je len taká obyčajná pretvora a len taký obyčajný renegát.	That was when I knew that Jack Half-a-Prayer was no ordinary Remade, and no ordinary renegade.	0.457721
Len málo ľudí vidí pretvory tak, ako ich vidím ja, tak, ako ich videl Jack.	Not many people see the Remade like I do, or like Jack did.	0.2125
Viete, že mám pravdu.	You know it’s true.	0.264706
Podľa väčšiny z vás sa majú buď ignorovať, alebo využívať.	To most of you they’re to be ignored or used.	0.194595
Ak si ich skutočne všimnete, želáte si, aby ste to nespravili.	If you really notice them you wish you hadn’t.	0.192308
Jack taký nebol a nie len preto, že on sám bol pretvora.	It wasn’t like that for Jack, and not just because he was Remade.	0.247826
Stavím sa – som si istý – že Jack si ich všímal, videl ich jasne aj predtým, ako sa to stalo aj jemu.	I bet—I know—that Jack used to notice them, see them clear, before him.	0.628571
Tak to bolo aj u mňa.	And that’s the same for me.	0.194118
Ľudia prechádzajú okolo nich a vidia len odpad. Pretvorený odpad so zdeformovanými telami, ktoré na nás chrlia trestné továrne.	People walk along and see nothing but trash, Remade trash with bodies all wrong, shat out by the punishment factories.	0.27
Nechcem znieť príliš sentimentálne, ale nepochybujem o tom, že Jack videl ženu, hoci jej ruky boli preč a nahradili ich vtáčie krídla. ~~~ Videl starca, nie bezpohlavnú vec, na ktorú ho zmenili, videl chlapca, ktorý mal namiesto očí len tmavé sklo, trúbky a svetielka. ~~~ Chlapca, ktorý sa tackal a snažil sa vidieť s očami, s ktorými sa nenarodil, ale predsa, chlapca.	Well, I don’t want to be too sentimental about itbutI’ve no doubts at all that Jack’d have seen this woman— whose hands yes were gone and been replaced with little birds’ wings—and he’d have seen an old man, not the sexless thing he’d been made into, and a young lad with eyes gone and in their place an array of dark glass and pipework and lights and the boy stumbling trying to see in ways he weren’t born to but still a boy.	-0.1103
Jack by videl ľudí upravenými parnými strojmi, olejovým ústrojenstvom, časťami zvierat. ~~~ Ich orgány či kožu pozmenili kliatbami a všetkými tými vecami, ale pod ich trestami by stále videl ľudí.	Jack’d see people changed with engines in steam, and oily gears, and the parts of animals, and their innards or their skin altered with hexes, and all those things, but he’d have seen them under the punishment.	-0.00718563
Ľudí zlomí, keď ich pretvoria.	People get broken when they get Remade.	0.222222
Videl som to mnohokrát.	I’ve seen it so many times.	0.271429
