Stav mysle môžeme definovať ako súhrn miliónov neurologických procesov, ktoré sa v nás odohrávajú. ~~~ Inými slovami, súhrn dojmov v ktoromkoľvek momente.	A state can be defined as the sum of the millions of neurological processes happening within us, in other words, the sum total of our experience at any moment in time.	-0.0056391
Problémom je, že väčšinu stavov nedokážeme vedome smerovať.	The problem is, most of our states happen without any conscious direction on our part.	0.186792
Ľudské úspechy a zlyhania sú úzko späté so schopnosťou neustále sa udržiavať v stave priaznivom pre dosiahnutie cieľa.	People succeed or fail in life in direct relationship to their ability to consistently put themselves in states that support them in their achievements.	0.217647
Takmer všetko, čo ľudia chcú, považujeme za nejaký stav – lásku, sebavedomie, rešpekt, či dokonca peniaze, pomocou ktorých chcú získať slobodu, moc, lásku, atď.	Almost everything people want is some possible state - love, confidence, respect - even money, which you want in order to give you states like freedom, power, love, etc.	0.291304
Správanie sa odvíja od stavu mysle, ktorý tvoria dva základné komponenty:	Behavior is the result of the state we're in, and our states are created by 2 main components:	0.234375
1. Vnútorné vnímanie - a) čo a ako si vo svojej mysli predstavujeme; b) čo si v mysli povieme a čo počujeme;	1) Internal representations - a) what and how we picture in our mind, b) what we hear and what we say to ourselves in our mind;	0.640168
2. Fyziológia – postoj, biochémia, dýchanie, uvoľňovanie a napínanie svalov.	2) Physiology - posture, biochemistry, breathing, muscular tension/relaxation.	0.282353
VNÚTORNÉ VNÍMANIE a FYZIOLÓGIA fungujú v kybernetickej slučke.	INTERNAL REPRESENTATION and PHYSIOLOGY work in a cybernetic loop.	0.622619
Všetko to, čo ovplyvňuje jedno, zároveň ovplyvňuje aj druhé.	Anything that affects one will automatically affect the other.	0.288679
Aby sme stav mysle dokázali ovládať, musíme kontrolovať a vedome smerovať svoje vnútorné vnímanie aj fyziológiu.	To control our states, we must control and consciously direct our internal representations and physiology.	0.283871
Kľúčovým slovom je zobrazovanie. ~~~ Svet vnímame piatimi zmyslami – zrakom, sluchom, hmatom, čuchom a chuťou.	The key word is representation - we experience our world through our five senses - visual, auditory, kinesthetic, olfactory, gustatory.	-0.0347368
Mozog zachytáva zmyslové podnety a procesom zovšeobecňovania, skresľovania a vyraďovania ich premieta, alebo filtruje do podoby, akú VNÍMAME VNÚTORNE.	Through the process of generalization, distortion, and deletion, the brain takes the sensory stimuli and represents or filters them into an INTERNAL REPRESENTATION.	0.277444
Vaše vnútorné vnímanie, váš zážitok z udalosti, teda nie je udalosť samotná, ale skôr osobný vnútorný dojem – je to len interpretácia, filtrovaná cez konkrétne presvedčenia, stanoviská, hodnoty a metaprogramy.	Thus, your internal representation, your experience of the event, isn't precisely what happened but rather a personalized internal representation - it's just one interpretation as filtered through specific personal belief, attitudes, values, and metaprograms.	0.320531
Tento proces filtrovania vysvetľuje rozmanitosť ľudského vnímania.	This filtering process explains the huge range in human perception.	0.289831
Niektorí ľudia možno venujú viac pozornosti tomu, čo videli, iní možno tomu, čo počuli – pozerajú sa na vec z rôznych uhlov pohľadu a majú rozličné fyziológie, ktorými proces vnímania začína.	One person may pay more attention to what (s)he saw, another to what (s)he heard - they look at it from different angles, and have different physiologies to begin the perception process with.	0.29625
Realita nie je nič iné, ako naše vlastné vnímanie danej situácie. ~~~ Tak prečo ju nevnímať tak, aby vás aj ostatných posilňovala, a nie obmedzovala?	Since we don't know how things really are, but only how we represent them to ourselves, why not represent them in a way that empowers ourselves and others, rather than creating limitations?	-0.0408
Kľúčom k úspechu je riadenie pamäti.	The key to doing this successfully is memory management.	0.140625
V každej situácii je možné sústrediť sa na množstvo aspektov a vy ju dokážete vnímať priaznivo, nech je akokoľvek zlá.	In any experience, you have many things to focus on - no matter how terrible a situation is, you can represent it in a way that empowers you.	0.397857
Všetko môžeme vnímať pozitívne, alebo robiť opak.	We can represent things in a way that puts us in a positive state, or we can do the opposite.	0.0886364
Ak nebudeme svoju myseľ a stav vedome smerovať, prostredie na nás môže mať negatívny vplyv.	If we don't consciously direct our own minds and states, our environment may produce undesirable states.	0.253846
Sústredením sa na tie správne veci očistíme svoju záhradku od buriny.	We must weed our garden by deciding what we are going to focus on.	0.266667
Úspešní ľudia si kedykoľvek dokážu privodiť taký stav mysle, aký práve najviac potrebujú.	Successful people are able to gain access to their most resourceful states on a consistent basis.	0.280769
Pri utváraní stavu mysle má náš mozog niekoľko možností, ako zareagovať.	When we go into a state, our brain then accesses possible behavioral choices.	0.285714
Ich počet je stanovený vaším ponímaním sveta – ako reagujete, keď ste napríklad nahnevaní?	The number of choices is determined by our models of the world - what are your behavioral choices when you're in an angry state, for example?	0.15
Chôdzou po žeravom uhlí sa ľudia učia meniť stav mysle a reakcie tak, aby prekonali strach, začali konať a dosahovať nové výsledky.	The Firewalk teaches people how to change their states and their behaviors in a way that empowers them to take action and produce new results in spite of fear.	0.373678
Táto metóda pomáha ľuďom vytvárať nové vnútorné ponímanie vlastnej viery a možnosti.	The Firewalk helps people form a new internal representation of belief and possibility.	0.522661
Väčšina ľudí ovláda svoju myseľ vedome len v minimálnej miere.	Most people take very little conscious action to direct their states.	0.266667
Ráno sa zobudia deprimovaní alebo plní energie.	They wake up depressed or they wake up energized.	0.3
Priaznivé udalosti ich priam nakopnú, tie zlé ich demotivujú.	Good breaks lift them up, bad ones bring them down.	0.223256
Úspešní ľudia zo seba dokážu aj pod tým najväčším tlakom dostať to najlepšie.	Successful people are able to summon their best when they need it, when the pressure is the greatest.	0.427922
Tí, ktorí sa rozhodnú, na čo sa budú sústrediť a ako budú čo vnímať, sú majstrami v ponáraní sa do najrozvinutejších častí mysle, a tak bežne dokážu ovplyvňovať svoj psychický stav.	People who have achieved excellence are masters of tapping into the most resourceful parts of their brain, by deciding what they are going to focus on -what they are going to represent to themselves, and thus controlling the state they access on a regular basis.	0.261513
3. KAPITOLA – KĽÚČOVÉ BODY	CHAPTER III - KEY POINTS	0.271429
Ľudské úspechy a zlyhania sú úzko späté so schopnosťou neustále sa udržiavať v stave priaznivom pre dosiahnutie cieľa.	People succeed or fail in life in direct relationship to their ability to consistently put themselves in states that support them in their achievements.	0.217647
Je to práve zmena stavu, o ktorú sa väčšina ľudí snaží.	State change is what most people are after.	0.227027
Naučte sa efektívne využívať svoju myseľ a tým ovplyvňovať stav, v akom sa nachádzate.	Learn how to effectively run your brain in order to direct your state.	0.223729
Správanie sa odvíja od stavu mysle, ktorý tvoria dva základné komponenty:	Behavior is the result of the state we're in, and our states are created by 2 main components:	0.234375
1. Vnútorné vnímanie a) čo a ako si vo svojej mysli predstavujeme; b) čo si v mysli povieme a čo počujeme;	1) Internal representations a) what and how we picture in our mind b) what we hear and what we say to ourselves in our mind	0.5279
2. Fyziológia – postoj, biochémia, dýchanie, uvoľňovanie a napínanie svalov.	2) Physiology - posture, biochemistry, breathing, muscular tension/relaxation.	0.282353
VNÚTORNÉ VNÍMANIE a FYZIOLÓGIA fungujú v kybernetickej slučke.	INTERNAL REPRESENTATION and PHYSIOLOGY work in a cybernetic loop.	0.622619
Všetko to, čo ovplyvňuje jedno, zároveň ovplyvňuje aj druhé.	Anything that affects one will automatically affect the other.	0.288679
Mozog zachytáva zmyslové podnety a procesom zovšeobecňovania, skresľovania a vyraďovania ich premieta, alebo filtruje do podoby, akú VNÍMAME VNÚTORNE.	Through the process of generalization, distortion, and deletion, the brain takes the sensory stimuli and represents or filters them into an INTERNAL REPRESENTATION.	0.277444
SAMOTNÁ MAPA NIE JE ÚZEMIE.	THE MAP IS NOT THE TERRITORY.	0.2875
Kľúčom k úspešnému smerovaniu vášho vnútorného vnímania je riadenie pamäti.	The key to directing your internal representations successfully is memory management.	0.259701
Musíme sa sústrediť na správne veci, a tým plieť svoju záhradku. ~~~ Presne tak ako W. Mitchell.	We must weed our garden by deciding what we are going to focus on - like W. Mitchell did.	-0.0166667
Život je ako rieka.	Life is like a river.	0.282353
Ak sa dobrovoľne a vedome nenecháte unášať prúdom, môže k vám byť milosrdná. ~~~ Naše ponímanie sveta určuje počet reakcií, ktoré máme k dispozícii.	It's moving, and you can be at the mercy of the river if you don't take deliberate conscious action to steer yourself in the direction you have predetermined.	-0.0084
Väčšina ľudí ovláda svoju myseľ vedome len v minimálnej miere.	Most people take very little conscious action to direct their states.	0.266667
Ráno sa zobudia deprimovaní alebo plní energie.	They wake up depressed or they wake up energized.	0.3
Priaznivé udalosti ich priam nakopnú, tie zlé ich demotivujú.	Good breaks lift them up, bad ones bring them down.	0.223256
Úspešní ľudia zo seba dokážu aj pod tým najväčším tlakom dostať to najlepšie.	Successful people are able to summon their best when they need it, when the pressure is the greatest.	0.427922
Chôdza po žeravom uhlí ľudí učí vytvárať nové vnútorné vnímanie možností.	The Firewalk teaches people to form new internal representations of possibility.	0.267188
Ste žiarliví?	Are you a jealous person?	0.0923077
Nie.	No, you're not.	-0.24
NESTOTOŽŇUJTE SA SO SVOJÍM SPRÁVANÍM.	YOU ARE NOT YOUR BEHAVIOR.	0.156522
Zapamätajte si, že správanie sa odvíja od stavu mysle – teda žiarlivosti. ~~~ Tento stav môžete okamžite zmeniť prostredníctvom fyziológie a vnútorného vnímania (na čo sa budete sústrediť).	Remember, behavior is a result of your state you're in a jealous state, and you can change that state by changing your physiology and your internal representations - what you focus on - in an instant.	-0.0037037
3. KAPITOLA - CVIČENIA	CHAPTER III - EXERCISE	0.9
1. Spomeňte si na konkrétnu situáciu, kedy ste žiarlili.	1. Think of a time when you were in a jealous state.	0.55
Preneste sa k nej späť vo svojich myšlienkach a odpovedzte na nižšie uvedené tri otázky.	Go back to that specific time, and ask yourself the three questions below.	0.242857
(Ak ste nikdy nežiarlili, spomeňte si na situáciu, kedy ste sa na niekoho hnevali.)	(If you've never been jealous, then think of a time when you were angry at someone.)	0.295714
Zistite, ako ste k tomuto stavu dospeli.	Find out HOW you created this state for yourself by discovering:	0.128571
a) Čo ste si predstavili v súvislosti s danou osobou?	a) What did you picture about that person?	0.558333
Boli ste si vedomí niečoho, čo daná osoba urobila, alebo naopak, neurobila?	Were you conscious of any images about what you thought that person did or didn't do?	0.272308
Všimnite si, akú silu tieto spomienky mali alebo nemali v súvislosti s vaším pocitom žiarlivosti.	Note how much power these pictures either have or don't have in terms of your feeling the state of jealousy.	0.278571
(Pozn.: vizuálne spomienky pre vás možno nie sú až také dôležité, resp. si ich nie ste vedomí – v tom prípade prejdite k bodu b);	(Note: the pictures may not be that important to you, or you may not be aware of them - you may have to go to step b.)	0.258065
b) Čo ste vo svojej mysli počuli, alebo ste si pri tomto zážitku hovorili? – tzn. všímajte si, čo hovorí hlas druhej osoby alebo váš vlastný, a takisto intonáciu, s akou dané slová vyslovil;	b) What did you hear or say to yourself about this experience? - i. e. the other person's voice saying what, or what did you say to yourself - note both the words and the tonality of how those words were said.	0.364828
c) Čo ste cítili? – aké pocity sa šírili vaším telom, keď ste žiarlili – napr. teplota, postoj, dýchanie, stiahnutie svalov, pocit v žalúdku, výraz tváre atď.	c) What did you feel in your body? - what sensations did you feel in your body when you were feeling the state of jealousy - like temperature, posture, breathing, muscular tension, feeling in the stomach, facial expressions, etc.	0.27406
Všimnite si, ktorá z týchto troch foriem vnímania má na vás najsilnejší vplyv a najľahšie vo vás vyvolá žiarlivosť.	Notice which of the three representations of internal system is the most powerful for you - which has the most power to put you in the state of jealousy.	0.214286
Takisto by ste si mali uvedomiť, že je to len stav mysle a môžete ho zmeniť, ak sa budete sústrediť na niečo, vďaka čomu sa budete cítiť príjemne.	You should also notice now that this is just a state, and can be changed by focusing on something that makes you feel good.	0.483564
2. Postupujte rovnako ako v prvom bode, ale zamerajte sa na lásku.	2. Follow the same procedure as in number 1, but choose the state of love.	0.503984
Spomeňte si na konkrétnu situáciu, v ktorej ste veľmi milovali, alebo sa cítili milovaní.	Remember a time when you felt totally loved or loving.	0.0978261
Vráťte sa k nej späť a zistite, vďaka čomu ste lásku pocítili. Porovnajte rozdiely vo vizuálnych spomienkach, vnútorných dialógoch a fyziológii medzi týmito dvoma stavmi mysle.	Remember a specific time, and go back to that time, and discover HOW you go into the state of love, and notice the difference in pictures, internal dialogue and physiology between these two states.	0.385453
4. KAPITOLA	CHAPTER IV	0.27
Človek je tým, v čo verí.	Man is what he believes.	0.3
Spomeňte si na Pabla Casalsa. Mal 90 rokov, bol krehký a trpel artritídou. ~~~ Keď si však predstavoval, ako hrá na klavíri, jeho psychické rozpoloženie sa úplne zmenilo, a tým aj jeho fyzický stav.	Think of the story of Pablo Casals at 90 - frail and arthritic, the veryl thought of playing the piano totally changed his state and thus the effectiveness of his body.	0.997619
Veril v magickú silu svojej hudby.	He believed in the transcendent power of his art, his music.	0.09
Viera priamo ovláda váš nervový systém.	Beliefs deliver direct commands to your nervous system.	0.18
Ak s ňou správne narábate, môže sa stať vašou najsilnejšou zbraňou a priniesť so sebou mnoho dobrého.	Handled effectively, they can be the most powerful forces for creating good in your life.	0.260526
Na druhej strane viera, ktorá vás obmedzuje, vás môže zničiť presne tak, ako vás povznášajúca viera môže obohatiť.	On the other hand, beliefs that limit your actions and thoughts can be as devastating as resourceful beliefs can be empowering.	0.269388
Slúži ako kompas a mapa, ktoré nás vedú k cieľu a poskytujú istotu, že sa k nemu dostaneme.	Beliefs are the compass and maps that guide us toward our goals and give us the certainty to know we'll get there.	0.224
Ak ju nemáte, alebo ju nedokážete využiť, nemusíte byť dostatočne silní. ~~~ S pevnou vierou však svoj cieľ vidíte a máte energiu do neho dobehnúť.	Without beliefs or the ability to tap into them, people can be totally dis-empowered; with powerful guiding beliefs, you can see what you want and be energized to get it.	-0.0231707
Čím viac vieme o ľudskom správaní, tým viac si uvedomujeme, akú obrovskú moc má nad naším životom viera.	The more we learn about human behavior, the more we learn about the extraordinary power that beliefs have over our lives.	0.252273
Vezmite si napríklad pokusy, pri ktorých sa ľudí pod vplyvom hypnózy dotkli kúskom ľadu, ale presvedčili ich, že ide o horúci kov.	There have been numerous studies in which a person in a hypnotic trance is touched with a piece of ice represented to him/her as a piece of hot metal.	0.264545
V bode dotyku sa zakaždým vytvoril pľuzgier.	Invariably a blister will develop at the point of contact.	0.215385
Priama, nesporná komunikácia s nervovým systémom, teda viera, zvíťazila nad skutočnosťou.	What counted was not reality but belief - the direct, unquestioned communication to the nervous system.	0.26625
Mozog jednoducho urobí presne to, čo mu viera prikáže.	The brain simply does what it's told through our beliefs.	0.287234
Norman Cousins hovorí o placebo efekte a na základe skúmania mnohých chorôb, vrátane tej svojej, tvrdí: Nie vždy potrebujeme lieky.	Norman Cousins talks about the placebo effect, and from his own illness and studying many others, concludes, Drugs are not always necessary.	0.709987
Vieru vo vyliečenie však potrebujeme vždy.	Belief in recovery always is.	0.161538
Je to jednoducho len psychický stav, pocit istoty, ktorý ovplyvňuje naše správanie.	Belief is nothing but a state - a feeling of certainty - that governs behavior.	0.268182
Dokonalosť sa môže zrodiť vtedy, keď si uvedomíme, že viera je otázkou voľby.	The birth of excellence begins with our awareness that our beliefs are a choice.	0.290909
Je iba na vás, či sa ňou necháte ťahať na vrchol alebo ku dnu.	You can choose beliefs that limit you, or you can choose beliefs that support you.	0.186
Ľudia majú často mylnú predstavu, že viera je iba statický pojem, izolovaný od činu a dôsledku. ~~~ Táto teória je však od pravdy na míle vzdialená.	The biggest misconception people often have of belief is that it's a static, intellectual concept, an understanding that's divorced from action and results.	-0.0117647
Vieru podmieňuje niekoľko faktorov:	Beliefs come from a variety of sources:	0.290909
1. PROSTREDIE sa dá považovať za najväčší zdroj viery – porovnajte si vplyv geta s vplyvom priaznivého prostredia, ktoré vo vás živí presvedčenie, že ste výnimoční, alebo pravý opak.	1) ENVIRONMENT may be the single most potent generator of belief - ghettos, on the one hand, supporting environments that help foster beliefs about being special or the other.	0.285811
2. MALÉ I VEĽKÉ UDALOSTI – ako napr. atentát na Kennedyho alebo udalosti z osobného života, na ktoré nikdy nezabudneme.	2) EVENTS, SMALL OR LARGE - like Kennedy's assassination, and personal events we'll never forget.	0.239286
3. VEDOMOSTI nám umožňujú vymaniť sa spod negatívneho vplyvu prostredia.	3) KNOWLEDGE is one of the ways to break the shackles of a limiting environment.	0.285937
4. MINULÉ VÝSLEDKY – vedomie, že sme už niekedy dosiahli to, čo sme si zaumienili. Zvyčajne stačí aj jeden úspech.	4) OUR PAST RESULTS - knowing you've already achieved the result you want before - just once is usually enough.	0.290323
5. PREDSTAVUJTE SI, ŽE TO, ČO CHCETE DOSIAHNUŤ V BUDÚCNOSTI, STE DOSIAHLI UŽ TERAZ – zažite úspech v predstihu.	5) CREATE IN YOUR MIND THE EXPERIENCE YOU DESIRE IN THE FUTURE AS IF IT WERE HERE NOW - experiencing results in advance.	0.284043
Je dôležité, aby ste si zapamätali, že možnosti, ktoré využívame, a výsledky, ktoré dosahujeme, sú súčasťou dynamického procesu. ~~~ Ten začína vierou, ako zobrazuje nasledujúca schéma:	It is important to remember that the potentials we tap, the results we get, are all part of a dynamic process that begins with belief, as seen by the following diagram:	0.0427867
Ak sa budete od začiatku sústrediť na to, čo nedokážete, budete môcť využiť len obmedzené množstvo potenciálu. Vynaložíte polovičaté úsilie, budete konať ako keby na skúšku a dosiahnete len biedne výsledky. Čo to urobí s vašou vierou pri nasledujúcej snahe niečo dosiahnuť?	If you start with a belief system that stresses what you can't do, you tap a limited amount of your potential, and you take half-hearted action, tentative actions, which will probably lead to dismal results, and then what will these results do to your beliefs about subsequent endeavors?	0.429234
Je to typická zostupná špirála – neúspech plodí neúspech.	This is a classic downward spiral: failure breeds failure.	0.294
Pozrime sa na to ale z druhej strany. ~~~ Ak budete každou bunkou svojho tela od začiatku veriť, že uspejete, budete schopní využiť veľké množstvo potenciálu a podniknúť dôležité kroky. ~~~ Môžete si byť istí, že takto budete v budúcnosti svojim schopnostiam veriť ešte viac.	On the positive side, however, if you begin by believing with every fiber of your being that you will succeed, you'll tap lots of your potential, take massive action, and your belief in your ability to produce even better results in the future will be affirmed.	-0.109596
V tomto prípade platí pravidlo, že úspech sa živí úspechom a každý jeden prehlbuje vieru v seba samého a podnecuje k dosahovaniu ešte lepších výsledkov.	In this case, success feeds on success and each success creates more belief and momentum to success on an even higher scale.	0.227885
Je to neuveriteľné, ale pre dosiahnutie cieľa niekedy jednoducho stačí neveriť v obmedzenia, alebo mať skúsenosť, ktorá určité obmedzenie odbúrava – a to je ďalší prínos chôdze po žeravom uhlí.	Amazingly, sometimes just not having a limiting belief is enough to ensure success, or to have an experience that disproves a particular limitation - another reason we do the Firewalk.	0.573015
VAŠA REALITA JE REALITOU, KTORÚ TVORÍTE VAŠIMI PRESVEDČENIAMI.	YOUR REALITY IS THE REALITY YOU CREATE THROUGH YOUR BELIEFS.	0.276923
DOBRE SI ICH ZVÁŽTE!	CHOOSE THEM WELL!	0.2625
4. kapitola– KĽÚČOVÉ BODY	CHAPTER IV - KEY POINTS	0.255
Viera priamo ovláda váš nervový systém.	Beliefs deliver direct commands to your nervous system.	0.18
Viera slúži ako kompas a mapa, ktoré nás vedú k cieľu a poskytujú istotu, že sa k nemu dostaneme.	Beliefs are the compass and maps that guide us toward our goals and give us the certain to know we'll get there.	0.255
Viera je jednoducho iba psychický stav, pocit istoty, ktorý ovplyvňuje naše správanie.	Belief is nothing but a state - a feeling of certainty - that governs behavior.	0.254545
Dokonalosť sa môže zrodiť vtedy, keď si uvedomíme, že viera je otázkou voľby.	The birth of excellence begins with our awareness that our beliefs are a choice.	0.290909
Vieru podmieňuje niekoľko faktorov: 1. Prostredie 2. Udalosti 3. Vedomosti 4. Minulé výsledky 5. Predstavujte si, že to, čo chcete dosiahnuť v budúcnosti, ste dosiahli už teraz – zažite úspech v predstihu.	Beliefs come from a variety of sources: 1) Environment 2) Events 3) Knowledge 4) Past results 5) Creating in your mind the experience you desire in the future as if it were here now - experiencing results in advance.	0.293143
VIERA – POTENCIÁL – KONANIE – VÝSLEDKY – to, či vystúpite na vrchol, alebo padnete na dno, závisí od miery, do akej veríte v svoj úspech.	BELIEF – POTENTIAL – ACTION – RESULTS - upward or downward spiral that begins with your belief - your level of certainty about your success.	0.635534
Na dosiahnutie cieľa niekedy jednoducho stačí neveriť v obmedzenia.	Sometimes just not having a limiting belief is enough to ensure success.	0.29
Dobrý strom nerastie ľahko; čím silnejší je vietor, tým silnejší je strom.	Good timber does not grow with ease; the stronger the wind, the stronger the trees.	0.271875
VIERA JE STAVEBNÝM KAMEŇOM VAŠEJ REALITY.	YOUR REALITY IS THE REALITY YOU CREATE THROUGH YOUR BELIEFS.	0.178378
DOBRE SI ZVÁŽTE, V ČO BUDETE VERIŤ!	CHOOSE THEM WELL!	0.0375
4. KAPITOLA – CVIČENIA	CHAPTER IV - EXERCISES	0.3
Pozrime sa na to, čomu veríte v súvislosti s pôvodom týchto presvedčení: A. Prostredie.	Let's take a look at some of your beliefs - in terms of their sources: A. Environment.	0.483099
Akú vieru (pozitívnu či negatívnu) do vás zasialo prostredie?	What beliefs (resourceful and unresourceful) do you currently hold that were generated by your environment?	0.377778
Doplňte nasledovnú vetu: Moja výchova a prostredie zapríčinili, že si myslím, že (som, nie som, dokážem, nedokážem, budem, nebudem): B. Významné udalosti.	Complete the following sentences: Because of my upbringing and environment, I believe that I (am, am not, can, can't, will, will not): B. Significant events.	0.430435
Najprv si urobte zoznam aspoň piatich významných udalostí, ktoré ste zažili – verejné alebo súkromné.	First, list at least five significant events in your life - public or personal events: Next, complete the following statement.	0.231818
Potom doplňte nasledovné tvrdenie. ~~~ Doplňte túto vetu v súvislosti s každou uvedenou v skutočnosti veríte.	Discover the beliefs you have about the other significant events in your life by answering the same question about each one.	-0.0175532
C. Vedomosti.	C. Knowledge.	1.3
Aké významné knihy ste čítali, a ako vás obohatili?	What are the significant books you have read, or knowledge you have gained from experience?	0.0681818
Aký mala vaša nová znalosť vplyv na to, čomu veríte? (Ohľadne života, ľudí, kto ste, prečo ste tu.)	What do you believe about (life, people, who you are, why you're here) as a result of gaining the knowledge you have?	0.249398
D. Minulé výsledky.	D. Past results.	0.99
Urobte zoznam piatich vašich úspechov a pridajte jednu alebo dve veci, ktoré sa vám dosiahnuť nepodarilo. ~~~ Zistite, čomu ste verili.	List five things you have accomplished in your life and one or two things you haven't accomplished, and discover what your beliefs are.	-0.00131579
Väčšina ľudí, ktorí sa zúčastnili seminára Chôdze po žeravom uhlí, by povedala napríklad: Nemožné sa stalo možným a teraz verím, že je možné úplne všetko.	Most people that have attended the Firewalk seminar, for example, would say, Because I was able to do something that ought to be impossible, I now believe that anything is possible.	0.251908
E. Uveďte päť vecí, ktoré by ste chceli v živote dosiahnuť.	E. List five things you would you like to accomplish in your life.	0.52
Akú by ste mali vieru v samého seba, čo by ste si mysleli o živote, ľuďoch atď., keby ste tieto ciele už boli dosiahli?	What would you believe about yourself, life, people, etc. , if you had ALREADY ACCOMPLISHED these five outcomes?	0.296875
Ak ste tieto cvičenia robili poctivo a od začiatku do konca, viete o sebe podstatne viac, ako o sebe bude kedy vedieť väčšina ľudí, a už by ste mali mať jasnú predstavu o tom, čo vám v živote spôsobuje bolesť a čo potešenie.	If you have done these exercises honestly and thoroughly, you know a great deal more about yourself than most people ever do, and should have a pretty good idea about what causes you to experience pain and pleasure in your life.	0.433021
Ak ste tieto cvičenia preskočili, skúste sa sami seba spýtať, či nie ste hodní zistenia, čomu vlastne veríte.	If you have skipped these exercises, you might ask yourself if you aren't worth discovering what beliefs you currently have.	0.258065
Bolo by zaujímavé porovnať to s vierou, o ktorej budem hovoriť v nasledujúcej kapitole.	They will provide interesting comparisons to the beliefs I will be talking about in the next chapter.	0.456
Abstrakt Úvod a zhrnutie hlavných zistení	Abstract Position Statement	0.173077
Nasledovných sedem bodov sumarizuje množstvo optimálneho príjmu bielkovín pre zdravých a cvičiacich jedincov, ktoré sa uvádza v stanovisku Medzinárodnej spoločnosti pre športovú výživu. ~~~ 	The following seven points related to the intake of protein for healthy, exercising individuals constitute the position stand of the Society. ~~~ They have been approved by the Research Committee of the Society.	-0.16372
1) Viacero výskumov potvrdzuje, že ľudia, ktorí pravidelne vykonávajú fyzickú aktivitu, potrebujú vyššie množstvo bielkovín v strave ako tí, ktorí ju nevykonávajú.	1) Vast research supports the contention that individuals engaged in regular exercise training require more dietary protein than sedentary individuals.	0.420301
2) Príjem bielkovín s hodnotami v rozmedzí 1, 4 - 2,0 g/kg na deň pre fyzicky aktívnych ľudí je nielen bezpečný, ale mnohým umožňuje aj zvýšenie výkonnosti počas tréningu.	2) Protein intakes of 1.4 – 2.0 g/kg/day for physically active individuals is not only safe, but may improve the training adaptations to exercise training.	0.388112
3) Pokiaľ je u zdravých a aktívnych ľudí príjem bielkovín v takomto množstve súčasťou vyváženej a plnohodnotnej stravy, nepoškodzuje funkciu obličiek a ani metabolizmus kostí.	3) When part of a balanced, nutrient-dense diet, protein intakes at this level are not detrimental to kidney function or bone metabolism in healthy, active persons.	0.505055
4) Aj keď by sa fyzicky aktívni jedinci mali snažiť dosiahnuť požadovaný príjem bielkovín prostredníctvom výživy, pre športovcov sú doplnky bielkovín v rôznych formách vhodným a praktickým spôsobom, ako zabezpečiť kvalitný príjem bielkovín.	4) While it is possible for physically active individuals to obtain their daily protein requirements through a varied, regular diet, supplemental protein in various forms are a practical way of ensuring adequate and quality protein intake for athletes.	0.466423
5) Rôzne typy a kvalita bielkovín môže ovplyvniť biologickú dostupnosť aminokyselín, a tým aj príjem bielkovín.	5) Different types and quality of protein can affect amino acid bioavailability following protein supplementation.	0.475129
Preferencia jedného typu bielkoviny nad iným z hľadiska zlepšenia regenerácie a adaptácie na tréning musí byť presvedčivo preukázaná.	The superiority of one protein type over another in terms of optimizing recovery and/or training adaptations remains to be convincingly demonstrated.	0.266667
6) Vhodné načasovanie príjmu bielkovín je dôležitou súčasťou celkového tréningového plánu a je nevyhnutné pre optimálnu regeneráciu, správne fungovanie imunitného systému a rovnako aj pre rast a udržiavanie aktívnej telesnej hmoty.	6) Appropriately timed protein intake is an important component of an overall exercise training program, essential for proper recovery, immune function, and the growth and maintenance of lean body mass.	0.348498
7) Špecifické aminokyseliny, ako sú napríklad aminokyseliny s rozvetveným reťazcom (BCAA), môžu za určitých okolností zlepšiť výkonnosť na tréningu a následnú regeneráciu.	7) Under certain circumstances, specific amino acid supplements, such as branched-chain amino acids (BCAA's), may improve exercise performance and recovery from exercise.	0.428435
Odporúčaný príjem bielkovín	Protein intake recommendations	0.265385
V poslednom čase sa ostro diskutuje o bezpečnosti a efektívnosti navýšenia doteraz odporúčaného príjmu bielkovín.	Controversy has existed over the safety and effectiveness of protein intake above that currently recommended.	0.2875
V súčasnosti je odporúčaná denná dávka (ODD) bielkovín pre dospelých 0,8 g/kg telesnej hmotnosti	Currently, the RDA for protein in healthy adults is 0.8 g/kg body weight per day.	0.429412
Cieľom tohto odporúčania bolo zohľadniť individuálne rozdiely v metabolizme bielkovín, rozličnosť biologickej hodnoty bielkovín a dusíkové straty v moči a nestrávených zvyškoch potravy.	The purpose of this recommendation was to account for individual differences in protein metabolism, variations in the biological value of protein, and nitrogen losses in the urine and feces.	0.29816
Pokiaľ však chceme stanoviť optimálne množstvo bielkovín pre športovcov, musíme vziať do úvahy viacero faktorov.	Many factors need to be considered when determining an optimal amount of dietary protein for exercising individuals.	0.293939
Medzi ne zaraďujeme kvalitu bielkovín, príjem energie, príjem uhľohydrátov, spôsob a intenzitu cvičenia a tiež aj samotné načasovanie príjmu bielkovín.	These factors include protein quality, energy intake, carbohydrate intake, mode and intensity of exercise, and the timing of the protein intake.	0.2808
Súčasná odporúčaná denná dávka bielkovín (0,8 g/kg telesnej hmotnosti) spĺňa potreby takmer všetkých (97,5 %) mužov a žien starších ako 19 rokov.	The current recommended level of protein intake (0.8 g/kg/day) is estimated to be sufficient to meet the need of nearly all (97.5%) healthy men and women age 19 years and older.	1.67958
Toto množstvo bielkovín je primerané pre ľudí, ktorí nevykonávajú fyzickú aktivitu, avšak sotva dostačujúce na vyrovnanie oxidácie bielkovín a aminokyselín (čo predstavuje približne 1- 5 % celkovej spotreby energie pri cvičení) a nepostačujúce na rast nových svalových vláken a zregenerovanie svalov.	This amount of protein intake may be appropriate for non-exercising individuals, but it is likely not sufficient to offset the oxidation of protein/amino acids during exercise (approximately 1–5% of the total energy cost of exercise) nor is it sufficient to provide substrate for lean tissue accretion or for the repair of exercise induced muscle damage.	0.254023
Odporúčania týkajúce sa vyváženého príjmu bielkovín sú založené na hodnote dusíkovej bilancie a štúdiách aminokyselín.	Protein recommendations are based upon nitrogen balance assessment and amino acid tracer studies.	0.233721
Princíp dusíkovej bilancie spočíva v určení rozdielu medzi celkovým množstvom bielkovín, ktoré organizmus príjme a celkovým množstvom dusíka, ktorý organizmus vylúči.	The nitrogen balance technique involves quantifying the total amount of dietary protein that enters the body and the total amount of the nitrogen that is excreted.	0.282734
Štúdie zaoberajúce sa dusíkovou bilanciou podceňujú množstvo bielkovín nevyhnutné pre optimálne fungovanie, pretože sa priamo netýkajú cvičenia.	Nitrogen balance studies may underestimate the amount of protein required for optimal function because these studies do not directly relate to exercise performance.	0.267442
Rovnako je možné, že vyšší príjem bielkovín, ako je udávaný týmito štúdiami, dokáže zlepšiť výkon pri cvičení zvýšením spotreby energie alebo tým, že u športovca bude narastať čistá svalová hmota.	Also, it is possible that protein intake above those levels deemed necessary by nitrogen balance studies may improve exercise performance by enhancing energy utilization or stimulating increases in fat-free mass in exercising individuals.	0.230357
V skutočnosti však množstvo výskumov ukazuje, že ľudia, ktorí sa venujú cvičeniu alebo inej fyzickej aktivite, potrebujú vyšší príjem bielkovín ako 0,8 g/kg telesnej hmotnosti na deň odhliadnuc od spôsobu tréningu (t. j. vytrvalostný, silový tréning atď. ) alebo úrovne pokročilosti (t. j. rekreačný, mierne pokročilý alebo dobre trénovaný cvičenec).	Indeed, an abundance of research indicates that those individuals who engage in physical activity/exercise require higher levels of protein intake than 0.8 g/kg body weight per day, regardless of the mode of exercise (i. e. endurance, resistance, etc. ) or training state (i. e. recreational, moderately or well- trained).	0.390545
Konzumácia nedostatočného množstva bielkovín predstavuje skutočné riziko, obzvlášť v súvislosti s cvičením. V takomto prípade pravdepodobne dôjde k negatívnej dusíkovej bilancii, ktorá vedie k zvýšeniu katabolizmu a narušeniu regenerácie svalov po tréningu.	Also, there is a genuine risk in consuming insufficient amounts of protein, especially in the context of exercise; a negative nitrogen balance will likely be created, leading to increased catabolism and impaired recovery from exercise.	0.35378
Pri vytrvalostnom tréningu sa odporúčaný príjem bielkovín pohybuje od 1,0 do 1,6 g/kg telesnej hmotnosti na deň v závislosti od intenzity a dĺžky vytrvalostného cvičenia, rovnako ako aj od úrovne pokročilosti športovca.	Relative to endurance exercise, recommended protein intakes range from of 1.0 g/kg to 1.6 g/kg per day depending on the intensity and duration of the endurance exercise, as well as the training status of the individual.	0.384423
Napríklad špičkový vytrvalostný športovec potrebuje vyšší príjem bielkovín približujúci sa k hornej hranici už uvedených hodnôt (od 1,0 do 1,6 g/kg telesnej hmotnosti na deň).	For example, an elite endurance athlete requires a greater level of protein intake approaching the higher end the aforementioned range (1.0 to 1.6 g/kg/day).	0.262222
Navyše, ak pri vytrvalostnom tréningu zvyšujeme intenzitu a dĺžku, zvyšuje sa aj oxidácia aminokyselín s rozvetveným reťazcom a tým aj nároky na zvýšený príjem bielkovín nad rámec spomínaných hodnôt.	Additionally, as endurance exercise increases in intensity and duration, there is an increased oxidation of branched- chain amino acids, which creates a demand within the body for protein intakes at the upper end of this range.	0.363372
Pri silovom tréningu sú nároky na bielkoviny ešte vyššie, obzvlášť pri počiatočných fázach tréningu alebo pri prudkom zvýšení objemu tréningu. ~~~ Odporúčaný príjem bielkovín pri silovom tréningu sa pohybuje od 1,6 do 2,0 g/kg telesnej hmotnosti na deň.	Strength/power exercise is thought to increase protein requirements even more than endurance exercise, particularly during the initial stages of training and/or sharp increases in volume.	-0.047561
Napriek tomu niektoré výskumy ukazujú, že nároky na bielkoviny sa môžu pri tréningu dokonca znížiť vďaka biologickej adaptácii, ktorá zlepší hodnoty NPR (net protein retention).	Recommendations for strength/power exercise typically range from 1.6 to 2.0 g/kg/day, although some research suggests that protein requirements may actually decrease during training due to biological adaptations that improve net protein retention.	0.292657
Uskutočnilo sa niekoľko výskumov súvisiacich s kontaktnými športmi (napr. futbal, basketbal, zmiešané bojové umenia, atď.).	Little research has been conducted on exercise activities that are intermittent in nature (e. g., soccer, basketball, mixed martial arts, etc.).	0.259091
Vo vyhodnotení zameranom na futbal sa uvádzalo, že odporúčaný príjem bielkovín pre futbalistov je 1,4 až 1,7 g/kg telesnej hmotnosti na deň.	In a review focusing on soccer players, a protein intake of 1.4–1.7 g/kg was recommended.	0.313816
Tieto hodnoty sa odporúčajú aj pre ľudí, ktorí sa venujú iným druhom kontaktných športov.	Protein intakes within this range (1.4 to 1.7 g/kg/day) are recommended for those engaging in other types of intermittent sports.	0.167532
Stručne povedané, Medzinárodná spoločnosť pre športovú výživu odporúča ľudom, ktorí športujú alebo vykonávajú fyzickú aktivitu, prijímať bielkoviny v rozmedzí 1,4 až 2,0 g/kg telesnej hmotnosti na deň.	In summary, it is the position of the International Society of Sport Nutrition that exercising individuals ingest protein ranging from 1.4 to 2.0 g/kg/day.	0.203008
Jednotlivci, ktorí sa venujú vytrvalostnému cvičeniu, by mali dodržiavať najnižšie hodnoty z tohto rozmedzia, športovci vykonávajúci kontaktné športy by sa mali zamerať na stredný príjem bielkovín z daného rozmedzia a športovci, ktorí trénujú silovo, by mali pri príjme bielkovín dodržiavať najvyššie hodnoty z tohto rozmedzia.	Individuals engaging in endurance exercise should ingest levels at the lower end of this range, individuals engaging in intermittent activities should ingest levels in the middle of this range, and those engaging in strength/power exercise should ingest levels at the upper end of this range.	0.257831
Bezpečnosť príjmu bielkovín nad ODD	Safety of protein intakes higher than RDA	0.2625
Masmédiá často mylne tvrdia, že dlhodobo vysoký príjem bielkovín je nezdravý a môže viesť ku zbytočnej metabolickej záťaži obličiek, a tým aj k poškodeniu funkcie obličiek.	It is often erroneously reported by popular media that a chronically high protein intake is unhealthy and may result in unnecessary metabolic strain on the kidneys leading to impaired renal function.	0.366517
Ďalšou obavou, ktorá sa uvádza pri vysoko bielkovinovej strave, je aj zvýšené vylučovanie vápnika, v dôsledku čoho sa zvyšuje riziko vzniku osteoporózy.	Another concern that is often cited is that high protein diets increase the excretion of calcium thereby increasing the risk for osteoporosis.	0.27541
Nakoľko sú oba tieto mýty nepodložené, neexistuje jasný dôkaz o tom, že vyššie uvádzaný príjem bielkovín má skutočne nepriaznivé účinky na zdravých športovcov.	Both of these concerns are unfounded as there is no substantive evidence that protein intakes in the ranges suggested above will have adverse effects in healthy, exercising individuals.	0.254348
Jedným z hlavných bodov spornej diskusie týkajúcej sa príjmu bielkovín a funkcie obličiek je presvedčenie, že bežná spotreba bielkovín prevyšuje ODD, a tým podnecuje vznik chronického ochorenia obličiek spôsobeného zvýšeným glomerulárnym tlakom a hyperfiltráciou.	One of the main points of debate relative to protein intake and kidney function is the belief that habitual protein consumption in excess of the RDA promotes chronic renal disease through increased glomerular pressure and hyperfiltration.	0.260294
Väčšina vedeckých dôkazov bola pozorovaná na zvieratách a pacientoch s už existujúcou poruchou obličiek.	The majority of scientific evidence cited by the authors was generated from animal models and patients with co-existing renal disease.	0.221739
Práve preto je to u zdravých ľudí s normálnou funkciou obličiek nepravdepodobné.	As such, the extension of this relationship to healthy individuals with normal renal function is inappropriate.	0.415055
Na základe dobre vypracovanej kohortovej štúdie sme predpokladali, že vysoký príjem bielkovín nesúvisel s poklesom renálnej funkcie u žien s normálne fungujúcimi obličkami.	In a well designed prospective cohort study, it was surmised that high protein intake was not associated with renal functional decline in women with normally operating kidneys.	0.3
Taktiež sa zistilo, že neexistujú štatisticky významné rozdiely vo veku, pohlaví, hmotnosti a funkcii obličiek medzi ľuďmi, ktorí konzumujú mäso a vegetariánmi (resp. skupinou s preukázateľne nižším príjmom bielkovín).	Also, it has been reported that there are no statistically significant differences in age, sex, weight, and kidney function between non-vegetarians and vegetarians (a group demonstrated to have lower dietary protein intakes).	0.293717
Obe skupiny mali podobnú funkciu obličiek a u oboch skupín sa ukázala rovnaká miera postupného zhoršovania obličkovej fyziológie súvisiaca s pribúdajúcim vekom.	Both the non-vegetarian and vegetarian groups possessed similar kidney function, and displayed the same rate of progressive deterioration in renal physiology with age.	0.287143
Prvotné klinické a epidemiologické štúdie potvrdzujú, že vysoko bielkovinová strava vplýva na chronické ochorenie obličiek, vysoký tlak krvi, cukrovku, obezitu a metabolický syndróm.	Preliminary clinical and epidemiological studies have suggested a benefit of relatively high protein diets on major risk factors for chronic kidney disease, such as hypertension, diabetes, obesity and metabolic syndrome.	0.367236
Na to, aby sa dostatočne preskúmal úbytok hmotnosti pri vysoko bielkovinovej diéte, kvalita bielkovín, miera rozšírenia a vývoja ochorenia obličiek u rizikových pacientov z populácie sú potrebné ďalšie štúdie.	Future studies are necessary to further examine the role of relatively high protein weight loss diets, dietary protein source (quality) and quantity on the prevalence and development of kidney disease in at risk patient populations].	0.27033
Hoci sa zdá, že príjem bielkovín vyšší ako ODD nie je škodlivý pre zdravých športovcov, ľudia s miernou poruchou obličiek by mali dôkladne kontrolovať svoj príjem bielkovín, pretože výsledky pozorovania epidemiologických štúdií dokazujú, že môže úzko súvisieť s vývojom ochorenia obličiek.	While it appears that dietary protein intakes above the RDA are not deleterious for healthy, exercising individuals, those individuals with mild renal insufficiency need to closely monitor their protein intake as observational data from epidemiological studies provide evidence that dietary protein intake may be related to the progression of renal disease.	0.2304
Okrem funkcie obličiek sa ostro diskutuje aj o vzťahu medzi príjmom bielkovín a metabolizmom kostí.	In addition to renal function, the relationship between dietary protein intake and bone metabolism has also served as the cause for some controversy.	0.153488
Presnejšie povedané, existujú isté obavy, že vysoký príjem bielkovín vedie k vylučovaniu vápnika z kostí, čo môže mať za následok vznik osteopénie, čo je stav, ktorý u niektorých ľudí môže viesť až ku vzniku osteporózy.	Specifically, there is concern that a high intake of dietary protein results in the leaching of calcium from bones, which may lead to osteopenia and predispose some individuals to osteoporosis.	0.261818
Tento predpoklad vyplýva z dávnejších štúdií, v ktorých sa uvádzalo zvýšenie kyslosti moču kvôli vysokému príjmu bielkovín, v dôsledku čoho sa vápnik vylučoval z kostí, aby sa stlmilo prekyslenie.	This supposition stems from early studies reporting an increase in urine acidity from increased dietary protein that appeared to be linked to drawing calcium from the bones to buffer the acid load.	0.296407
Avšak štúdie zaoberajúce sa týmto javom nemali dostatok vzoriek, vo výskume boli metodologické chyby a tiež boli použité vysoké dávky čistých foriem bielkovín.	However, studies reporting this effect were limited by small sample sizes, methodological errors, and the use of high doses of purified forms of protein.	0.283969
V súčasnosti už však vieme, že obsah fosfátu v bielkovinových jedlách a doplnkoch obohatených o vápnik a fosfor tento jav potláča.	It is now known that the phosphate content of protein foods (and supplements fortified with calcium and phosphorous) negates this effect.	0.281081
V skutočnosti jestvujú údaje, ktoré tvrdia, že muži a ženy v pokročilom veku, čiže časť populácie, najviac náchylná na osteoporózu, by na udržanie kostenej hmoty mala konzumovať viac bielkovín, ako je momentálne odporúčané, t. j. viac ako 0,8 g/kg telesnej hmotnosti na deň.	In fact, some data suggest that elderly men and women (the segment of the population most susceptible to osteoporosis) should consume dietary protein above current recommendations (0.8 g/kg/day) to optimize bone mass.	0.226203
Okrem toho sa objavujú údaje zo štúdií stabilného izotopu vápnika, ktoré predpokladajú, že hlavnou príčinou zvýšenej hladiny vápnika v moči nie je kostná resorpcia, ale že ide o tráviaci problém.	In addition, data from stable calcium isotope studies is emerging, which suggests the main source of the increase in urinary calcium from a high-protein diet is intestinal (dietary) and not from bone resorption.	0.276647
Za predpokladu, že cvičenie dodáva podnet na zvyšovanie bielkovín v kostrových svaloch, odporúča sa prijať množstvo v rozmedzí od 1,4 do 2,0 g/kg telesnej hmotnosti na deň, aby sa tento stimul dokázal transformovať na ďalšie kontraktilné tkanivá, ktoré sú dôležité pre vznik kostnej hmoty u detí počas dospievania.	Also, given that exercise training supplies the stimulus for increasing skeletal muscle protein, levels in the range of 1.4 to 2.0 g/kg/d are recommended to transform this stimulus into additional contractile tissue, which is an important predictor in bone mass accrual during pre-pubertal growth.	0.284706
Avšak treba uskutočniť viac výskumov zameraných na dospelých a starších športovcov, hypertrofiu kostrového svalstva, príjem bielkovín a ich kumulatívne účinky na kostnú hmotu.	More research needs to be conducted in adults and the elderly relative to exercise, skeletal muscle hypertrophy and protein intake and their cumulative effects on bone mass.	0.287838
Celkovo chýbajú vedecké dôkazy, ktoré by potvrdzovali, že zvýšený príjem bielkovín má nepriaznivý vplyv na zdravých športujúcich jedincov.	Overall, there is a lack of scientific evidence linking higher dietary protein intakes to adverse outcomes in healthy, exercising individuals.	0.295082
Existuje však vedecká literatúra, ktorá potvrdzuje prínos bielkovín pre zdravie a správne fungovanie viacerých orgánových sústav.	There is, however, a body of scientific literature which has documented a benefit of protein supplementation to the health of multiple organ systems.	0.442558
Takže preto stanovisko Medzinárodnej spoločnosti pre športovú výživu znie, že aktívni ľudia v pokročilom veku potrebujú príjem bielkovín v rozmedzí 1,4 až 2,0 g/kg telesnej hmotnosti na deň a rovnako že príjem bielkovín práve v tomto rozmedzí je bezpečný.	It is therefore the position of the International Society of Sport Nutrition that active elderly individuals require protein intakes ranging from 1.4 to 2.0 g/kg/day, and that this level of intake is safe.	0.224138
Kvalita bielkovín a bežné bielkovinové doplnky	Protein quality and common types of protein supplements	0.25
Ľudia, ktorí cvičia, často využívajú bielkovinové prášky (tzv. proteíny) ako doplnkový zdroj bielkovín.	To obtain supplemental dietary protein, exercising individuals often ingest protein powders.	0.26747
Bielkovinový prášok je praktický a cenovo výhodný, samozrejme v závislosti od konkrétneho výrobku.	Powdered protein is convenient and, depending on the product, can be cost-efficient as well.	0.27375
Bežné zdroje bielkovín sú mlieko, srvátka, kazeín, vajcia a sójové produkty.	Common sources of protein include milk, whey, casein, egg, and soy-based powders.	0.28209
Rôzne zdroje bielkovín a spôsoby spracovania môžu ovplyvniť biologickú dostupnosť aminokyselín do organizmu.	Different protein sources and purification methods may affect the bioavailability of amino acids.	0.261628
Biologickú dostupnosť aminokyselín z daného zdroja bielkovín možno najlepšie vyhodnotiť ako množstvo a rozmanitosť aminokyselín, ktoré sa po prijatí strávia a vstrebú do krvného obehu.	The amino acid bioavailability of a protein source is best conceptualized as the amount and variety of amino acids that are digested and absorbed into the bloodstream after a protein is ingested.	0.523316
Okrem toho biologická dostupnosť aminokyselín sa môže premietnuť aj v rozdieli množstva obsahu stráveného dusíka z prijatých bielkovín a obsahom dusíka, ktorý je následne prítomný v nestrávených zvyškoch potravy.	Furthermore, amino acid bioavailability may also be reflected by the difference between the nitrogen content from a protein source that is ingested versus the nitrogen content that is subsequently present in the feces.	0.396757
Pri zostavovaní plánu na príjem bielkovín pred a po tréningu je najdôležitejšie vziať do úvahy biologickú dostupnosť aminokyselín v krvi a rovnako aj ich transport do cieľového tkaniva alebo tkanív.	Consideration of the bioavailability of amino acids into the blood, as well as their delivery to the target tissue(s), is of greatest importance when planning a regimen of pre- and post-exercise protein ingestion.	0.375598
Bielkoviny, ktoré poskytujú primeraný periodický prísun aminokyselín, sú ľahko naviazané kostrovým svalstvom pre maximálne využitie dusíkovej bilancie a kinetiky svalových bielkovín.	A protein that provides an adequate circulating pool of amino acids before and after exercise is readily taken up by skeletal muscle to optimize nitrogen balance and muscle protein kinetics.	0.298148
Kvalita zdroju bielkovín sa zvykne určovať metódami; tou staršou je pomer účinnosti bielkovín (protein efficiency ratio PER) a omnoho presnejšou je metóda PDCAAS, teda stráviteľnosť bielkovín vzhľadom na koeficient aminokyseliny.	The quality of a protein source has previously been determined by the somewhat outdated protein efficiency ratio (PER), and the more precise protein digestibility corrected amino acid score (PDCAAS).	0.549419
Prvý spôsob bol používaný na zisťovanie kvality zdroja bielkovín a spočíval v určení podielu množstva nárastu telesnej hmotnosti dospelých potkanov kŕmených testovanou bielkovinou.	The former method was used to evaluate the quality of a protein source by quantifying the amount of body mass maturing rats accrue when fed a test protein.	0.355233
Druhý spôsob vytvorila v roku 1991 Organizácia pre výživu a poľnohospodárstvo (FAO) ako vhodnejšiu alternatívu bodovacej metódy, ktorá berie do úvahy zloženie aminokyselín testovanej bielkoviny vzhľadom na referenčný vzorec aminokyselín, ktorý bol však neskôr upravený kvôli rozdielom v stráviteľnosti bielkovín.	The latter method was established by the Food and Agriculture Organization (FAO 1991) as a more appropriate scoring method which utilized the amino acid composition of a test protein relative to a reference amino acid pattern, which was then corrected for differences in protein digestibility.	0.344371
Referenčná príručka srvátkových a mliečnych výrobkov z roku 2003, ktorú vytvorila v Americká členská organizácia pre vývoz mliečnych výrobkov (The U. S. Dairy Export Council) tvrdí, že srvátkový izolát získaný z mlieka má zo všetkých bežných zdrojov bielkovín najvyššiu PDCAAS hodnotu vďaka vysokému obsahu esenciálnych aminokyselín a aminokyselín s rozvetveným reťazcom.	The U. S. Dairy Export Council's Reference Manual for U. S. Whey and Lactose Products (2003) indicates that milk-derived whey protein isolate presents the highest PDCAAS out of all of the common protein sources due to its high content of essential and branched chain amino acids.	0.508085
Kazeín získaný z mlieka, sušené vaječné bielka a proteínový izolát zo sóje sa tiež považujú za vysokokvalitné zdroje bielkovín a všetky dosahujú hodnotu 1 na PDCAAS stupnici.	Milk-derived casein, egg white powder, and soy protein isolate are also classified as high quality protein sources with all of them scoring a value of unity (1.00) on the PDCAAS scale.	0.502205
Na porovnanie, šošovica dosahuje hodnotu 0,52; zatiaľ čo pšeničný lepok iba 0,25.	In contrast, lentils score a value of 0.52 while wheat gluten scores a meager 0.25.	0.295714
Komerčne najobľúbenejšími typmi bielkovín v doplnkoch sú srvátka a kazeín.	Commercially, the two most popular types of proteins in supplemental form are whey and casein.	0.231818
Nedávne výskumy sa podrobne zamerali na reakcie aminokyselín v sérach pri rôznych typoch prijímaných bielkovín.	Recent investigations have detailed the serum amino acid responses to ingesting different protein types.	0.280435
Použitím metódy na sledovanie aminokyselín sa ukázalo, že srvátkové bielkoviny po skonzumovaní vyvolávajú prudký a rýchly nárast aminokyselín v krvi, zatiaľ čo konzumácia kazeínu vyvoláva mierny a dlhšie trvajúci nárast aminokyselín v krvi viac ako 7 hodín po konzumácii jedla.	Using amino acid tracer methodology, it was demonstrated that whey protein elicits a sharp, rapid increase of plasma amino acids following ingestion, while the consumption of casein induces a moderate, prolonged increase in plasma amino acids that was sustained over a 7-hr postprandial time period.	0.425003
Rozdiel medzi stráviteľnosťou a absorpciou týchto dvoch typov bielkovín naznačuje, že pomalé bielkoviny (kazeín) a rýchle bielkoviny (srvátka) metabolizmus spracuje rôznym spôsobom práve kvôli ich odlišným vlastnostiam.	The differences in the digestibility and absorption of these protein types may indicate that the ingestion of slow (casein) and fast (whey) proteins differentially mediate whole body protein metabolism due to their digestive properties.	0.284536
Iné štúdie preukázali podobné rozdiely v najvyššej plazmatickej hladine aminokyselín po prijatí malého množstva srvátkových a kazeínových bielkovín (t. j. stopy srvátky dosahujú maximum rýchlejšie ako stopy kazeínu).	Other studies have shown similar differences in the peak plasma levels of amino acids following ingestion of whey and casein fractions (i. e., whey fractions peaking earlier than casein fractions).	0.262722
Aplikovaný výskum v oblasti cvičenia preukázal rozdielne účinky v súvislosti s konzumáciou rôznych bielkovín a jej vplyve na reakcie aminokyselín v krvi a syntézu svalových bielkovín po cvičení.	Applied exercise science research has also demonstrated the differential effects that ingesting different proteins exerts on postprandial blood amino acid responses and muscle protein synthesis after exercise.	0.271429
