Je teda zjavné, že spolupráca vyšších a nižších častí je nevyhnutná na dosiahnutie silného emočného zážitku, zjednotenia a uspokojivého umeleckého prejavu prostredníctvom tanca.	Thus it is evident that the co-operation of these higher and lower parts is essential for rich emotional experience, integration, and satisfying artistic expression through dance.	0.298065
Hoci nás zložitosť nervovej sústavy ohromuje, princíp jej fungovania je jednoduchý.	Although we are impressed with the complexity of the nervous system, its functioning principle is simple.	0.231081
Skutočná povaha nervového impulzu, vďaka ktorému sa človek na základe skúseností vyvíja k ideálu, však pre nás zostáva záhadou.	But the true nature of the nerve impulse whereby out of experience man progresses to an ideal remains a mystery.	0.248936
Proces učenia pochopíme až vtedy, keď nám vedci povedia, čo nervový impulz vlastne je.	When science can tell us what the nerve impulse is, then we can understand how learning takes place.	0.259459
Dovtedy môžeme využiť len zatiaľ známe fakty a čo možno najpevnejšie a najrozumnejšie vystavať filozofiu, teóriu a vedu nášho odboru.	Until then we can only avail ourselves of the facts known to date and build as firmly and wisely as possible a philosophy, a theory, and a science of our subject.	0.681615
Vďaka takýmto vedomostiam môžeme veriť, že učenie schopnosti správať sa ako individualita, schopnosť učiť sa prostredníctvom vedomých skúseností, hodnota takéhoto prístupu a nevyhnutnosť umelecky tvoriť na základe vedome vyhodnotených skúseností, má význam.	Such knowledge gives us security in believing in the educational significance of the capacity for individuality, in the ability and value of learning through conscious experience, and in the artistic necessity to create from consciously evaluated experience.	0.294619
Pokiaľ ide o vzdelávací význam, schopnosti správať sa ako vyvíjajúca sa individualita a schopnosti ťažiť zo skúseností neurológ C. J. Herrick hovorí: "Už vieme, že deti neprichádzajú na svet s hotovými duševnými danosťami. ~~~ Vedomosti, myšlienky či morálne zásady v každej generácii musia za pomoci vzdelávania nadobudnúť samy. ~~~ Vzdelávaniu nádejnej mládeže venujeme tretinu očakávanej dĺžky jej života, aby sme zabezpečili maximálny možný rozvoj asociačných mechanizmov mozgovej kôry a ich latentných kultúrnych schopností."	As to the educational significance of the capacity for individuality in development and the ability to profit by experience, C. Judson Herrick says: "So well have we learned the lesson that children bring with them into the world no mental endowments ready-made – no knowledge, no ideas, nor morals – but that these have to be developed anew in each generation under the guiding hand of education, that we devote one-third of expected span of life of our most promising youth to the educational training necessary to ensure the highest possible development of the latent cultural capacities of these associational mechanisms of the cerebral cortex.”	-0.193617
"Často sme však nevideli druhú stranu mince.	"But we have often been blind to the other side of the picture.	0.2
Ako sme uviedli vyššie, mozgová kôra dospelého človeka môže fungovať iba prostredníctvom reflexnej mašinérie mozgového kmeňa. ~~~ Pri pedagogickej činnosti nemožno zabúdať na to, že tento vzťah má oveľa väčší význam v prvých rokoch života dieťaťa.	We have seen above that the adult cortex cannot function save through the reflex machinery of the brain stem, and it must not be forgotten in our pedagogy that this relation holds in much more vital and significant sense in the formative years of the child.	-0.000707547
Hoci je pravda, že deti sa nerodia s mentálnymi schopnosťami, v iných ohľadoch je ich dedičstvo naozaj bohaté.	It is true that the child is born with no mental endowments; but how rich is his inheritance in other respects!	0.293478
Získavajú obrovský kapitál vopred sformovaných, vrodených schopností vo forme fyziologickej vitality ako aj kapitál inštinktívneho a impulzívneho konania, ktoré väčšinou prebieha automaticky a nevedome.	He has an immense capital of preformed and innate ability which takes the form of physiological vigor and instinctive and impulsive actions, performed for the most part automatically and unconsciously.	0.287861
Táto tzv. nižšia či živočíšna prirodzenosť v nás stále pretrváva.	This so-called lower or animal nature is ever present with us.	0.277358
V ranom detstve je dominantná. ~~~ Detstvo predstavuje obdobie búrok a stresu, hľadania rovnováhy medzi stereotypnými no mocnými impulzívnymi silami a kontrolnými mechanizmami rodiacej sa intelektuálnej a morálnej podstaty. ~~~ V dospelosti sa hodnota človeka v spoločenskom živote meria výsledkom jeho obrovského zápasu v detstve a v dospievaní.	In infancy it is dominant; childhood is a period of storm and stress, seeking equilibrium between the stereotyped but powerful impulsive forces and the controls of the nascent intellectual and moral nature; and in mature years one"s value in his social community life is measured by the resultant outcome of his great struggle in childhood and adolescent.	-0.0694444
Týmto zápasom je vzdelávanie."	This struggle is education."	0.276923
Druh integrovaného zážitku, ktorý je spomenutý v predchádzajúcom odseku, je pre umenie nevyhnutný. ~~~ Aby sa pri vyučovaní tanca vytvorila príležitosť pre tento druh zážitku, študent musí zažiť pohyb v rozličných formách charakteristických pre ľudské reakcie.	If dance education is to afford an opportunity for the type of integrated experience mentioned in the preceding paragraph, which is essential to art, the student must experience movement in various forms characteristic of human responses.	-0.0154412
Pedagógovia by ho mali vedome viesť smerom od nemenného typu činností, ku ktorým ho predurčuje jeho štruktúrna a reflexná organizácia, k reakciám, ktoré možno individuálne upravovať.	He should be led consciously from the invariable type of actions that are predetermined by his structural and reflex organization to those responses that are individually modifiable.	0.4092
Tieto premenlivé a osobné reakcie sú pod vedomou selektívnou kontrolou mysliaceho, vediaceho ja.	These variable and personal responses are under the conscious selective control of the thinking, knowing self.	0.261176
Postupne nadobudne schopnosť zažívať a hodnotiť sprievodné pocity určitej kvality, ktorých zdrojom je jeho emočná podstata.	As he progresses, he will be able to experience and evaluate the accompanying feeling tones which are the contribution of the emotional nature.	0.26422
Keďže existuje veľké množstvo spôsobov prežívania, počet prejavov a jeho foriem je prakticky nekonečný. ~~~ Keď vezmeme do úvahy pestrosť a rozsah pohybov, ktorých je telo schopné, uvedomíme si, aká zložitá môže byť technická príprava na tanec.	Expression and its forms are necessarily infinite, because of the many ways of experiencing, and, considering the great variety and range of movement of which the body is capable, we realize how complex the technical preparation for dance may be.	0
No v tejto mätúcej kope materiálov predsa len možno nájsť určité fakty a princípy, na ktorých môžu byť založené umelecké výsledky.	Yet in this confused mass of material there are certain facts and principles upon which art results may be founded.	0.256701
Riešením je tieto princípy nájsť, podriadiť sa im, pripustiť si ich normálnosť a v súlade s nimi zdokonaliť pohyb predtým, ako ho odovzdáme do rúk prejavujúcej sa mysle.	The solution is to find these principles, to obey them, to admit their normality, and to perfect movement in accordance with them before submitting movement to the fashioning of the expressive mind.	0.247552
Hoci je pohybové preciťovanie dôležité pre všetky životné aktivity, väčšina ľudí ho nie je schopná rozpoznať.	Although movement sensations are important to all life activities, with most people they escape recognition.	0.3
Dôvodom je, že svalové pociťovanie je príliš neurčité, a preto dostatočne neupúta našu pozornosť.		-0.3
Aj keď oň prídeme, prejaví sa to najmä stratou kontroly, nie prerušením určitých svalových pocitov.	This is because muscular sensations are too indefinite to force themselves sufficiently upon the attention.	0.459593
Zvyčajne sa na pohyb pozeráme iba povrchne a všímame si len výsledok.	Even when we are deprived of them, the defect is realized mainly in the loss of control rather than in a cessation of particular muscular sensations.	0.195176
Neuvedomujeme si, že v skutočnosti sú za pohybom svaly.	Ordinarily we look at the movement superficially, noting only the results.	0.19375
Pozornosť preto venujeme len vonkajším zmenám, ktoré svaly zapríčinili svojou činnosťou.	We usually are not aware that actual muscles are involved – but rather pay attention to the external changes brought about by their action.	0.155696
V súlade s výsledkami sa činnosti označujú za cieľavedomé, impulzívne, inteligentné, výrazné alebo umelecké.	In accordance with the results, actions are termed purposeful, impulsive, intelligent, expressive, artistic, and so on.	0.271875
Takéto výrazy však nepoukazujú na vnútorné vlastnosti samotného pohybu.	But such terms do not suggest the intrinsic attributes of motion itself.	0.290323
Študent tanca musí ísť hlbšie.	The student of dance must go deeper.	0.255556
Musí sa naučiť uvedomovať si svalové napätie a objaviť v pohybe prejav fyzikálnych zákonov, ktoré musí vedome použiť, aby v súlade s nimi vytvoril štýl.	He must learn to be aware of muscular tensions, to discover in movement the manifestation of physical laws, and consciously to employ those laws if he is to develop a style in accordance with them.	0.333989
Štúdium pohybu musí preniknúť do anatomických faktorov štruktúry kĺbu, ktoré stanovujú rozsah a druhy pohybu, ako napr. ohýbanie, naťahovanie a vykrúcanie, rôzne druhy lokomócie, t. j. presun z miesta na miesto a nosnosť kĺbu.	A study of movement must penetrate into the anatomical factors of joint structure, which determine the range and kinds of movement (such as bending, stretching, and twisting), the various types of locomotion, and the load-bearing capacities.	0.279897
Práve táto anatomická štruktúra určuje mechanické limity pre motorické reakcie.	It is this anatomical structure that sets the mechanical limits for motor response.	0.295775
Ak sa však štruktúra uvedie do činnosti, závisí od fyziologických aspektov.	But this structure, when it is set in action, is dependent upon physiological aspects.	0.263636
Napokon pohyby, ktoré nasledujú po akomkoľvek podnete, sú prejavom fyziologických princípov.	In the last analysis, movements that follow any stimulating cause are the manifestations of physiological principles.	0.227711
Tieto princípy sa zasa uplatňujú pri nervovej činnosti.	These principles in turn are attendant upon neural events.	0.287755
Fyziologické aspekty sa vzťahujú na stav a charakter svalového tkaniva, ktoré závisí od nervového tkaniva – dostáva od neho podnety potrebné na uvoľnenie latentnej motorickej energie.	These physiological aspects pertain to the condition and nature of muscle tissue, which depends upon the nervous tissue for the impulse to set off its latent motor energy.	0.271034
Od týchto faktorov závisí mechanika ľudského tela, ktorá musí v súlade s nimi fungovať.	They are the factors upon which the human mechanism is dependent and in accordance with which it must function.	0.224
Toto nervovo-svalové nastavenie predstavuje akési zariadenie na správanie, pre ktoré sú príznačné reflexné dráhy a možnosti rozličných činností.	This neuromuscular setup is a behaviour equipment possessing reflex paths and infinite possibilities of activity, which, when modified, emerge as definite skills.	0.425082
Ak sa upravujú, vyvinú sa z nich konkrétne zručnosti.	It is educated by doing.	-0.0571429
Toto zariadenie sa učí na princípe vykonávania rozličných aktivít.		-0.3
My sme však stvorení aj na uvažovanie, cítenie a prejavovanie vôle.	But we are also designed to think and feel and will.	0.195349
Hru zvanú život nemožno vysvetliť iba mechanickými faktormi, a preto sa nemôžeme podrobiť výlučne mechanickým zákonom.	The mere mechanical factors cannot explain the play of life. Therefore, we cannot submit to mechanical laws alone.	0.281633
Musíme vziať do úvahy aj psychologické faktory.	Psychological factors also must be considered.	0.3
Tie pôsobia nielen prostredníctvom vôle a asociácií, ale aj vďaka tomu, že si uvedomujeme kinestetické pocity a rozličné duševné stavy.	These act not only through the will and association, but through the awareness of kin aesthetic sensations and various mental states.	0.292105
Ak chceme vykonať akýkoľvek pohyb, musíme vynaložiť úsilie. ~~~ Toto úsilie pozostáva z vydania energie.	To execute any movement, we must make an effort; this effort consists of an expenditure of energy.	-0.0126506
Subjektívne sa prejavuje určitými kinestetickými pocitmi a výsledný duševný stav pohody či nepohody zohráva dôležitú úlohu pri určovaní foriem pohybu.	Subjectively it manifests itself by specific kinaesthetic sensations – and the resulting mental state of ease or lack of ease plays an important role in determining the forms of our movements.	0.229545
Môžeme povedať, že najpríjemnejšie pohyby sú tie, z ktorých máme najväčší pôžitok pri čo najúspornejšom vydaní energie. ~~~ Nemusia to byť nutne tie, ktoré si vyžadujú najmenej úsilia.	Generally speaking, the movements that are most pleasurable are those that give us the greatest return for the most economical expenditure of energy, and not necessarily those which demand the least effort.	-0.0181529
Tento poznatok je dôležitý pri osvojovaní nových zručností, ktoré v nás vyvolávajú pocit spokojnosti alebo nespokojnosti.	This is important in the learning of new skills and in the satisfaction or dissatisfaction derived from them.	0.254839
Študenti sa často nechajú odradiť prvými neúspešnými pokusmi, ale ak pochopia tieto formujúce faktory, neúspech pre nich nebude prekážkou a budú s nadšením pracovať na zdokonalení.	Students are likely to become discouraged during the first unfruitful efforts, but, with an understanding of these conditioning factors, they will work with less discouragement and push on with enthusiasm to perfected forms.	0.228846
Mentálne vybavenie určuje fyzické správanie, pretože v ňom sídli povedomie o všetkých pocitoch a taktiež i schopnosť myslieť, cítiť, predstavovať si a prejavovať vôľu.	The mental equipment determines, then, the physic behaviour, for in it resides the awareness of all sensations as well as the capacity to think, feel, imagine, and will.	0.295804
Je to vybavenie na interpretáciu zážitkov a predstavuje ľudské osobnostné predpoklady.	It is the equipment for interpreting experience and represents the human personal endowments.	0.280519
Ide o formujúcu látku, z ktorej vzniká osobnosť.	It is the formative substance from which develops personality.	0.207143
Pri hlbšej úvahe o pohybe sa odhalí vzájomný vzťah ďalších faktorov, ktoré prispievajú k vzniku rozličných jeho foriem a ovplyvňujú ich.	Further consideration of movement reveals an interrelation of various other factors that contribute to and condition its forms.	0.283784
Vždy, keď sa telo alebo jeho časť hýbu, pozorujeme zmenu polohy. ~~~ Inak povedané, telo môže zmeniť polohu tak, že sa presunie z jedného miesta na druhé. Polohu však môžu zmeniť aj jeho časti, čím vyvolajú zmenu držania tela ako celku.	Whenever movement of the body or its parts takes place, we observe that there is a change of position; that is, the body may change its position by moving from one place to another, or the parts of the body may change their positions with respect to one another and thus produce a postural change of the body as a whole.	-0.0497449
Tieto zmeny navyše môžu prebiehať v pohybe alebo v pokoji.	And, further these changes may take place on a moving or on a stationary base.	0.21
Zo zmeny polohy vyplýva, že človek sa vydal určitým smerom a prekonal istú vzdialenosť.	Change of position implies that direction is taken and distance is covered.	0.253846
Pohyb má istý rozsah.	Movement has range.	0.283333
Pri prekonávaní vzdialenosti plynie čas, preto má význam hovoriť aj o rýchlosti pohybu či vykonania nejakej činnosti.	Also, in covering distance, we consume time, which further implies rate of movement or execution.	0.235714
Napokon, aby sa pohyb vôbec mohol uskutočniť, treba pomocou určitej sily vydať energiu.	And, finally, for movement to be accomplished at all, energy must be expended with some degree of force.	0.252632
Navyše musí existovať nejaký bod, na ktorý táto sila pôsobí.	Also there must be a point of its application.	0.2
Nijaký pohyb, akokoľvek veľký či malý, rýchly či pomalý, silný či slabý, sa nemôže uskutočňovať bez odporu, smeru, vzdialenosti, trvania, rýchlosti a úsilia.	No movement, however large or small, fast or slow, strong or weak, can take place unless resistance, direction, distance, duration, speed, and force are involved.	0.293382
Pri skúmaní pohybu musíme nevyhnutne vziať do úvahy nielen tieto faktory, ale aj vzory a formy pohybu, ktoré tvorivý učiteľ alebo študent vyvinie ako prostriedok na podnecovanie a prežívanie nových motorických reakcií.	A study of motion necessarily involves the consideration of these factors and the movement patterns and forms that the creative teacher or student may evolve as a means of stimulating and experiencing new motor responses.	0.390909
Ako jeden zo spôsobov, ktorým môže telo meniť polohu v priestore, uvedieme lokomóciu.	For example, let us take locomotion as one of the ways in which the body may change its position in space.	0.247297
Pohyb je jednoducho presun telesnej hmotnosti z jednej nohy na druh, alebo na obe nohy, prípadne z oboch nôh, ako sa to deje pri skoku.	Locomotion is simply transferring of the body weight from one foot to the other, or to both feet, or from both as in jumping.	0.393786
Spôsoby, akými štruktúra tela umožňuje tento prenos, sa nazývajú chôdza, beh, poskok, výskok, skok, preskok, cval alebo prešmyk.	The varying way in which the body structure permits this transference are commonly called walk, run, hop, leap, jump, skip, gallop, and slide.	0.275893
Toto všetko sú prirodzené formy lokomócie, ktorých príčinou je štrukturálne fungovanie mechaniky ľudského tela. ~~~ Pri analýze akokoľvek náročných tanečných krokoch vždy zistíme, že sa skladajú z týchto základných krokov.	These are the untaught ways of locomotion due to the structural functioning of our body mechanism, and, no matter how complex a dance step may be, it will be found to be organized of these elemental steps.	-0.0202941
Jens-Peter Rose Hans-Helge Bartsch Klinika nádorovej biológie, Univerzita Alberta Ludviga, Freiburg, Nemecko	Jens-Peter Rose Hans Helge Bartsch Tumor Biology Center, Albert-Ludwigs-University, Freiburg, Germany	1.28043
Poznáte to. Ste doma a pozeráte triler. ~~~ Ke sa napätie už pomaly nedá zniesť, nevedomky siahnete po ovládači a stíšite hlas, či dokonca vypnete zvuk. Odrazu vám tieto nepríjemné obrazy neprekážajú.	It’s a familiar scenario for many: at home watching a thriller on television, as the tension becomes almost unbearable, a hand involuntarily reaches out for the remote control to turn down the volume or even switch off the sound – and suddenly, the nerve-wracking images become tolerable.	-0.00568047
Takéto konanie je dôkazom silných účinkov zvuku, hluku a, samozrejme, hudby na náš mozog.	Such behavior illustrates the powerful effects of sounds, noises and indeed music on our brains.	0.276623
A práve dobre vyvinutá schopnosť spracovať zvuk v mozgu sa využíva pri súčasných metódach muzikoterapie (liečby hudbou).	And it is precisely the keen sound-processing abilities of our minds that are harnessed for modern forms of music medicine or music therapy.	0.26
Základný princíp používania hudby ako liečebného prostriedku je, že jav, ktorý napätie vytvára, dokáže napätie aj znížiť.	A basic concept underlying the use of music as a therapeutic agent is that a phenomenon able to generate tension can also assist in reducing it.	0.260377
Inými slovami, hudba odbúrava stres a upokojuje.	In other words, music can relieve stress and promote relaxation.	0.209302
V aka nej sa tiež mení emocionálny stav a citlivosť na bolesť.	Emotional states and pain sensitivity are also susceptible to modification through music.	0.144231
Aktívnym tvorením alebo počúvaním hudby môžu pacienti za prítomnosti kvalifikovaných hudobných terapeutov dosiahnuť významné terapeutické výsledky.	Facilitated by trained musical therapists, many patients by either actively making music or listening to it can achieve significant therapeutic goals.	0.29542
Vývoj modernej muzikoterapie od roku 1945 Muzikoterapia, ako ju poznáme dnes, sa začala vyvíjať v Spojených štátoch amerických po druhej svetovej vojne.	The Development of Modern Music Therapy since 1945 It was in the United States after the two world wars that music therapy as we know it today began to take shape.	1.73024
Hudobníci navštevovali vojenské nemocnice a hrali pre tisícky udí, ktorí trpeli povojnovými telesnými alebo duševnými traumami.	Musicians visited veterans’ hospitals around the country to play music for the thousands suffering from post-war physical and emotional traumas.	0.265487
Lekári a zdravotné sestry si všimli, ako tieto činnosti priaznivo pôsobia na pacientov a žiadali nemocnice, aby si hudobníkov najali.	Doctors and nurses observed the benefits of these activities and requested the hiring of musicians by the hospitals.	0.255
Tiež uznali, že hudobníci potrebujú školenie, aby sa naučili používať hudbu na liečebné účely, a tak sa na vysokých školách a univerzitách postupne zavádzali študijné odbory a programy pre budúcich muzikoterapeutov.	It was recognized that they required training in how to apply music for therapeutic purposes, and so colleges and universities began to set up specific music therapy curricula and programs.	0.253416
Prvý svetový muzikoterapeutický program bol založený na Michiganskej štátnej univerzite v roku 1944 a v roku 1950 vznikla Národná asociácia muzikoterapie (NAMT), prvé profesijné združenie muzikoterapeutov. alšie zmeny v štruktúre amerického systému zdravotnej starostlivosti si v roku 1998 vyžadovali spojenie NAMT s toho času druhým najväčším združením.	In 1944 the first music therapy program in the world was founded at Michigan State University, and 1950 saw the founding of the first professional association for music therapists, the National Association for Music Therapy (NAMT).	0.372685
Ďalšie zmeny v štruktúre amerického systému zdravotnej starostlivosti si v roku 1998 vyžadovali spojenie NAMT s toho času druhým najväčším združením.	Subsequent changes in the structure of the American health care system necessitated the fusion in 1998 of the NAMT with the second-largest association at that time to create the American Music Therapy Association (AMTA), still today the country’s major professional organization for music therapists.	1.64098
Tak sa vytvorila Americká muzikoterapeutická asociácia (AMTA), ktorá je aj v súčasnosti významnou profesijnou organizáciou muzikoterapeutov v USA.	The first European association, the British Society for Music Therapy (BSMT), was founded in 1958.	0.141176
Britská spoločnosť muzikoterapie (BSMT) vznikla v roku 1958 a je prvou európskou muzikoterapeutickou asociáciou [v roku 2009 ju nahradila Britská asociácia muzikoterapie (BAMT)].		-0.3
Prvý svetový kongres muzikoterapie sa konal v roku 1973 v španielskom meste Vitoria.	The first World Congress for Music Therapy took place in Vitoria, Spain, in 1973.	0.282609
Základ pre svetovú asociáciu muzikoterapeutov bol dokončený v roku 1976 na alšom svetovom kongrese v Buenos Aires (Argentína). ~~~ Svetová federácia muzikoterapie (WFMT) nakoniec uzrela svetlo sveta na piatom kongrese (1985) v talianskom meste Janov.	The ground for a global association of music therapists was prepared in 1976 at the next World Congress in Buenos Aires, Argentina, and the World Federation of Music Therapy (WFMT) finally saw the light of day at the fifth World Congress in 1985 in Genoa, Italy.	0.0868464
Európska muzikoterapeutická konfederácia (EMTC) vznikla v roku 1990.	A European Music Therapy Confederation (EMTC) was formed in 1990.	0.940351
Jedným z hlavných cie ov tejto konfederácie bolo, aby programy na školenie muzikoterapeutov v Európe a najmä v Európskej únií mali rovnaký štandard ako ostatné.	One of the major goals of the EMTC was to bring on a par with one another the various training programs within Europe and especially within the European Union.	0.404021
Používanie muzikoterapie ako oficiálne uznávaného spôsobu liečby a povolenie na jej vykonávanie sa značne líši v národných systémoch zdravotnej starostlivosti.	The application and validation of music therapy as an officially recognized form of medical treatment varies greatly among national health care systems.	0.279545
Vo väčšine krajín sa muzikoterapia stále nepovažuje a neuznáva za samostatnú liečebnú metódu.	In most countries, music therapy is still not regarded or accepted as an independent medical discipline.	0.270732
Namiesto toho sú muzikoterapeutické prístupy poskytované len v rámci zdravotnej starostlivosti a v zariadeniach sociálnych služieb, ktoré poskytujú starostlivosť o udí v rôznom zdravotnom stave a liečia rôzne choroby.	Instead, most music therapy approaches are offered within the context of health care and welfare clinics and institutions that treat and cater for a broad spectrum of conditions and diseases.	0.350307
Nájdu sa aj výnimky.	There are exceptions.	0.266667
Rakúsky parlament v roku 2008 jednomyse ne schválil návrh na zavedenie profesijného oprávnenia vykonávať muzikoterapiu. ~~~ Tým sa položili základy pre legálne uznanie tohto povolania.	In Austria in 2008, the draft of occupational licensing regulations for music therapy was unanimously accepted by parliament, laying the foundations for legal recognition of the profession.	-0.00375
Muzikoterapeutické metódy sa pre neexistenciu takýchto zákonných ustanovení v čase založenia prvých asociácií spočiatku vyvíjali v rozličných a navzájom si konkurujúcich psychoterapeutických školách. ~~~ Tie siahali od kognitívne behaviorálnych prístupov po prístupy založené na hlbinnej alebo tvarovej psychológii.	Given the absence of such statutory provisions when the various associations were first established, the ways in which music was applied for therapy to begin with were shaped by the various and competing schools of psychotherapy, ranging from cognitive behavioral therapy to approaches based on depth or gestalt psychology.	-0.00108696
Muzikoterapia sa postupne stala samostatnou profesiou a s rastúcim povedomím o konkrétnych znakoch a vlastnostiach hudby sa muzikoterapeuti vo svojej teórii a praxi začali dištancovať od už existujúcich psychoterapeutických prístupov.	Gradually, though, music therapy developed an independent identity, and with a growing awareness of the specific features and qualities of music, music therapists began to distance themselves from the domination of existing psychotherapeutic premises in their theory and practice.	0.342891
Ba čo viac, pozornosť sa čoraz viac neupriamovala len na základný výskum, ale na konkrétne spôsoby, akými hudba pôsobí na myse a telo človeka.	In addition, attention was increasingly paid by basic research to the specific modes by which music acts on the mind and the person.	0.275676
Takto po rokoch diferenciácie vzniklo nové profesionálne zjednotenie.	Thus, after years of differentiation, a new professional unity has now been achieved.	0.247619
Môžeme to vidieť napríklad na spojení dvoch amerických asociácií v roku 1988 a zlúčení najväčších nemeckých asociácii do Nemeckej muzikoterapeutickej spoločnosti (2008).	This is reflected and underpinned by, for example, the fusion of the two American associations in 1998, and the merging in 2008 of the largest German music therapy associations into the German Music Therapy Society.	0.233557
Súčasná definícia muzikoterapie	The Current Definition of Music Therapy	0.25
Pod a asociácií WFMT a AMTA, muzikoterapiu možno definovať ako odborné použitie hudby a/alebo jej prvkov (zvuk, rytmus, melódia, harmónia, dynamika, tempo) kvalifikovaným muzikoterapeutom pre klienta alebo skupinu na dosiahnutie terapeutických cie ov	According to the WFMT and the AMTA, music therapy can be defined as the clinical and evidence- based use of music and/or its elements (sound, rhythm, melody, harmony, dynamic, tempo) by a qualified music therapist to accomplish individualized goals within a therapeutic relationship with one client or a group.	0.680902
Jej účelom je rozvíjať potenciál a/alebo obnoviť funkcie jednotlivca tak, aby mal lepšiu intrapersonálnu a/alebo interpersonálnu integráciu, ktorá zlepšuje kvalitu života prostredníctvom prevencie, rehabilitácie a liečby.	The aim of music therapy is to develop potentials and/or restore functions of the individual so that he or she can achieve better intrapersonal and/or interpersonal integration, which may include a better quality of life, through prevention, rehabilitation or treatment.	0.357812
Okrem odborného zamerania sa moderná muzikoterapia chápe aj ako vzťahovo orientovaná terapia.	Besides its scientific orientation, modern music therapy defines itself as a resource- and relational- based approach.	0.224096
Ide teda o uznávanú zdravotnícku profesiu, ktorá pri liečbe používa hudbu s cie om naplniť fyzické, emocionálne, kognitívne a sociálne potreby jednotlivcov.	It is an established health profession in which music is used within a therapeutic relationship to address individuals’ physical, emotional, cognitive and social needs.	0.408376
Kvalifikovaný muzikoterapeut po zhodnotení stavu a potrieb každého klienta stanoví liečbu, ktorá spočíva v spievaní, pohybe, počúvaní a tvorení hudby.	After assessing the strengths and needs of each client, the qualified music therapist provides the indicated treatment including creating, singing, moving to and/or listening to music.	0.236364
V aka zapojeniu hudby do terapie sa pacientove schopnosti zlepšia, čo sa prejaví aj v iných oblastiach života. ~~~ Muzikoterapia taktiež podporuje komunikáciu u udí, ktorí majú problém s vyjadrovaním.	Through musical involvement in the therapeutic context, clients’ abilities are strengthened and transferred to other areas of their lives.	-0.0430851
Treba však poukázať na rozdiel medzi muzikoterapiou a používaním "hudby ako lieku" (v angl. music medicine).	Music therapy also provides avenues for communication that can be helpful to those who find it difficult to express themselves in words.	0.229787
Zatia čo muzikoterapia si vyžaduje prítomnosť kvalifikovaného muzikoterapeuta, pri "hudbe ako lieku" slúži hudba len ako doplnková liečba a sprostredkovatelia nemusia byť vyučení v danom odbore.	A distinction needs to be drawn here between music therapy, which always involves the participation of a qualified music therapist, and the concept of music medicine, in which music is employed as an ancillary therapy by those who are not necessarily specialized in the field.	0.299935
Ako hudba pôsobí?	How Does Music Exert Its Effects?	0.05625
Do deväťdesiatych rokov minulého storočia bolo málo vedeckých dôkazov o hodnote hudby.	Until the 1990s, scientific evidence for the value of music therapy was sparse and unsatisfactory.	0.264474
Väčšina publikácií obsahovala len prípadové štúdie a tie sa v poslednom desaťročí minulého storočia dopĺňali o klinické štúdie a preh ady.	Up to that point, the majority of publications were case studies, and these were only complemented in the last decade of the 20th century by a growing number of clinical studies and reviews.	0.335523
Ich počet sa i na alej zvyšuje a vyh adávanie relevantných nadpisov v databázach ako PubMed alebo PsycINFO odha uje, že za posledné desaťročie sa objavila približne jedna tretina článkov o muzikoterapii.	This growth continues, and a search for relevant titles in databanks such as PubMed or PsycINFO reveals that about one-third of the articles on music therapy have appeared within the last decade.	0.558182
Prvé Cochranove metaanalýzy [1] a systematické preh ady [2] potvrdili, že muzikoterapia funguje a je rovnako účinná ako iné uznávané psychoterapeutické prístupy.	The first Cochrane meta-analyses [1] and systematic reviews [2] have demonstrated that music therapy works and that it is as effective as recognized psychotherapeutic approaches.	0.531082
Argstätter a jeho kolegovia [2] vo svojom preh ade desiatich metaanalýz a štyroch preh adov z rokoch 1986 až 2005 zistili, že muzikoterapia zaúčinkovala hlavne na novorodencov, deti s autizmom, deti a mladistvých so psychopatologickými poruchami.	In their review of ten meta-analyses and four reviews from 1986 to 2005, Argstätter and colleagues [2] found that music therapy was especially effective when applied with neonates, children with autism, and children and youths with psychopathologic problems.	0.529092
Muzikoterapia tiež ukázala dobré, ale nie až také úspešné výsledky pri demencii, psychóze a strese.	Music therapy also demonstrated good but less consistent success with other conditions, including dementia and psychosis, and for stress reduction.	0.15
Nové zobrazovacie metódy, ako napríklad pozitrónová emisná tomografia (PET), ukázali, že niektoré účinky hudby sú špeciálne vyvolané pod a toho, akým spôsobom sa spracovávajú v mozgovej neurónovej sieti.	Recent imaging studies, such as those employing positron emission tomography (PET), have shown that some of music’s effects are specifically elicited by the sites and ways in which it is processed by the brain’s neuronal network.	0.37294
Takéto spracovanie môže ovplyvňovať a meniť napr. naše emocionálne prežívanie [3] a vnímanie bolesti [4].	Such processing can influence and alter, for example, our emotional experiences [3] and the perception of pain [4].	0.652174
Medzi najväčšie prekvapenia pri prvých pozorovaniach udí s mozgovou poruchou alebo zdravých jedincov s amúziou (neschopnosť vnímať a reprodukovať tóny a rytmus) patrilo zistenie, že v mozgu neexistuje osobitné centrum pre hudbu.	One of the biggest surprises during early observations of those with brain damage or of healthy subjects with amusia (the inability to recognize and replicate musical tones or rhythms) was that there is no special music center in the brain.	0.293939
Lepšie povedané, pri počúvaní a tvorení hudby sa aktivuje nieko ko oblastí rozložených po celom mozgu. ~~~ Patria sem aj tie, ktoré sa bežne zapájajú do iných kognitívnych funkcií. ~~~ Zara ujeme sem napr. Brocovu oblasť, ktorá slúži na porozumenie a tvorbu reči pod a gramatických pravidiel.	Rather, when listening to or making music, several areas distributed throughout the brain are activated, including some that are typically engaged in other cognitive functions, such as the Broca area, which is responsible for the comprehension and production of the grammatical aspects of language.	-0.164103
Psychiater Manfred Spitzer vo svojej knihe Musik im Kopf (Hudba v mozgu) [5], vydanej v roku 2003, graficky opisuje výsledky výskumu, ktoré boli prvýkrát publikované vo vedeckom časopise Nature v roku 1993 a v súčasnosti sú známe ako Mozartov efekt.	In his book published in 2003, Musik im Kopf [Music in the Brain] [5], the psychiatrist Manfred Spitzer describes graphically the results of a study first published in Nature in 1993, which came to be known as the ‘Mozart effect. ’	0.928849
V skutočnosti za popularitu Mozartovho efektu môže skôr publikácia než samotný výsledok skúmania. ~~~ Deň po uverejnení sa totiž zvýšil predaj Mozartových nahrávok - - hlavne Sonáty D-dur pre dva klavíry (KV 448), ktorá bola použitá pri výskume.	In fact, it would be more accurate to ascribe this effect to the publication of the article rather than the research findings themselves: on the day after the article appeared, sales of Mozart recordings – and in particular of the Sonata for two pianos in D major (KV 448) used in the study – soared.	-0.028125
Čo sa skúmalo? A má vôbec Mozartova hudba klinicky relevantné účinky?	What had been studied, and does Mozart’s music have clinically relevant effects?	0.25
Rauscherová a jej kolegovia [6] skúmali, či počúvanie hudby ovplyvňuje priestorové vnímanie.	Rauscher and his colleagues [6] investigated whether listening to music had an impact on the processing of spatial perception.	0.431989
Tridsaťšesť študentov rozdelili do dvoch skupín.	Thirty-six students were divided into three groups.	0.286364
Jedna skupina počúvala Mozartovu sonátu 10 minút, zatia čo druhej skupine hrala relaxačná hudba a tretia bola bez akejko vek zvukovej stimulácie.	One group listened to the Mozart sonata for 10 minutes. The second group were played relaxation music for the same period. The third group received no acoustic stimulation.	1.68438
Potom žiaci riešili inteligenčné testy zamerané na priestorovú predstavivosť.	Afterwards, the subjects’ spatial intelligence was evaluated with a standardized test.	0.27
Študenti, ktorí počúvali Mozarta dosiahli ove a lepšie výsledky než ostatní.	Students who had been listening to Mozart achieved significantly higher scores than those in the other two groups.	0.161194
Tento výskum vyvolal rozličné ohlasy.	This study provoked various responses.	0.291176
Americké školy začali počas vyučovacích hodín púšťať Mozartove skladby ako pozadie, zatia čo vedecké časopisy zaplavovali výskumy a kritické preskúmania Mozartovho efektu.	US schools began to play Mozart in the background during lessons, while a flood of studies and a critical re-examination of the Mozart effect appeared in the scientific press.	0.424354
Takže existuje vôbec Mozartov efekt?	So, is there a Mozart effect?	0.204
Pod a striktného názoru vedcov: nie, hudobné skladby nemajú vplyv na rozvoj kognitívnych schopností.	In a strictly scientific sense: no; that is, specific pieces of music have no effect on cognitive development.	0.479545
Napriek tomu, spracovanie hudby a jej tvorba sú ve mi zložité činnosti, ktoré kladú vysoké nároky na náš mozog.	Nevertheless, the processing and production of music are highly complex activities that place great demands on our brains.	0.261702
Je nepravdepodobné, aby len samotné počúvanie hudby (bez vlastného pričinenia alebo iniciatívy) zvyšovalo mentálne schopnosti.	Simply consuming music is unlikely to promote mental abilities without additional individual input or initiative.	0.261
Tvorenie hudby pôsobí na viacero aspektov - jemná motorika, pamäť a reakcia na podnety.	Furthermore, making music challenges us at many other levels, including our fine motor skills, memory and responsiveness to stimuli.	0.14
Netýka sa len udského poznávania, ale aj osobnosti (ako sa vieme vyrovnať s emóciami). Zároveň nás učí sebaovládaniu.	It trains not only human cognition, but at the level of personality, how we deal with our emotions, and it is an important resource for learning self- discipline.	0.19604
Z terapeutického h adiska sú zaujímavé najmä procesy, ktoré prebiehajú v mozgu vtedy, ke na nás hudba silno zapôsobí.	From a therapeutic perspective, particularly interesting are the events that take place in the brain when we react emotionally to music.	0.249
Väčšina udí má v takomto prípade aj somatické príznaky.	Most people experience somatic reactions when they respond strongly to pieces of music.	0.125
Pod a výskumu Slobodu [7] z roku 1991 sú to najčastejšie zimomriavky na chrbte, plač, hrča v krku či zvýšenie srdcového tepu.	In a study by Sloboda in 1991 [7], the most commonly mentioned reactions were a shiver of goose bumps running down the spine, laughter, a lump in the throat, tears, or an increase in heart rate.	1.70807
Hudba nevyvoláva len emócie. ~~~ Pre mnohých je dôležitou súčasťou citového života.	Music does not merely evoke emotions, for many it is a vital component of a full emotional life.	-0.0166667
Pacienti často hovoria o tom, ako im hudba už v detstve a taktiež pri vážnych ochoreniach pomáhala zbaviť sa emocionálneho stresu.	Patients often describe how since childhood, as well as during serious illnesses, music has helped them to work through emotional stresses.	0.275676
Iba nieko ko minút hry na klavíri dokáže uvo niť emocionálne napätie.	Just a few minutes sitting at the piano playing a piece of music can relieve emotional strain.	0.198305
Pri vážnom fyzickom ochorení sa zvyčajne výrazne zhoršuje pocit duševnej pohody, čo ovplyvňuje účinnosť terapie a znižuje schopnosť zapojiť sa do terapie.	Serious physical illness is often accompanied by a marked degradation of one’s sense of well-being, which in turn undermines and interferes with a person’s usual involvement with music.	0.374465
Vedieť znovu tvoriť hudbu predstavuje pre pacientov muzikoterapie cestu späť do normálneho stavu.	Being able to make music again is often experienced by music therapy patients as a way back to (an often readjusted) normality.	0.226744
V zobrazovacej metóde PET, Bloodová a Zatorre [8] dokázali, že hudba stimuluje neurónové siete, ktoré inak reagujú na príjem potravy, sex alebo omamné látky.	In a PET imaging study, Blood and Zatorre [8] were able to show that music stimulates neuronal systems that otherwise respond to food intake, sex or narcotic drugs.	0.773333
Dochádza k stimulácii mozgového systému odmeny, čo vedie k uvo neniu endogénnych CHÝBA TEXT	The body’s reward system is stimulated, leading to the release of endogenous opioids and the neurotransmitter dopamine.	0.205063
CHÝBA TEXT štruktúry centrálneho nervového systému, ktoré signalizujú strach, averziu a bolesť.	Furthermore, music that is experienced as pleasant inhibits central nervous system structures that signal anxiety, aversion or pain.	0.190588
Zároveň tiež spozorovali, že sa aktivizovali štruktúry dôležité pre bdelosť a pozornosť.	In parallel, Blood and Zatorre also found activation of structures important for wakefulness and attention.	0.238462
Zaujímavé na tom je, že hudbu nepotrebujeme ani na prežitie, ani na reprodukciu a sama o sebe nie je ani liečivom.	This is interesting given that, strictly speaking, music is necessary neither for survival nor reproduction and is not itself a pharmacological substance.	0.313206
Ich výskum však zdôrazňuje vyššie opísané skutočnosti: možno dokážeme žiť bez hudby, ale bez nej sa naše duševné zdravie môže podstatne zhoršiť.	Their study, however, underscores the experiences described above: we may be able to live without music, but without music our psychic health may be considerably impaired.	0.244355
Ďalší prístup v muzikoterapeutickom výskume úzko súvisí s chronobiológiou. ~~~ Zaoberá sa variabilitou srdcového rytmu pri počúvaní hudby a jej aktívnom tvorení.	Another approach in music therapy research and one that is closely related to chronobiology is the study of heart rate variability during music reception and active music making.	-0.0128571
Rozdiely v príslušných fyziologických hodnotách sa merajú malými prístrojmi, ktoré takmer vôbec neprekážajú pri pohybe.	Changes in relevant physiological parameters are measured with small instruments that do not, or only slightly, interfere with the subjects’ mobility.	0.229245
Zmena srdcovej frekvencie predstavuje mieru našej relaxácie a fyzickej rovnováhy.	The variation in our pulse is an indicator of our degree of relaxation and physical equilibrium.	0.263014
Toto meranie sa využíva v telovýchovnom lekárstve a vrcholovom športe, napr. na sledovanie stavu športovca a na to, aby sa predišlo nadmernému tréningu.	In sports medicine and competitive sports this measurement is used, e. g. , to monitor an athlete’s condition and to prevent excessive training.	0.280488
Nebezpečné signály nastupujú, ke je variabilita čoraz menšia a srdcový tep pracuje ako metronóm. ~~~ udia pod stresom majú nižšiu variabilitu než tí, ktorí sú pokojní.	If the variation drops off and the heart beat takes on the characteristics of a metronome, these are interpreted as danger signals.	0.0517857
Ľudia pod stresom majú nižšiu variabilitu než tí, ktorí sú pokojní.	People in stressful situations exhibit less heart beat variation than those who are relaxed.	0.186207
Výskumy o premenlivosti srdcového rytmu pacientov v paliatívnej starostlivosti ukazujú, že ku koncu života sa pulz stáva pravidelným (je prakticky bez akejko vek odchýlky).	Studies of pulse variability of patients in palliative care show that towards the end of life, the heart beat becomes increasingly regular, with virtually no variation.	0.2875
Pokia ide o hudbu, jej počúvanie i tvorba (napr. spievanie) zvyšuje variabilitu srdcového rytmu, čím sa znižuje stres, napätie a pacienti sa rýchlejšie zotavia.	As far as music is concerned, both listening to music and active music making, like singing, raise heart rate variability and contribute to somatic recovery and a reduction in stress and tension.	0.361304
Hudobná činnosť nemení len variabilitu srdcového rytmu.	Musical activity can alter not only the variability of the heart beat.	0.24
Reinhardt [9] vo svojom výskume s onkologickými pacientmi trpiacimi chronickou bolesťou zistil, že ich pulz sa zosúladil s rytmom pomalej relaxačnej hudby.	In a study with cancer patients suffering from chronic pain, Reinhardt [9] showed that the patients’ pulse synchronized with the beat of slow relaxation music.	0.558647
Po nieko kých stretnutiach pacienti dokonca prestali užívať tak ve a liekov proti bolesti.	In addition, over the course of several sessions with this music, the patients self-administered significantly less analgesic medication.	0.134615
Zaznamenal sa výskyt dvoch zosynchronizovaných pomerov: 1:2 (tempo hudby 50 bpm, pulz srdca 100 bpm) a jeden obzvlášť stály: 2:3 (hudba 42-48 bpm, srdce 63-72 bpm).	Two synchronization relationships were found: 1:2 (music 50 bpm, heart 100 bpm) and a particularly stable one of 2:3. The latter was found when the music had a tempo of 42–48 bpm – the heart responded with a pulse of 63–72 bpm.	1.97706
Najvyšší stupeň synchronizácie mali pacienti, ktorí si hudbu maximálne vychutnávali.	Those patients who enjoyed the music most tended to show the greatest degree of synchronization.	0.272368
Dôležité informácie o účinkoch hudby môžeme získať aj prostredníctvom dotazníkov a rozhovorov s pacientmi.	Important information about the effects of music can also be obtained by directly interviewing patients or giving them questionnaires to fill out.	0.197872
Výskum onkologických pacientov, ktorí sa rehabilitujú na Klinike nádorovej biológie vo Freiburgu ukázal, že monochord (30-strunový hudobný nástroj s tromi základnými tónmi) – hoci je pomerne monotónny, avšak bohatý na alikvotné (vyššie harmonické) tóny – vyvoláva pocit pokoja a rovnováhy [10].	A study with patients undergoing oncological rehabilitation in the Clinic for Tumor Biology in Freiburg showed that the relatively monotonal but overtone-rich sounds of a monochord (a 30-stringed instrument with three tonic notes) promote a feeling of calm and equilibrium [10].	0.494202
Treba hlavne podotknúť, že hudba účinkuje takmer okamžite a pacient nemusí nacvičovať "spôsob počúvania", ke že ide o prirodzenú činnosť.	Especially noteworthy here is that the music exerts its effects almost immediately and the patient does not have to practise a listening technique.	0.42521
Muzikoterapia V zásade sa rozlišujú dva druhy muzikoterapie: aktívna a receptívna.	Music as Therapy There are fundamentally two types of music therapy: active and receptive.	0.279452
Počas aktívnej muzikoterapie tvorí pacient hudbu sám, s terapeutom alebo v skupine.	In active music therapy, the patient makes music either alone, with a therapist or within a group.	0.258904
Pri receptívnej muzikoterapii sa terapeutické ciele realizujú počúvaním hudby.		-0.3
Muzikoterapeuti vychádzajú z predpokladu, že každý má aspoň základné hudobné nadanie.	In receptive music therapy, the therapeutic goals are pursued exclusively by listening to music.	0.268421
O tejto hypotéze sa zmienil profesor Michael Thaut vo svojom úvodnom článku a v súčasnosti je dokázaná v aka obrovskému množstvu výskumov.	Music therapists work with the underlying assumption that everyone is endowed with a basic musicality, a hypothesis that, as Michael Thaut has shown in his opening article, is now substantiated by a significant body of research.	0.498084
Treba zdôrazniť, že muzikoterapia nevyžaduje, aby mal pacient predošlé znalosti z hudby (ako napr. hra na hudobnom nástroji).	Music therapy, and this point needs to be stressed, requires no prior musical knowledge – such as the ability to play an instrument – on the part of the patient.	0.233945
Stáva sa totiž, že ak sa na terapii stretnú vyškolení hudobníci, môže dôjsť k vzniku konfliktov kvôli rozdielnemu vkusu.	In fact, when trained musicians are in therapy, there is often the danger of their running into conflicts with their personal aesthetic standards.	0.235922
Úspech terapie závisí od toho, ako sa k nej klient stavia a akým spôsobom sa hudba v terapii využíva.	Having an open mind about music and how it is employed in therapy is, rather, much more likely to lead to a successful outcome.	0.375
Používanie afrických bubnov pri aktívnej muzikoterapii.	Active music therapy using African drums.	0.186486
Hudobný dialóg medzi pacientom a terapeutom je improvizovaný, simultánny a úplne spontánny.	The musical dialogue between patient and therapist is played improvisationally, simultaneously and fully spontaneously.	0.203704
Pacienti pri aktívnej skupinovej terapii sa viac uvo nia až vtedy, ke prestanú byť sebakritickí alebo rozmýš ať nad tým, či dobre hrajú a len si jednoducho budú užívať to, čo robia. ~~~ Taktiež tým výrazne znížia napätie a získajú viac sebadôvery.	When, for example, patients in an active group therapy at the Clinic for Tumor Biology in Freiburg are able to stop worrying self-critically about how well they are performing and are simply able to enjoy what they are doing, they are then able to achieve a greater sense of composure, can actively reduce the stresses they are experiencing and, in general, reach a higher degree of self-acceptance.	-0.0477493
Pre onkologicky chorých to tiež znamená nový vzťah so sebou samým alebo dokonca novú telesnú identitu - dôležité liečebné výsledky u pacientov, ktorí sa musia vyrovnať s rakovinou.	In the oncological context this often also means a new relationship to the injured self, or even a new body identity – important healing outcomes when coming to terms with a cancer illness.	0.395656
Muzikoterapia sa vo všeobecnosti uplatňuje v klinickej, pedagogickej a gerontologickej oblasti.	The areas in which music therapy can be applied can be broadly subdivided into clinical, pedagogic and gerontologic applications.	0.209302
Klinická sféra je široká a zahŕňa psychosomatiku, psychiatriu, neurológiu, onkológiu, pediatriu, gerontológiu a paliatívnu medicínu.	The clinical scope is wide and includes psychosomatics, psychiatry, neurology, oncology, pediatrics, gerontology and palliative medicine.	0.289916
Tabu ka 1 znázorňuje klinické odbory a zdravotný stav, pri ktorých sa muzikoterapia využíva.	Table 1 shows the clinical fields and medical conditions in which music therapy is applied, and rates the value of the two therapeutic forms – active and receptive – for the different fields.	2.2
Zároveň hodnotí dve liečebné formy muzikoterapie (aktívnu a receptívnu) využívané v rôznych odboroch. ~~~ Metódy muzikoterapie Aktívna muzikoterapia môže byť reproduktívna (používa známe piesne alebo rytmy) alebo produktívna (komponovanie alebo spontánna tvorba nových hudobných skladieb).	The Methods of Music Therapy Active music therapy can take the form of either a reproductive music therapy using well-known songs or rhythms, or a productive music therapy during which new musical pieces are created spontaneously or are composed.	-0.0330144
Bez oh adu na metódu, cie om je podporiť vyjadrovanie emócií, ktoré je sprevádzané celkovou psychofyziologickou aktivizáciou a stimuláciou pacientovej tvorivosti.	Regardless of the method, the goal is to promote emotional expressivity, accompanied by a general psychophysiological activation and stimulation of the patient’s creativity.	0.417483
Pre pacienta s chronickým ochorením to znamená, že všetky tieto procesy mu pomôžu vyrovnať sa so svojím zdravotným stavom.	For a patient with a chronic disease, for example, these are all processes that will assist him or her to cope with the disease.	0.447143
Receptívne prístupy môžu byť (a) relaxačné a paliatívne, napr. na zníženie bolesti; (b) rehabilitačné a psychoterapeutické; (c) funkčne zamerané (pozri tabu ku 2).	Receptive approaches may (a) be relaxational and palliative, for example, to reduce pain; (b) be more rehabilitative and psychotherapeutic; or (c) have a functional orientation (see Table 2).	0.876408
Metódy muzikoterapie Aktívna muzikoterapia Aktívna muzikoterapia zvyčajne používa hudobné nástroje, na ktorých sa ve mi ahko hrá.	Active Music Therapy Active music therapy usually works with instruments that are very easy to play.	0.202326
Jej cie om nie je naučiť pacienta hrať na nástroji dobre či bezchybne.	The aim here is not for the patient to learn to play an instrument well or perfectly.	0.244068
Aktívne tvorenie hudby má predovšetkým zlepšiť komunikačné a kooperačné schopnosti, zmobilizovať a zaktivizovať neverbálne vyjadrovanie emócií a prekonať zaužívané vzorce správania. ~~~ Pacient by sa mal jednoducho tešiť z toho, že robí niečo pre seba.	The goals, rather, of active music making are to improve the patient’s communication and relational abilities, to mobilize and activate the nonverbal expression of emotions, to overcome restrictive personality patterns or simply to experience joy in doing something for oneself.	-0.0151376
Pacientom pod ve kým stresom (napr. pri chronickej chorobe v pokročilom štádiu) pomáha aktívna tvorba hudby zbaviť sa negatívnych myšlienok a pocitov aspoň nachví u, ke že sa sústredia len na hudbu.	For patients under substantial stress, such as those with a progressive chronic disease, active music making can help them gain some distance or respite from negative thoughts and feelings because their attention becomes totally absorbed by the music making activity.	0.281981
Hlavne onkologickí pacienti hovoria, aká je to pre nich prospešná a zároveň príjemná činnosť.	Oncology patients, in particular, have explained how helpful and agreeable this can be.	0.280263
Medzi typické intervenčné metódy muzikoterapie patria spev, práca s rytmom, improvizácia a komponovanie hudby alebo piesní.	Typical intervention techniques in active music therapy are singing, playing with rhythm, improvisation, and the composition of music or songs.	0.255963
Tieto metódy sú bližšie opísané alej v texte.	These methods are described in more detail below.	0.269231
Spev Pri speve pacient používa svoje vlastné telo ako hudobný nástroj.	Singing Working with songs obviously involves the use of the patient’s own body as the musical instrument.	0.152459
Z terapeutického h adiska si precvičuje artikuláciu, dýchanie a sebavyjadrovanie.	In the therapeutic context, singing can train articulation, breathing and individual expressivity.	0.238356
V skupinovej práci si dokonca rozvíja sociálne zručnosti.	Group work, in addition, nurtures the development of social skills.	0.252941
Spievaním známych piesní môžu najmä udia trpiaci demenciou znovu získať niektoré zo svojich stratených rečových schopnosti a zároveň sa zbaviť pocitu úzkosti spojeného s touto chorobou.	In particular, people with dementia can regain some of their lost speech abilities by singing well-known songs. At the same time, singing can help to relieve the anxieties associated with dementia.	0.286957
udom s afáziou po porážke spev stimuluje rečové mozgové centrá, čo vedie k následnému zlepšeniu rečovej kompetencie.	For patients with an aphasia after stroke, singing can stimulate the brain’s speech centers, leading to a subsequent improvement in speech competence.	0.213861
Ľuďom s afáziou po porážke spev stimuluje rečové mozgové centrá, čo vedie k následnému zlepšeniu rečovej kompetencie.	Rhythm Working with rhythms during therapy enhances fine motor skills and eye-hand coordination.	0.24
Rytmus Práca s rytmom zlepšuje jemnú motoriku a koordináciu pohybov rúk a očí. ~~~ Vyjadrovacia sila uvo nená pri rytmických cvičeniach pomáha pacientom znížiť napätie a úplne sa ponoriť sa do hudby. ~~~ V skupinách posilňuje pocit spolupatričnosti, ktorý sa prejavuje v pacientovej radosti z toho, čo robí.	The expressive power that is often released by rhythm work contributes to an active release of tension, flow (the mental state in which a person is fully immersed in what he or she is doing), and in groups to a positive sense of belonging, manifested in pleasure in one’s own activities.	-0.0890351
Ako sme už spomínali, rytmus a cítenie vlastného pravidelného pulzu je dobré na synchronizáciu procesov, ktoré sú zdraviu prospešné a dokonca stimulujú motorické centrá mozgu.	Rhythm as well as the experience of an inner metrical beat can be, as mentioned above, beneficial for health-promoting synchronization processes and are even able to stimulate the motor areas of the brain.	0.256579
Improvizácia	Improvisation	0.276923
Hudobná improvizácia je zameraná na vyjadrovanie myšlienok a pocitov bez použitia slov.	In musical improvisation, patients express thoughts and feelings wordlessly.	0.265217
Hovoríme o terapeutickej technike, ke pacienti rozvíjajú svoju kreativitu, ktorá ovplyvňuje ich individuálny alebo skupinový výkon.	It is a therapeutic technique in which they can deploy their creativity, responding to and interacting with their own performance or that of a group.	0.276923
