Rozhodla som sa poprechádzať.	I decided to take a walk.	0.214286
Išla som do centra mesta, pritisla som nos na okno pekárne a pozorovala muža so zamúčenými rukami. Cesto mäkké ako pokožka stláčal, ťahal a tvaroval do konečnej podoby hviezd.	I went into the center of town, pressed my nose against a bakery window, watched the man with flour on his hands, the dough as soft as skin, pushed and pulled and shaped at last into stars.	0.387838
Motala som sa okolo antikvariátu.	I milled about in an antique store.	0.3
Nakoniec som prišla do tetovacieho štúdia.	At last I came to our town‘s tattoo parlor.	0.283333
Teraz už nie som typ človeka na tetovanie, ale z nejakého dôvodu, v tú studenú tichú nedeľu, som sa rozhodla vojsť dnu.	Now I am not a tattoo type person, but for some reason, on that cold silent Sunday, I decided to walk in.	0.250588
Ako vám môžem pomôcť? spýtala sa ma žena vo vnútri.	Can I help you? a woman asked.	0.084
Existuje nejaké dočasné tetovanie? spýtala som sa.	Is there a kind of tattoo I can get that won‘t be permanent? I asked.	0.226667
Tetovanie henou. odpovedala mi.	Henna tattoos. she said.	0.204545
Vysvetlila mi, že vydrží šesť týždňov, používa sa na indických svadbách, je silné, krásne a celé hnedé.	She explained that they lasted for six weeks, were used at Indian weddings, were stark and beautiful and all brown.	0.269318
Ukázala mi fotky indických žien so šperkmi v nosoch, ich ruky zdobili špirály a čipky z heny.	She showed me pictures of Indian women with jewels in their noses, their arms scrolled and laced with the henna markings.	0.207692
Samozrejme, že boli prekrásne, nie ako komické krikľavé vytetované prúžky v Spojených štátoch.	Indeed they were beautiful, sharing none of the gaudy comic strip quality of the tattoos we see in the United States.	0.245783
Tetovanie henou vyjadruje zložitosť, vzťahy medzi dvoma ľuďmi, väzby, ktoré ich zväzujú a aké ťažké je nájsť ich začiatok a koniec.	These henna tattoos spoke of intricacy, of the webwork between two people, of ties that bind and how difficult it is to find their beginnings and their ends.	0.249107
Keďže som sa práve vydala a cítila som posvadobné sklamanie, chcela som niečo skutočne romantické, čo mi pomôže preplávať nocou, tak som sa pre jedno rozhodla.	And because I had just gotten married, and because I was feeling a post wedding letdown, and because I wanted something really romantic to sail me through the night, I decided to get one.	0.366667
Kam? opýtala sa ma.	Where? she asked.	0.28125
Nadvihla obočie.	She raised her eyebrows.	0.1875
Jasné. odpovedala.	Sure. she said.	0.214286
Prišla ku mne nesúc malú čiernu misku, v ktorej bola mierne lesklá, sýto červená kaša.	She came to me carrying a small black-bellied pot inside of which was a rich red mush, slightly glittering.	0.230137
Premenila mi telo na úplne novú bujnú záhradu, a potom mi dolu okolo bokov namaľovala delikátnu reťaz pásu cudnosti.	She turned my body into a stake supporting whole new gardens of growth, and then, low around my hips, she painted a delicate chain-linked chastity belt.	0.362121
O hodinu neskôr, keď farba zaschla, som sa obliekla a odišla domov za manželom.	An hour later, the paint dry, I put my clothes back on, went home to find my newly wed one.	0.273134
Jedno som vedela. Toto je môj dar pre neho, ktorý ponúkate iba raz v živote.	This, I knew, was my gift to him, the kind of present you offer only once in your lifetime.	0.247619
Nechala som ho, aby ma vyzliekol.	I let him undress me.	0.116667
Fíha. povedal a odstúpil.	Wow. he said, standing back.	0.273913
Už dávno nie sme začiatočníci.	We are no longer beginning, my husband and I.	0.177778
Vôbec ma to neprekvapuje.	This does not surprise me.	0.3
Dokonca aj vtedy, keď som mala oblečenú výzdobu poprepletaných tetovaní som vedela, že zoslabnú a ich hlinovo červená farba vybledne.	Even back then, wearing the decor of desire, the serpentining tattoos, I knew they would fade, their red-clay color bleaching out until they were gone.	0.266087
Vo svadobný deň mi na tom nezáležalo.	On my wedding day I didn‘t care.	0.244444
Teraz však záleží.	I do now.	-0.0375
O osem rokov neskôr, bledá ako návlek na podušku tu sedím so všetkými kilami navyše a všetkými problémami, ktoré čas prináša.	Eight years later, pale as a pillowcase, here I sit, with all the extra pounds and baggage time brings.	0.380233
A otázky vo mne rastú viac a viac.	And the questions have only grown more insistent.	0.139286
Naozaj sa vášeň časom zmenšuje?	Does passion necessarily diminish over time?	0.171429
Je romantická láska skutočne spoľahlivá ako prostriedok na výber partnera?	How reliable is romantic love, really, as a means of choosing one‘s mate?	0.280645
Môže manželstvo stále fungovať, aj keď je láska nahradená priateľstvom alebo dokonca ekonomickým vzťahom, v ktorom sú dvaja ľudia spätí bankovými účtami?	Can a marriage be good when Eros is replaced with friendship, or even economic partnership, two people bound by bank accounts?	0.227103
Poviem to jasne. ~~~ Stále milujem svojho manžela.	Let me be clear: I still love my husband.	-0.0388889
Neexistuje iný muž, po ktorom by som túžila viac.	There is no man I desire more.	0.096
Ale je nesmierne ťažké udržať romantiku v každodennom živote plnom maličkostí.	But it‘s hard to sustain romance in the crumb-filled quotidian that has become our lives.	0.269565
Putá, ktoré nás spájali, rozdelili peniaze, hypotéky a deti. ~~~ Tí malí krpci, ktorí nejako dokázali narušiť manželský zväzok, čím oslabili celý vzťah.	The ties that bind have been frayed by money and mortgages and children, those little imps who somehow manage to tighten the knot while weakening its actual fibers.	-0.00923077
Benjamin a ja už nemáme čas na vychladené biele víno a lososa.	Benjamin and I have no time for chilled white wine and salmon.	0.530769
Dokonca aj kúpeľne v našom dome sú v motíve obľúbenej postavičky Big Bird z televíznej detskej šou.	The baths in our house always include Big Bird.	0.27
Ak sa vám toto všetko zdá byť mizerné, nie je to tak.	If this all sounds miserable, it isn‘t.	0.220588
Moje manželstvo je ako kus pohodlného oblečenia, dokonca aj hádky v nás vyvolávajú pocit zmätenosti, no manželstvo je tým, čo môžem nazývať domovom.	My marriage is like a piece of comfortable clothing; even the arguments have a feel of fuzziness to them, something so familiar it can only be called home.	0.295276
A predsa V západnom svete sa po stáročia vymýšľali básne, príbehy a hry o cykloch lásky, o premenách a zmenách v priebehu času a spôsobe, akým nás vášeň nečakane opantá, a potom sa jednoducho vytratí.	And yet In the Western world we have for centuries concocted poems and stories and plays about the cycles of love, the way it morphs and changes over time, the way passion grabs us by our flung- back throats and then leaves us for something saner.	0.235329
Ak by bol Drakula krehkou ženou a stelesnením poslušnosti, symbolizoval by vášeň počiatočnej romantiky. ~~~ Flinstonovci by zase odzrkadľovali skúsenosti z dlhodobej lásky. Samozrejme, že je to nezmysel a hlúposť, ako známa pieseň, ktorú si nemôžete prestať spievať, a keď prestanete, samota je takmer neznesiteľná.	If Dracula—the frail woman, the sensuality of submission—reflects how we understand the passion of early romance, the Flintstones reflects our experiences of long-term love: All is gravel and somewhat silly, the song so familiar you can‘t stop singing it, and when you do, the emptiness is almost unbearable.	-0.00515267
Spoliehame sa na príbehy, ktoré vysvetľujú zložitosť lásky, povesti o žiarlivých bohoch a šípoch.	We have relied on stories to explain the complexities of love, tales of jealous gods and arrows.	0.285185
V súčasnosti sú však tieto príbehy súčasťou každej civilizácie a môžu zmeniť postup vedy na vysvetlenie toho, čo sme vždy pociťovali ako mýtus a kúzla.	Now, however, these stories—so much a part of every civilization—may be changing as science steps in to explain what we have always felt to be myth, to be magic.	0.401322
Po prvýkrát, nový výskum začal objasňovať, kde v mozgu sa nachádza láska a údaje o jej chemických zložkách.	For the first time, new research has begun to illuminate where love lies in the brain, the particulars of its chemical components.	0.237363
Ako profesorka na Rutgersovej univerzite, žije v New York City. ~~~ Jej apartmán, ktorý je celý obložený knihami sa nachádza v blízkosti Central Parku, s rozvetvenými zelenými stromami v lete a chodníkmi plných párikov držiacich sa za ruky.	A professor at Rutgers University, she lives in New York City, her book-lined apartment near Central Park, with its green trees fluffed out in the summer season, its paths crowded with couples holding hands.	0.0295714
Fisherová venuje veľkú časť svojho života štúdiu biochemickej dráhy lásky vo všetkých jej prejavoch ako sú túžba, romantika, oddanosť a intenzite.	Fisher has devoted much of her career to studying the biochemical pathways of love in all its manifestations: lust, romance, attachment, the way they wax and wane.	0.274016
Automaticky si preloží nohu cez nohu a prirodzenou otvorenosťou s cinknutím ľadu v pohári, rozpráva o vzostupoch a pádoch lásky spôsobom, akým väčšina ľudí hovorí o nehnuteľnostiach.	One leg casually crossed over the other, ice clinking in her glass, she speaks with appealing frankness, discussing the ups and downs of love the way most people talk about real estate.	0.296129
ˇŽena nevedome používa orgazmus ako prostriedok na rozhodnutie sa, či je muž pre ňu dobrý alebo nie.	A woman unconsciously uses orgasms as a way of deciding whether or not a man is good for her.	0.264474
Ak je netrpezlivý a drsný a ona nedosiahne orgazmus, inštinktívne cíti menšiu pravdepodobnosť, že bude dobrý manžel a otec.	If he‘s impatient and rough, and she doesn‘t have the orgasm, she may instinctively feel he‘s less likely to be a good husband and father.	0.424528
Vedci sa domnievajú, že chýbajúci ženský orgazmus môže ženám pomôcť rozlíšiť pána Dokonalého od pána Nedokonalého.	Scientists think the fickle female orgasm may have evolved to help women distinguish Mr. Right from Mr. Wrong.	0.280851
Jednou z Fisherovej hlavných činností za posledné desaťročie je skúmať lásku, doslova pomocou prístroja magnetickej rezonancie (MRI).	One of Fisher‘s central pursuits in the past decade has been looking at love, quite literally, with the aid of an MRI machine.	0.262857
Fisherová a jej kolegovia Arthur Aron a Lucy Brownová pozorovali jednotlivcov, ktorí boli šialene zamilovaní po dobu siedmich mesiacov.	Fisher and her colleagues Arthur Aron and Lucy Brown recruited subjects who had been ―madly in love‖ for an average of seven months.	0.731081
Keď boli vo vnútri MRI prístroja, ukázali im dve fotografie. Jednu neutrálnu a druhú s podobizňou ich milovanej osoby.	Once inside the MRI machine, subjects were shown two photographs, one neutral, the other of their loved one.	0.428547
To, čo Fisherová zistila, ju fascinovalo.	What Fisher saw fascinated her.	0.203571
Keď sa každý jednotlivec pozrel na svojho partnera, ventrálna tegmentálna oblasť a nucleus caudatus sa rozsvietili, čo znamená, že v týchto častiach mozgu sa prejavovala spokojnosť a potešenie.	When each subject looked at his or her loved one, the parts of the brain linked to reward and pleasure—the ventral tegmental area and the caudate nucleus—lit up.	0.228889
Čo však uchvátilo Fisherovú najviac nebolo ani tak zistenie, kde sa láska nachádza, ale zachytenie jej špecifických chemických dráh.	What excited Fisher most was not so much finding a location, an address, for love as tracing its specific chemical pathways.	0.271429
Láska rozsvieti nucleus caudatus, pretože sa v ňom nachádza hustá sieť receptorov pre neurotransmiter 3 dopamín, o ktorom si Fisherová myslí, že je súčasťou nášho vlastného endogénneho nápoja lásky.	Love lights up the caudate nucleus because it is home to a dense spread of receptors for a neurotransmitter called dopamine, which Fisher came to think of as part of our own endogenous love potion.	0.387195
V správnom pomere produkuje dopamín intenzívnu energiu, radosť, zvýšenú pozornosť a motiváciu na získanie odmeny.	In the right proportions, dopamine creates intense energy, exhilaration, focused attention, and motivation to win rewards.	0.276
Preto, keď ste čerstvo zamilovaný, môžete bdieť celú noc, sledovať východ slnka, bežať opreteky a upaľovať na lyžiach aj na svahu, ktorý je nad vaše schopnosti.	It is why, when you are newly in love, you can stay up all night, watch the sun rise, run a race, ski fast down a slope ordinarily too steep for your skill.	0.384711
Láska nás robí odvážnymi, veselými podstupujeme kvôli nej skutočné riziko, ktoré sa niekedy oplatí a niekedy nie.	Love makes you bold, makes you bright, makes you run real risks, which you sometimes survive, and sometimes you don‘t.	0.293878
Prvýkrát som sa zamilovala v dvanástich do svojho učiteľa.	I first fell in love when I was only 12, with a teacher.	0.26
Volal sa pán McArthur, nosil sandále s otvorenou špičkou a smiešnu briadku.	His name was Mr. McArthur, and he wore open-toed sandals and sported a beard.	0.761538
Nikdy predtým som nemala muža učiteľa a povaţovala som to za veľmi nezvyčajné.	I had never had a male teacher before, and I thought it terribly exotic.	0.479286
Pán McArthur robil veci, na ktoré sa iný učiteľ neodvážil.	Mr. McArthur did things no other teacher dared to do.	0.539394
Opierajúc sa lenivo o stenu školskej budovy, fajčil cez prestávky cigarety. Popol cigarety bol čoraz dlhší a dlhší až pokým ho automaticky neodklepol prstom.	He smoked cigarettes at recess, leaning languidly against the side of the school building, the ash growing longer and longer until he casually tapped it off with his finger.	0.275556
Je zaujímavé aká unikátna konštelácia potrieb ma primäla k tomu, aby som milovala muža, ktorý nechal vybuchnúť vajce. Avšak ani výbuch vajca nebol pre mňa taký zaujímavý ako jeho fyzický vzhľad.	What unique constellation of needs led me to love a man who made an egg explode is interesting, perhaps, but not as interesting, for me, as my memory of love‘s sheer physical facts.	0.27
Nikdy predtým som také niečo necítila.	I had never felt anything like it before.	0.291176
Nemohla som ho dostať z hlavy.	I could not get Mr. McArthur out of my mind.	0.184615
Bola som nervózna, hrýzla som si vnútornú stranu líca, až pokiaľ som nepocítila pachuť krvi.	I was anxious; I gnawed at the lining of my cheek until I tasted the tang of blood.	0.246269
Škola sa pre mňa stala zrazu desivou a vzrušujúcou zároveň.	School became at once terrifying and exhilarating.	0.26
Uvidím ho na chodbe?	Would I see him in the hallway?	0.166667
V bufete?	In the cafeteria?	0.0666667
Dúfala som.	I hoped.	0.1875
Keď sa však moje sny stali skutočnosťou a zazrela som ho, nestalo sa nič. ~~~ Len ma to ešte viac rozpálilo.	But when my wishes were granted, and I got a glimpse of my man, it satisfied nothing; it only inflamed me all the more.	0.0114754
Pozrel sa na mňa?	Had he looked at me?	0.26
Prečo sa na mňa nepozrel?	Why had he not looked at me?	0.286364
Kedy ho znovu uvidím?	When would I see him again?	0.236842
Doma som si v telefónnom zozname našla jeho číslo a zavolala som mu.	At home I looked him up in the phone book; I rang him, this in a time before caller ID.	0.451128
Bolo to v dobe, keď sa ešte nezobrazovalo číslo volajúceho.		-0.3
Zodvihol mi. Haló?	He answered, Hello?	0.282353
Bolesť v srdci mi ho zlomila na polovicu.	Pain in my heart, ripped down the middle.	0.3
Zložila som.	Hang up.	0.15
Zavolala som znovu.	Call back. Hello?	0.2625
Haló?		-0.3
Nikdy som mu nič neodpovedala.	I never said a thing.	0.15
Raz som mu zavolala neskoro v noci a podľa toho, ako zodvihol telefón bolo jasné, dokonca aj takej predpubertiačke ako ja, že bol so ženou.	Once I called him at night, late, and from the way he answered the phone it was clear, even to a prepubescent like me, that he was with a woman.	0.415385
Jeho hlas bol zmätený a v pozadí bolo počuť jej zvonivý smiech.	His voice fuzzy, the tinkle of her laughter in the background.	0.3
Nevstala som z postele celý deň.	I didn‘t get out of bed for a whole day.	0.257143
Je vám to povedomé?	Sound familiar?	0.26
Možno ste mali 30, 8, 80 alebo 25, keď sa vám to stalo.	Maybe you were 30 when it happened to you, or 8 or 80 or 25.	0.708117
Možno ste žili v Káthmandu alebo Kentucky. ~~~ Vek a miesto je nepodstatné.	Maybe you lived in Kathmandu or Kentucky; age and geography are irrelevant.	-0.0047619
Donatella Marazzitiová z Univerzity v Pise v Taliansku je profesorkou psychiatrie, ktorá študuje biochémiu chorôb z lásky.	Donatella Marazziti is a professor of psychiatry at the University of Pisa in Italy who has studied the biochemistry of lovesickness.	0.44704
Potom, čo bola dvakrát zamilovaná a cítila, aké je to silné, začala skúmať podobnosti medzi láskou a obsedantno-kompulzívnou poruchou.	Having been in love twice herself and felt its awful power, Marazziti became interested in exploring the similarities between love and obsessive-compulsive disorder.	0.230769
Spolu so spolupracovníkmi zmerala hladinu serotonínu v krvi 24 jednotlivcov, ktorí sa zaľúbili v posledných šiestich mesiacoch a boli posadnutí objektom svojej lásky minimálne štyri hodiny každý deň.	She and her colleagues measured serotonin levels in the blood of 24 subjects who had fallen in love within the past six months and obsessed about this love object for at least four hours every day.	1.41953
Serotonín je pravdepodobne najdôležitejší neurotransmiter, hladinu ktorého môžu zmeniť najlepšie psychiatrické lieky, ako sú Prozac, Zoloft a Paxil, a iné.	Serotonin is, perhaps, our star neurotransmitter, altered by our star psychiatric medications: Prozac and Zoloft and Paxil, among others.	0.5575
Vedci si dlho mysleli, že ľudia s obsedantno-kompulzívnou poruchou (OKP) majú nerovnováhu― serotonínu.	Researchers have long hypothesized that people with obsessive-compulsive disorder (OCD) have a serotonin ―imbalance.	0.257143
Zdá sa, že lieky ako Prozac zmierňujú OKP tým, že zvyšujú množstvo tohto neurotransmiteru, prítomného na synapsii.	Drugs like Prozac seem to alleviate OCD by increasing the amount of this neurotransmitter available at the juncture between neurons.	0.421212
Marazzitiová porovnala hladinu serotonínu u zaľúbených so skupinou ľudí, trpiacich OKP a ďalšou skupinou, v ktorej nikto netrpel duševnou chorobou ani nebol zaľúbený.	Marazziti compared the lovers‘ serotonin levels with those of a group of people suffering from OCD and another group who were free from both passion and mental illness.	0.418662
Hladina serotonínu v krvi zaľúbených a chorých bola o 40 percent nižšia ako tá u jednotlivcov v druhej skupine.	Levels of serotonin in both the obsessives‘ blood and the lovers‘ blood were 40 percent lower than those in her normal subjects.	2.05532
Inak povedané, láska a obsedantno-kompulzívna porucha, môžu mať podobný chemické základ.	Translation: Love and obsessive-compulsive disorder could have a similar chemical profile.	0.542405
Z toho vyplýva, že lásku a duševnú poruchu môže byť ťažké rozpoznať.	Translation: Love and mental illness may be difficult to tell apart.	0.294828
Preto nebláznite a držte sa od nej ďalej.	Translation: Don‘t be a fool. Stay away.	0.675
Samozrejme, že túto radu nikto z nás nemôže počúvnuť.	Of course that‘s a mandate none of us can follow.	0.263415
Zamilovávame sa, niekedy znovu a znovu a zakaždým sa tým vystavujeme ťažkému stavu mysle.	We do fall in love, sometimes over and over again, subjecting ourselves, each time, to a very sick state of mind.	0.433766
Existuje nádej, avšak len pre tých, ktorí sa chytili do pasce pominuteľnej vášne s názvom Prozac.	There is hope, however, for those caught in the grip of runaway passion—Prozac.	0.233824
Neexituje však nič podobné dvojfarebnej tabletke, ktorá spôsobí, že vám bude všetko jedno a utlmí sexuálny apetít.	There‘s nothing like that bicolored bullet for damping down the sex drive and making you feel ―blah‖ about the buffet.	0.29697
Helen Fisherová sa domnieva, že uţívanie lieku ako Prozac ohrozuje schopnosť človeka zamilovať sa a zostať zamilovaný.	Helen Fisher believes that the ingestion of drugs like Prozac jeopardizes one‘s ability to fall in love—and stay in love.	0.633333
Opadnutím záujmu o lásku a s tým spojenej sexuálnej túžby sa vzťahy rozpadnú.	By dulling the keen edge of love and its associated libido, relationships go stale.	0.277273
Poznám jeden pár na pokraji rozvodu.	Says Fisher, I know of one couple on the edge of divorce.	0.159375
Manželka bola na antidepresívach.	The wife was on an antidepressant.	0.29
Prestala ich užívať, začala mať znovu orgazmus, opäť sa stala sexuálne príťažlivou a teraz sú zase zamilovaní, hovorí Fisherová.	Then she went off it, started having orgasms once more, felt the renewal of sexual attraction for her husband, and they‘re now in love all over again.	0.262162
Psychoanalytici vymysleli nespočetné množstvo teórií o tom, prečo sa zamilujeme práve do tej osoby, do ktorej sa zamilujeme.	Psychoanalysts have concocted countless theories about why we fall in love with whom we do.	0.184615
Freud by povedal, že váš výber je ovplyvnený neopätovaným želaním spať s matkou, ak ste chlapec alebo s otcom, ak ste dievča.	Freud would have said your choice is influenced by the unrequited wish to bed your mother, if you‘re a boy, or your father, if you‘re a girl.	0.529441
Jung veril, že vášeň je poháňaná nejakým druhom kolektívneho nevedomia.	Jung believed that passion is driven by some kind of collective unconscious.	0.558442
Dnešní psychiatri, ako napríklad Thomas Lewis z Lekárskej fakulty Kalifornskej univerzity v San Franciscu predpokladajú, že romantická láska je zakorenená v našich raných skúsenostiach s intimitou, konkrétne, ako sme sa cítili na prsiach matky a jej tvári. ~~~ Toto čisté pokojné prostredie sa nám vrylo do mozgu a ako dospelí sa ho neustále snažíme znovu nájsť.	Today psychiatrists such as Thomas Lewis from the University of California at San Francisco‘s School of Medicine hypothesize that romantic love is rooted in our earliest infantile experiences with intimacy, how we felt at the breast, our mother‘s face, these things of pure unconflicted comfort that get engraved in our brain and that we ceaselessly try to recapture as adults.	0.0519052
Podľa tejto teórie milujeme toho, koho milujeme ani nie tak kvôli nádeji na vybudovanie si budúcnosti, ale kvôli tomu, že dúfame v navrátenie minulosti.	According to this theory we love whom we love not so much because of the future we hope to build but because of the past we hope to reclaim.	0.254867
On alebo ona nám je povedomý, na základe určitého vzhľadu, vône, hlasu alebo dotyku, ktorý v nás aktivuje zabudnuté spomienky.	He or she is familiar. He or she has a certain look or smell or sound or touch that activates buried memories.	0.24
Keď som prvýkrát stretla svojho manžela, verila som, že táto psychologická teória je viac-menej správna.	When I first met my husband, I believed this psychological theory was more or less correct.	0.245455
Manžel má ryšavé vlasy a jemný hlas.	My husband has red hair and a soft voice.	0.645968
Je náladový, zvláštny a je chemik.	A chemist, he is whimsical and odd.	0.3
Raz, ešte predtým, ako sme sa vzali, ponoril ružu do tekutého dusíka, na čo zmrzla. ~~~ Potom ju hodil o stenu a okázalo rozbil.	One day before we married he dunked a rose in liquid nitrogen so it froze, whereupon he flung it against the wall, spectacularly shattering it.	-0.0214286
Vtedy som sa do neho zamilovala.	That‘s when I fell in love with him.	0.278571
Môj otec má tiež ryšavé vlasy, jemný hlas a veľa výstredností.	My father, too, has red hair, a soft voice, and many eccentricities.	0.521698
Mal tendenciu začať z ničoho nič spievať a robil pri tom veci, ktoré sme ešte nikdy nevideli.	He was prone to bursting into song, prompted by something we never saw.	0.21
Ukazuje sa však, že moje teórie o tom, prečo som sa zamilovala do svojho manžela, sú možno len výmysly.	However, it turns out my theories about why I came to love my husband may be just so much hogwash.	0.2775
Evolučná psychológia odmieta Freuda a jeho oidipovský komplex a všetky ostatné nezmyselné veci, pričom dáva prednosť jednoduchým schopnostiam na prežitie.	Evolutionary psychology has said good riddance to Freud and the Oedipal complex and all that other transcendent stuff and hello to simple survival skills.	0.290909
Predpokladá, že máme tendenciu vidieť seba ako atraktívnych, a preto si za partnerov vyberáme ľudí, ktorí vyzerajú zdravo.	It hypothesizes that we tend to see as attractive, and thereby choose as mates, people who look healthy.	0.238636
Podľa evolučných psychológov sa zdravie u ženy prejavuje 70 percentným pomerom obvodu pásu k bokom a u muža drsnými črtami, ktoré sa vyznačujú vysokým prísunom testosterónu v krvi.	And health, say these evolutionary psychologists, is manifested in a woman with a 70 percent waist-to-hip ratio and men with rugged features that suggest a strong supply of testosterone in their blood.	1.50826
Pomer obvodu pásu k bokom je veľmi dôležitý pre úspešný pôrod. ~~~ Štúdie preukázali, že presný pomer znamená vyššiu plodnosť.	Waist-to-hip ratio is important for the successful birth of a baby and studies have shown this precise ratio signifies higher fertility.	-0.0140187
Pokiaľ ide o robustný vzhľad, muž s dobrou hladinou testosterónu má tiež silný imunitný system, a tak je viac pravdepodobné, že môže s partnerkou splodiť zdravé dieťa.	As for the rugged look, well, a man with a good dose of testosterone probably also has a strong immune system and so is more likely to give his partner healthy children.	0.400668
Možno nos je jednoduchým prostriedkom na výber partnerov.	Perhaps our choice of mates is a simple matter of following our noses.	0.252941
Claus Wedekind z Univerzity v Lausanne vo Švajčiarsku spravil zaujímavý pokus s upotenými tričkami.	Claus Wedekind of the University of Lausanne in Switzerland did an interesting experiment with sweaty T-shirts.	0.865517
Požiadal 49 žien, aby ovoňali tričko, ktoré predtým nosili neznámi muži s rôznymi genotypmi, vplývajúcimi na telesný pach a imunitný systém.	He asked 49 women to smell T-shirts previously worn by unidentified men with a variety of the genotypes that influence both body odor and immune systems.	1.91653
Potom požiadal tieto ženy o ohodnotenie tričiek podľa toho, ktoré voňalo najlepšie a ktoré najhoršie.	He then asked the women to rate which T-shirts smelled the best, which the worst.	0.211765
To, čo Wedekind zistil bolo, že ženy preferujú pach muža, ktorého genotyp je veľmi odlišný od toho jej, čiže genotyp, ktorý je pravdepodobne spojený s imunitným systémom a disponuje niečím, čo ona nemá.	What Wedekind found was that women preferred the scent of a T-shirt worn by a man whose genotype was most different from hers, a genotype that, perhaps, is linked to an immune system that possesses something hers does not.	0.451909
Týmto sa zvyšuje šanca ženy, že jej dieťa bude zavalité.	In this way she increases the chance that her offspring will be robust.	0.225
Toto všetko vyzerá až príliš dobre na to, aby bola pravda to, že máme vrodený inštinkt na hľadanie partnera.	It all seems too good to be true, that we are so hardwired and yet unconscious of the wiring.	0.240789
Pretože, pokiaľ viem tak nikto nikdy nepovedal, zobrala som si ho kvôli jeho telesnému pachu.	Because no one to my knowledge has ever said, I married him because of his B. O.	0.230769
Nie.	No.	0.225
Povieme, zobrala som si ho alebo ju pretože je inteligentný, je krásna, je vtipný, je zhovievavá.	We say, I married him (or her) because he‘s intelligent, she‘s beautiful, he‘s witty, she‘s compassionate.	0.26747
Ale v láske sa môžeme sklamať práve tak, ako sa aj sklameme, keď sme zamilovaní.	But we may just be as deluded about love as we are when we‘re in love.	0.241071
Ak by o tomto všetkom rozhodoval test čuchu, psi by mali rozhodne výhodu, pokiaľ ide o výber partnerov.	If it all comes down to a sniff test, then dogs definitely have the edge when it comes to choosing mates.	0.296512
Prečo vášnivá láska nevydrží?	Why doesn‘t passionate love last?	0.266667
Ako je možné, že v pondelok sa nám niekto zdá krásny a o 364 dní neskôr, v iný pondelok táto krása pominula?	How is it possible to see a person as beautiful on Monday, and 364 days later, on another Monday, to see that beauty as bland?	1.81408
Určite sa vaša partnerka nemohla až tak zmeniť.	Surely the object of your affection could not have changed that much.	0.168293
Má stále rovnako tvarované oči.	She still has the same shaped eyes.	0.278571
Jej hlas mal vždy ten chrapľavý zvuk, ale teraz vás to hnevá. ~~~ Znie, ako keby potrebovala antibiotiká.	Her voice has always had that husky sound, but now it grates on you—she sounds like she needs an antibiotic.	-0.00340909
Alebo možno ste to vy, kto potrebuje antibiotiká, pretože partnerka, ktorú ste kedysi milovali, starali sa o ňu, a ktorá žiarila ako hviezda sa teraz cíti skôr ako nejaká zbytočná infekcia, ktorá vás unavuje a vysáva z vás všetku silu.	Or maybe you‘re the one who needs an antibiotic, because the partner you once loved and cherished and saw as though saturated with starlight now feels more like a low-level infection, tiring you, sapping all your strength.	0.362905
Celosvetové štúdie potvrdzujú, že vášeň sa naozaj zvyčajne skončí.	Studies around the world confirm that, indeed, passion usually ends.	0.294915
Koniec vášne je rovnaký ako jej počiatočné vzplanutie.	Its conclusion is as common as its initial flare.	0.257143
Niet divu, ţe niektoré kultúry povaţujú výber celoţivotného partnera na základe niečoho tak pominuteľného za hlúposť.	No wonder some cultures think selecting a lifelong mate based on something so fleeting is folly.	0.223171
Helen Fisherová naznačuje, že vzťahy sa často končia po štyroch rokoch, pretože tak dlho trvá vychovanie dieťaťa do detstva.	Helen Fisher has suggested that relationships frequently break up after four years because that‘s about how long it takes to raise a child through infancy.	0.379907
Vášeň, tak nespútaný a šialený pocit sa po tom všetkom stane užitočnou.	Passion, that wild, prismatic insane feeling, turns out to be practical after all.	0.25082
Nepotrebujeme sa nielen rozmnožovať, taktiež potrebujeme dostatok vášne na výchovu a pocit upevnenia, kedy partneri prevezmú na seba zodpovednosť pri výchove bezbranného dieťaťa.	We not only need to copulate; we also need enough passion to start breeding, and then feelings of attachment take over as the partners bond to raise a helpless human infant.	0.397917
Ak už dieťa nie je dojčené, môžeme ho ponechať so sestrou, tetami alebo priateľmi.	Once a baby is no longer nursing, the child can be left with sister, aunts, friends.	0.3
Každý z partnerov je teraz voľný, aby si našiel nového partnera a mal ďalšie deti.	Each parent is now free to meet another mate and have more children.	0.236842
Biologicky povedané, dôvody prečo sa romantická láska vytráca môžeme nájsť v spôsobe, akým náš mozog reaguje na nárast dopamínu, ktorý súvisí s vášňou a pocitom eufórie.	Biologically speaking, the reasons romantic love fades may be found in the way our brains respond to the surge and pulse of dopamine that accompanies passion and makes us fly.	0.295862
Užívatelia kokaínu to opisujú ako jav tolerancie - mozog sa prispôsobí zvýšeným dávkam drogy.	Cocaine users describe the phenomenon of tolerance: The brain adapts to the excessive input of the drug.	0.47037
Možno neuróny zostanú znecitlivené a potrebujú stále viac a viac produkovať dopamín – obrazne povedané, uvoľňovať pocity šťastia.	Perhaps the neurons become desensitized and need more and more to produce the high—to put out pixie dust, metaphorically speaking.	0.297321
Možno je dobré, ak sa romantika vytratí.	Maybe it‘s a good thing that romance fizzles.	0.265714
Mali by sme železnice, mosty, lietadlá, faxy, vakcíny a televíziu, ak by sme boli stále všetci pobláznení?	Would we have railroads, bridges, planes, faxes, vaccines, and television if we were all always besotted?	0.3
Namiesto stále sa rozvíjajúcej technológie, ktorá ľudskú kultúru poznačila už z čias prvého použitia nástroja, by sme mali len cukríky, kytice a antikoncepciu.	In place of the ever evolving technology that has marked human culture from its earliest tool use, we would have instead only bonbons, bouquets, and birth control.	0.3
Teraz vážne, ak je zmena chemického stavu vyvolaná romantickou láskou, podobná duševnej chorobe alebo eufórii spôsobenou drogami, dlhodobé vystavovanie sa jej, môže spôsobiť psychické poškodenie.	More seriously, if the chemically altered state induced by romantic love is akin to a mental illness or a drug-induced euphoria, exposing yourself for too long could result in psychological damage.	0.292857
Dobrý sexuálny život môže byť taký silný ako Pattex, ale kto by chcel mať takúto vec na vlastnej koži?	A good sex life can be as strong as Gorilla Glue, but who wants that stuff on your skin?	0.240845
Kde bolo tam bolo, v Indii sa chlapec a dievča do seba zamilovali bez povolenia rodičov.	Once upon a time, in India, a boy and a girl fell in love without their parents‘ permission.	0.468362
Pochádzali z rozdielnych kást, ich vzťah bol radikálny a zakázaný.	They were from different castes, their relationship radical and unsanctioned.	0.243103
Predstavte si trblietavé sárí, chlapca v bielom plátne, tajné stretnutia na dlaždicových terasách s veľkým bielym mesiacom nad hlavou.	Picture it: the sparkling sari, the boy in white linen, the clandestine meetings on tiled terraces with a fat, white moon floating overhead.	0.294872
Kto by odopieral týmto milencom potešenie alebo odsudzoval silu ich vzájomnej príťažlivosti?	Who could deny these lovers their pleasure, or condemn the force of their attraction?	0.263014
Ich rodičia.	Their parents could.	0.125
V nedávnom incidente, rodičia vlastnými rukami obesili chlapca a dievča z rôznych kást a stovky dedinčanov sa tomu prizerali.	In one recent incident a boy and girl from different castes were hanged at the hands of their parents as hundreds of villagers watched.	0.436111
Pár, ktorý utiekol od rodičov, vyzliekli a zbili.	A couple who eloped were stripped and beaten.	0.269231
Ďalší pár spáchal samovraždu po tom, čo im ich rodičia zakázali sa zosobášiť.	Yet another couple committed suicide after their parents forbade them to marry.	0.286364
Antropológovia si mysleli, že romantika je výtvorom Západu, buržoázny vedľajší produkt stredoveku.	Anthropologists used to think that romance was a Western construct, a bourgeois by-product of the Middle Ages.	0.276136
Romantika bola pre sofistikovaných, konala sa v kaviarňach, pri káve a Cabernete, na hodvábnych prikrývkach alebo v izbách pri blikotajúcom ohni.	Romance was for the sophisticated, took place in cafés, with coffees and Cabernets, or on silk sheets, or in rooms with a flickering fire.	0.410502
Predpokladalo sa, že nezápadné kultúry s ich naviazaním na rodinné a spoločenské povinnosti, neboli príliš otvorené jednotlivým citom.	It was assumed that non-Westerners, with their broad familial and social obligations, were spread too thin for particular passions.	0.289474
Ako by kolektivistická kultúra mohla oslavovať alebo akokoľvek potrestať posadnutosť jednou osobou, ktorá je objektom lásky?	How could a collectivist culture celebrate or in any way sanction the obsession with one individual that defines new love?	0.282692
