Jedného dňa, asi o 5 miliónov rokov neskôr, v tomto Raji fúkal studený vietor.	One day, perhaps five million years later, a cold wind blew through this Eden.	0.3
Hladina morí klesla a výška snehovej pokrývky stúpla.	The seas receded, the ice caps expanded.	0.197143
Pri periodickom poklese morskej hladiny sa v podobe výbežku zeme vynoril most, po ktorom išlo pár odvážnych ľudoopov z Afriky.	A spit of land emerged from the tides, a bridge that a few adventurous apes followed out of Africa.	0.204878
Nomádi sa usadili v dažďových pralesoch, ktoré pokrývajú Euroáziu.	Nomads, wanderers, they settled in the rain forests that blanketed Eurasia.	0.264407
Ale ochladzovanie pokračovalo a tropické dažďové pralesy s ovocím nahradili listnaté lesy. ~~~ Lístie stromov sa na jeseň sfarbilo dočervena a potom opadlo.	But the cooling continued, replacing tropical groves of fruit with deciduous forests, where the leaves flame in autumn, then die.	-0.0310811
Nasledovalo obdobie hladomoru.	A time of famine followed.	0.221739
Lesy zaplnili hladujúce ľudoopy.	The woods filled with starving apes.	0.28
V určitom okamihu došlo u jedného z nich k mutácii, vysvetlil Johnson.		-0.3
Mutácia spôsobila, že sa z ľudoopa stal veľmi účinný výrobca fruktózy.	At some point a mutation occurred in one of those apes, Johnson explained.	0.290164
V jeho tele sa v podobe tuku ukladali dokonca aj malé množstvá fruktózy.	It made that ape a wildly efficient processor of fructose.	0.234
Bola to obrovská výhoda počas mesiacov, keď v krajine zavládol chlad a jedla bolo nedostatok.	Even small amounts were stored as fat, a huge survival advantage in months when winter lay upon the land and food was scarce.	0.3975
Ľudoop so zmutovaným génom a zdravou túžbou po vzácnom a drahom ovocnom cukre sa jedného dňa vrátil do svojho domova v Afrike. ~~~ Tam splodil ľudoopov, ktorých vidíme v dnešnej dobe, vrátane toho, ktorý po celom svete rozšíril potomstvo, ktoré miluje cukor.	Then one day that ape, with its mutant gene and healthy craving for rare, precious fruit sugar, returned to its home in Africa and begot the apes we see today, including the one that has spread its sugar-loving progeny across the globe.	-0.0160714
Mutácia bola takým silným faktorom na prežitie, že prežilo iba niekoľko zvierat. ~~~ V súčasnosti majú túto mutáciu všetky ľudoopy, vrátane ľudí.	The mutation was such a powerful survival factor that only animals that had it survived, Johnson said, so today all apes have that mutation, including humans.	-0.0120968
Našim predkom pomohla počas neúrodných rokov.	It got our ancestors through the lean years.	0.276316
Ale keď sa cukor dostal na Západ vo veľkom štýle, nastal rozsiahly problém.	But when sugar hit the West in a big way, we had a big problem.	0.216
Svet zaplavila fruktóza, ale ľudské telá boli vyvinuté tak, aby ju prijali len vo veľmi malom množstve.	Our world is flooded with fructose, but our bodies have evolved to get by on very, very little of it.	0.281928
Je to úžasná irónia: Práve tá vec, ktorá nás zachránila, nás nakoniec môže zabiť.	It’s a great irony: The very thing that saved us could kill us in the end.	0.255
Zdravý šéfkuchár	The Healthy Chef	0.28
Hoci má Nick Scurlock len 11 rokov, výborne reprezentuje priemerného Američana v cukrovej dobe.	Though just 11, Nick Scurlock is a perfect stand-in for the average American in the age of sugar.	0.692593
Reklamný pracovník a predavač cukríkov sú nadmieru výkonní v premene fruktózy na tuk. ~~~ Nickovi ju pumpujú do žily vo veľmi nízkych hodnotách.	Hyperefficient at turning to fat the fructose the adman and candy clerk pump into his liver at a low, low price.	0.0686293
Nick navštevuje piatu triedu, váži 61 kg a miluje sladký jed, ktorý ohrozuje jeho život.	One hundred thirty-five pounds in fifth grade, in love with the sweet poison endangering his life.	0.264
Keď sedel v jedálni, usmial sa a opýtal sa: Prečo také dobré veci škodia nášmu zdraviu?	Sitting in the lunchroom, he smiled and asked, Why are the good things so bad for you?	0.291549
Ale tento príbeh hovorí viac o sile ako o pokušení.	But this story is less about temptation than about power.	0.25814
V najlepšom prípade môže škola pomôcť deťom robiť lepšie rozhodnutia.	At its best, the school can help kids make better decisions.	0.241176
Pred niekoľkými rokmi sa v jedálni školy Kirkpatrick podávala pizza a obdĺžnikové sladké pečivo značky Pop-Tarts.	A few years ago Pop-Tarts and pizza were served at Kirkpatrick.	0.3
Teraz sa jedálny lístok zlepšil.	Now, across the district, menus have improved.	0.175862
Škola má aj záhradu, v ktorej sa pestujú plodiny pre miestnych obyvateľov, bežeckú dráhu pre študentov a verejnosť a nové ihrisko.	The school has a garden that grows food for the community, a walking track for students and the public, and a new playground.	0.552535
V určitom zmysle je boj v meste Clarksdale len ďalším začiatkom pokračujúceho konfliktu medzi cukrovými magnátmi a rezačmi cukrovej trstiny.	In a sense the struggle in Clarksdale is just another front in the continuing battle between the sugar barons and the cane cutters.	0.552987
Táto tragédia zasahuje viac chudobných ako bohatých, povedal mi Johnson.	It’s a tragedy that hits the poor much harder than it does the rich, Johnson told me.	0.271875
Ak ste bohatí a chcete sa zabaviť, môžete ísť na dovolenku, cestovať na Havaj a hocičo si kúpiť.	If you’re wealthy and want to have fun, you go on vacation, travel to Hawaii, treat yourself to things.	0.2775
Ale ak ste chudobní a chcete oslavovať, môžete len zájsť do obchodu za rohom a kúpiť si zmrzlinovú tortu.	But if you’re poor and want to celebrate, you go down to the corner and buy an ice-cream cake.	0.257143
Keď som sa opýtal Nicka, čím by chcel byť, keď vyrastie, odpovedal mi: Šéfkuchárom.	When I asked Nick what he wanted to be when he grew up, he said, A chef.	0.226316
Potom chvíľku rozmýšľal, pozrel sa na svoju mamu a opravil sa.	Then he thought a moment, looked at his mom, and corrected himself.	0.527358
Šéfkuchárom, ktorý pripravuje zdravú stravu, dodal.	A healthy chef, he said.	-0.0714286
Bezprostredným zdrojom informácií o Juliane z Norwichu je jej kniha, v ktorej sa s nami delí o množstvo významných udalostí z jej života. ~~~ Opisuje v nej i svoje myšlienky a pocity spojené so zjaveniami.	A direct source of information about Julian of Norwich is her book where she shares a number of crucial events of her life, her own thoughts and feelings in so far as they are related to the revelations.	-0.00359281
Juliana hovorí, že ešte pred samotnými zjaveniami si vyprosovala tri milosti.	Before the revelations took place Julian informs us that she had asked for three graces.	0.269118
Prvou bolo zachovať pamiatku Kristovho utrpenia, druhou fyzická bolesť a treťou tri rany symbolizujúce skutočnú kajúcnosť, milujúci súcit a neutíchajúcu túžbu po Bohu.	The first was the grace to have recollection of Christ’s Passion; the second was a bodily sickness, and the third was to have three wounds: true contrition, loving compassion and longing with her will for God.	0.365411
Boh jej želanie napokon vyslyšal a ako tridsaťročná vážne ochorela. ~~~ Z viacerých hľadísk jej choroba pripomínala Kristovo utrpenie.	When she was a little over thirty, God heard her prayer and sent her a bodily sickness that was in some aspects parallel to Christ’s Passion.	-0.0012931
Jej zdravotný stav bol až natoľko vážny, že na pár dní bola celkom paralyzovaná.	Her sickness was so serious that it made her paralyzed for a couple of days.	0.27619
Juliana bola dokonca presvedčená o svojej blížiacej sa smrti, a tak nechala zavolať kňaza, aby vykonal sviatosť pomazania chorých.	She actually believed that she was at the point of death and so a priest was called to administer the sacraments to her.	0.407576
Okrem matky opisuje aj ďalších ľudí prítomných pri jej smrteľnej posteli. ~~~ Nakoniec sa však Juliana z ťažkej choroby dostala.	She describes her mother along with other persons present at her bedside, but eventually she recovered from the sickness.	-0.00721154
V čase choroby Juliana ešte nebola pustovníčka. ~~~ To potvrdzuje aj fakt, že pri jej smrteľnej posteli boli jej príbuzní. ~~~ V pustovníckej cele, v ktorej žila, by totiž nemohla mať okolo seba všetkých svojich blízkych.	This observation about the presence of relatives at her deathbed favours the argument that at the time of her illness Julian was not yet a recluse, because she could not have had all these people present in an anchorhold.	-0.129577
Z tohto dôvodu sa domnievame, že do samotárskeho života sa rozhodla utiahnuť krátko po zjaveniach.	Therefore, we can assume that she decided to retire only after the revelations took place.	0.268831
Keď si Juliana myslela, že zomrie, jej bolesť zrazu pominula a znovu sa cítila zdravá ako predtým, obzvlášť v hornej časti tela.	At the moment when Julian thought she was going to die, her pain suddenly left her and she felt as sound as before, particularly in the upper part of her body.	0.238889
Neskôr pochopila, že choroba ako aj jej zázračné uzdravenie, boli pre ňu akousi Božou prípravou na prijatie zjavení.	She later came to the understanding that both the sickness and the miraculous cure were God’s preparation for her to receive the revelations.	0.24
Tie nasledovali hneď po vízii trpiaceho Krista, ktorú jej pripomenula Veronikina šatka uchovaná v Ríme.	These followed immediately afterwards with the vision of the suffering Christ, which reminded her of Veronica’s veil kept in Rome.	0.226667
Následne sa vynára otázka - odkiaľ Juliana vedela o šatke.	Here a question arises as to how she knew of the veil.	0.259091
Je možné, že videla jej rytinu v manuskripte, ktoré ju opisovali. ~~~ Na druhej strane tiež nemôžeme vylúčiť možnosť, že bola jednou z pútnikov idúcich do Ríma, kde mohla osobne vidieť šatku uchovávanú v chráme sv. Petra.	It is possible that she saw its engraving in a manuscript, but it is not excluded that she had personally journeyed as a pilgrim to Rome where she had seen the veil kept in St. Peter’s.	-0.0269531
Keď uprene hľadela na kríž, zrazu sa pred jej očami objavil duchovný a v tom momente sa pred ňou premenil samotný Kristus.	All of a sudden, as she was gazing at the crucifix the priest had placed before her eyes, there came a change in Christ’s appearance.	0.406905
Plný radosti ju začal učiť prostredníctvom vízií a slov.	He seemed joyful and started to teach her through visions and locutions.	0.220408
Zjavenie lásky a jej prijatie opisuje v druhej kapitole dlhšej verzie diela. ~~~ Z parížskeho rukopisu spomínaného diela sa dozvedáme, že dátum zjavenia, hoci je diskutabilný, pripadá na 13. mája 1373.	In Chapter II of the Long Text she writes of having received her Revelation of loveon May 13, 1373, as we read in the Paris manuscript of the Long Text, though even this date is debatable.	-0.0165584
Sloan vo svojich rukopisoch zase píše, že k zjaveniam došlo už 8. mája, teda na tretiu nedeľu po Veľkej noci v roku 1373.	In the Sloan Manuscripts it is said that the revelations took place on the May 8, which was the third Sunday after Easter in 1373.	0.529
V tretej kapitole nám Juliana hovorí, že vtedy mala tridsať a pol roka, to znamená, že sa narodila v decembri 1342.	And in Chapter III she tells us she was then thirty and a half years old, which means she must have been born in December 1342.	0.550852
Neskôr, na konci 15. zjavenia dlhšieho vydania, sa Juliana rozpamätáva, že všetky jej zjavenia začali približne ráno o štvrtej. ~~~ Vrátane 15. zjavenia všetky trvali až do tretej hodiny poobede.	Later on, at the end of Revelation XV of the Long Text, Julian recollects that the Showings began early in the morning, about 4 o’clock and lasted through fifteen revelations until 3 o’clock in the afternoon.	-0.00722892
Až krátko predtým, ako začalo posledné zjavenie, navštívil Julianu duchovný. ~~~ Povedala mu o svojich pochybnostiach, že všetky jej vízie boli možno len halucinácie.	Before the final Revelation XVI started, she was visited by a religious whom she told about her doubts that the visions might have been a hallucination.	-0.0175781
V tú noc sa jej snívalo, že k nej prišiel diabol a snažil sa ju zadusiť. ~~~ Vtom sa však zobudila a nasledovalo 16. zjavenie.	In the night that followed she had a dream in which the devil tried to choke her, and after she woke up the sixteenth Revelation followed.	0.0705882
Posledná vízia začínala slovami plnými radosti a pokoja: Náš Pán mi odhalil tieto slová veľmi pokorne bez toho, aby vydal zo seba čo i len hlas, či pohol perami. ~~~ Podobne ako predtým len sladko povedal: Vedz, že to, čo si dnes videla, nebola žiadna halucinácia. ~~~ Prijmi to, ver tomu a pevne sa toho pridŕžaj. ~~~ Buď pokojná, dôveruj tomu a nič ťa nepremôže.	The final vision opens with words of comfort and reassurance: Our Lord very humbly revealed words to me, without voice and without opening of lips, just as he had done before, and said very sweetly: Know it well, it was no hallucination which you saw today, but accept and believe it and hold firmly to it, and comfort yourself with it and trust in it, and you will not be overcome.	-0.182192
Jeho posledné slová ma dokonale uistili v tom, že je to práve náš Pán Ježiš, kto mi to všetko zjavil. (DV 314)	These last words were said to me to teach me perfect certainty that it is our Lord Jesus who revealed everything to me (LT 314).	0.51087
V konečnom dôsledku aj v úvode kratšej verzie od neznámeho autora sa píše, že v roku 1413 Juliana stále žila ako pustovníčka v Norwichi.	Finally, in the introduction to the Short Text, written probably by an anonymous scribe, it is said that in 1413 Julian still lived the life of a recluse in Norwich.	1.55947
Okrem toho jej posledný odkaz z roku 1429, podobne ako aj Blomfieldov dátum z roku 1443, nám dokazujú, že Juliana žila dlho. ~~~ Jej vek odhadujeme na takmer 100 rokov.	Besides, the last bequest made to her in 1429 and Blomfield’s date of 1443 show that she may have lived a very long life of almost one hundred years.	-0.0209016
Všetky vyššie uvedené informácie o Julianinom živote sú spoľahlivé.	This is all the sure information we have about Julian’s life.	0.253846
Žiaľ, nevieme, kde sa presne narodila a nepoznáme ani históriu jej rodiny. Neexistujú dokonca žiadne dostupné informácie týkajúce sa času a miesta jej smrti či pohrebu.	We do not know where she was born, what the history of her family was, nor is there any information available about the time and place of her death and burial.	0.267692
Nikde sa nezmienila ani o temnejších stránkach jej života, ktoré ju obklopovali.	She does not even mention any of the sad events that were taking place around her.	0.291176
Všetko, čo sa netýkalo posolstva Božej lásky, držala v tajnosti.	She remains completely silent about everything that has no bearing on her message of God’s love.	0.160714
Ďalšie poznatky o jej živote sú zväčša len dedukciami historikov vyplývajúcich z dostupných zdrojov.	All the extrasthat have been told about her life by the historians are mostly deductions based on the sources we have at our disposal.	0.218182
V konečnom dôsledku nepoznáme ani jej pravé meno.	We do not even know her real name.	0.139286
Je možné, že meno Juliana prevzala od sv. Juliána - patróna kostola, ktorému sa zasvätila ako pustovníčka.	She possibly took her name Julian from St. Julian, the patron saint of the Church to which she was attached as an anchoress.	0.26044
Možno povedať, že dotyčný svätý bol známy aj ako Julián Špitálnik. ~~~ Svätý Julián je patrónom prievozníkov od čias, kedy kostol stojí v blízkosti rieky Winsum, kam sa ľudia pri prechode na druhú stranu prepravovali pomocou trajektu.	It is likely that the saint in question was Julian the Hospitaller, the patron saint of ferrymen, since the Church stands near the River Wensum and there must have been a ferry to get across the river.	-0.0278571
Odvtedy, čo sa objavil rukopis, v ktorom sa dozvedáme o víziách až príliš podobných tým Julianiným, sa J. B. Holloway domnieva, že Julianino skutočné meno bolo Mary Westwick.	J. B. Holloway makes a hypothesis that Julian’s real name might have been Mary Westwick, since there is a manuscript that speaks of her having visions that are similar to Julian’s.	0.707712
Norwich je známy aj vďaka oblasti Westwick nachádzajúcej sa neďaleko hradu, ktorý bol istý čas obývaný židovskými rodinami.	There was a Westwick area in Norwich, near the Castle, that had once been inhabited by Jewish families.	0.388929
Nemožno vylúčiť, že i Juliana patrila do jednej z týchto rodín. ~~~ V roku 1290, keď boli Židia vyhnaní z Anglicka, museli mnohé rodiny konvertovať na kresťanstvo.	It is possible that Julian may have stemmed from one of these families that converted to Christianity when Jews were expelled from England in 1290.	-0.0157258
Nedostatok informácií o živote lady Juliany nie je pre nás žiadnym prekvapením.	But this lack of information about Julian’s life is not surprising.	0.243103
Vybrala si život pustovníčky, a preto sa aj snažila ostať v úzadí. ~~~ Uvedomovala si, že posolstvo skryté v zjaveniach je dôležitejšie než ona sama.	She chose the life of a recluse and intended to remain hidden, being aware that it was the message of the revelations that was important and not her person.	-0.0048
Preto radšej zabudni, aký som úbožiak, píše, konaj tak, nech nie som tvojou prekážkou a premýšľaj o Ježišovi, ktorý je učiteľom každého človeka. (KV 135)	Then will you soon forget me who am a wretch”, she writes, and do this, so that I am no hindrance to you, and you will contemplate Jesus, who is every man’s teacher(ST 135).	0.39
Tajomným životom a neustálym sa ukrývaním pred svetom sa Juliana snažila priblížiť k tajomnu a anonymite samotného Boha.	In this act of putting on a veil of concealment and anonymity, Julian points to the concealment and anonymity of God himself.	0.45501
Boh sa síce ukazuje svetu, ale stále ostáva skrytý ako tzv. Deus absconditus (Boh skrytý).	God reveals himself to the world, and yet he always remains a Deus absconditus.	0.455224
Podobným spôsobom sa stalo známym vo svete aj jej svedectvo. ~~~ Svojím poslaním pustovníčky a duchovnej matky sa nám snaží pripomenúť aj existenciu neviditeľného a nadpozemského sveta.	In a similar way, Julian’s work has been made known to the world, and yet in her vocation of an anchoress and spiritual mother she reminds us of the existence of an invisible and spiritual world.	0.0104051
Adrienne von Speyrová, švajčiarska mystička 20. storočia, ktorá konvertovala na katolícku vieru pod vedením editora väčšiny jej diel H. U. von Balthasara, nám v prvej časti knihy o svätých a ich živote v modlitbe s názvom Das Allerheiligenbuch (Kniha všetkých svätých, preložila S. Š. ) poskytuje vzácny náhľad do vnútorného života Juliany z Norwichu.	Adrienne von Speyr, a Swiss mystic of the XX century, who converted to Catholicism under the guidance of H. U. von Balthasar who edited most of her works, in the first part of her book on the saints and their life of prayer, Das Allerheiligenbuch, gives us a precious insight into the interior life of Julian of Norwich.	0.642045
V súčasnosti sa nám pustovnícky spôsob života môže zdať neobvyklý. ~~~ V ranom období cirkvi a v stredoveku však nebol žiadnym zriedkavým úkazom.	Today, the life of a recluse may seem somewhat unusual to us, but it was not a rare phenomenon in the early centuries of the Church and in the Middle Ages.	-0.00365854
Slovo pustovník je odvodené z gréckeho slovesa anachorein, čo v preklade znamená ustúpiť alebo vzdialiť sa.	The word anchoriteis derived from the Greek verb anachorein and means to retireor to withdraw”.	0.259756
Pustovník, či už muž alebo žena, sa vzďaľoval od sveta, aby mohol v pokoji viesť život pokánia a modlitby.	An anchorite, male or female, retired from the world to lead a life of penance and prayer.	0.410667
Tento samotársky životný štýl sa odvíjal z tradície prvých Otcov púšte, napr. Antona, Pavla Pustovníka, Makaria alebo Arsenia, ktorí sa snažili nájsť hlbšie spojenie s Bohom, a to tým spôsobom, že opustili hluk mesta a utiahli sa do púšte.	This solitary life–style developed from the tradition of the first Desert Fathers who, like Anthony, Paul the Hermit, Macarius or Arsenius, in their search for a deeper communion with God retreated to the desert, away from the noise of the city.	0.444059
Ich pustovnícky ideál opisovali v texte s názvom Vitas Patrum (Životy Otcov), ktorý podnietil príchod prvých pustovníčok známych ako Matky púšte.	Their hermitical ideal, narrated in a text known as Vitas Patrum, was soon to be followed by the first female anchoresses, known as Desert Mothers.	0.431525
K východnej kultúre patrí aj podobná zbierka výrokov a skutkov týchto svätých matiek s názvom Meterikon.	The eastern tradition has in its possession a similar collection of sayings and deeds of these holy mothers, called Meterikon.	0.592941
Navyše pustovnícky život žien má aj biblické opodstatnenie, a to v postave Anny, ktorá sa spomína v príbehu Obetovania Pána v chráme.	Moreover, the female anchoritic life has a scriptural foundation, namely, in the figure of Anna, mentioned in the scene of the Presentation of the Lord in the temple.	0.358753
Evanjelista Lukáš ju opisuje ako prorokyňu, čo môžeme v súčasnosti vyjadriť aj pojmom mystička, ktorá bola obdarovaná duchovným porozumením a víziami.	The evangelist Luke defines her as a prophetess”, which could be translated today in terms of a mysticendowed with spiritual understanding and visions.	0.434056
Z chrámu neodchádzala, vo dne i v noci slúžila Bohu pôstom a modlitbami (Lk 2, 36-37).	He tells us that she never left the Temple, and served God night and day with fasting and prayer (Lk 2, 36-37).	0.750245
Tento obraz nám ju vykresľuje ako pustovníčku v chráme, ktorá zasvätila svoj život Bohu a posväteniu kňazov.	This picture presents her as a recluse of the temple, who lived there for God and for the sanctification of the priests.	0.444086
V čase stredoveku došlo k znovuzrodeniu rehoľného a pustovníckeho života.	In the Middle Ages the monastic and anchoritic life experienced a revival.	0.56804
A. K. Warren, ktorý študoval posledné vôle a ich odkázané dedičstvo miestnym pustovníkom, píše, že v 14. storočí žilo v Anglicku približne 96 osamelých pustovníčok. V 15. storočí ich počet vzrástol na 1103 .	A. K. Warren, studying the wills with their bequests to local anchorites, estimates that in the 14th century there lived around 96 female anchorites in England alone, and in the 15th the number increased to 1103 .	1.66629
V tom čase mali rehoľníčky a pustovníčky na ľudí obrovský vplyv, pomáhali im prostredníctvom modlitieb, rád a útechy.	The nuns and anchoresses had an enormous impact on the people of that time and exercised a role of praying, counselling and reconciling.	0.416311
Niektoré významné ženy stredoveku dokonca plnili v cirkvi učiteľskú funkciu, ako napríklad Hildegarda z Bingenu, Matilda z Hackebornu, Gertrúda Veľká, Katarína Janovská a Katarína Sienská.	Some of the great women of the medieval ages had even a teaching role in the Church, like for example, Hildegard of Bingen, Mechtild of Hackeborn, Gertrude the Great, Catherine of Genoa and Catherine of Siena.	0.397203
Toto dokazuje, že ich utiahnutie sa do samoty nebolo žiadnym únikom pred službou ľuďom, či pred plnením funkcie duchovných matiek.	This shows that their withdrawal from the world was not an escape from serving the people and exercising the role of spiritual motherhood towards them.	0.257143
Zámerom pustovníčky nebolo pracovať len na vlastnom spasení, ale tiež modliť a kajať sa za ostatných.	The anchoress’ intent was not to work only for her own salvation, but to pray and do penance on behalf of others.	0.27931
Týmto spôsobom sa pustovnícky život stal akousi formou prežívania cudzieho utrpenia a spoluúčasti pri celkovom sprostredkovaní Krista.	In this way, the anchoritic life-style became a form of vicarious substitution, participating in the universal mediation of Christ.	0.453509
Z tohto dôvodu mali dôležité postavenie v spoločnosti. ~~~ Obyvatelia boli hrdí na to, že majú pustovníčku, ktorá za nich obetuje svoje každodenné modlitby.	Therefore they were given a high social status, for the citizens were proud to have a recluse who offered her daily prayers for them.	-0.0297297
Hlavný cieľ samotárskeho života uvádza aj sv. Aelred Rievaulx v jeho pravidlách pre pustovníkov nasledovne: Objím celý svet náručím plným tvojej lásky a pri tom rozmýšľaj a zablahoželaj dobru, rozjímaj a smúť za hriešnymi.	Aelred of Rievaulx, in his rule for recluses, indicates this essential point of the solitary life: Embrace the whole world with the arms of your love and in that act at once consider and congratulate the good, contemplate and mourn over the wicked.	0.358872
Vo svojom konaní pamätaj na trpiacich a utláčaných a súciť s nimi.	In that act look upon the afflicted and the oppressed and feel compassion for them…	0.225
Spomeň si na úbohosť chudobných, stonanie sirôt, opustenosť vdov, bolesť zarmútených, potreby cestujúcich, modlitby panien, nebezpečenstvo tých na mori, pokušenia mníchov, povinnosti prelátov, námahu tých, ktorí vedú vojnu. ~~~ Pre pustovníkov neexistovala nijaká všeobecná norma života.	In that act call to mind the wretchedness of the poor, the groans of the orphans, the abandonment of widows, the gloom of the sorrowful, the needs of travellers, the prayers of virgins, the perils of those at sea, the temptations of monks, the responsibilities of prelates, the labours of those waging Ancrene Riwle.	-0.00714286
Až v stredoveku bolo spísaných niekoľko pravidiel.	In the Middle Ages a number of such rules were written.	0.293333
Už v 9. storočí mních menom Grimlaic napísal Regula Solitarium a z 11. storočia pochádza pravidlo Aelreda Rievaulxa určené pre jeho sestru pustovníčku.	Already in the ninth century, a monk named Grimlaic wrote the Regula Solitarium and in the eleventh century we find the rule of Aelred of Rievaulx written for his anchoress sister.	0.751538
V 13. storočí bola napokon zostavená najznámejšia zbierka pravidiel pre pustovníkov pod názvom Ancrene Riwle alebo tiež Ancrene Wisse (Príručka pre pustovníkov).	Finally, in the thirteenth century the most famous collection of instructions for anchoresses, the so-called Ancrene Riwle or Ancrene Wisse was written.	0.801285
Nariadenie sa sústreďuje predovšetkým na vnútorný život pustovníka.		-0.3
Ako príklad života v rozjímaní uvádza evanjelický príbeh o Márii, ktorá sedela pri Ježišových nohách.		-0.3
Zdôrazňuje nasledovnú pasáž: Vy pustovníci, ste si privlastnili Máriinu úlohu, ktorú schválil náš Pán Starostlivosť o domácnosť je poslaním Marty, Máriinou úlohou je pokoj a oddych od všetkého hluku sveta, aby jej nebránil v počúvaní Božieho hlasu.	The Rule concentrates, above all, on the inner life of a recluse and sets up as an example of contemplative life the Gospel story of Mary who sat at Jesus’ feet and chose the better part: Ye anchorites have taken to yourselves Mary’s part, which our Lord himself commended…	0.360638
Pre pustovníčku ako Kristovu nevestu bola hlavnou cnosťou čistota.	Housewifery is Martha’s part, and Mary’s part is quietness and rest from all the world’s din, that nothing may hinder her from hearing the voice of God”.	-0.0508475
V Ancrene Riwle sa nachádza hneď niekoľko morálnych zásad, ktorých cieľom bolo vyhýbať sa pokušeniu.	As a bride of Christ, the essential virtue of the anchoress was chastity and there are many concrete precepts in the Ancrene Riwle that should help her avoid any violation of it.	0.464655
Kontakt s mužmi bol striktne obmedzený a ako svojho spovedníka si pustovníčka musela vybrať staršieho kňaza s dobrou povesťou.	Her contact with men was severely restricted and she was counselled to choose as her confessor an elderly priest of good reputation.	0.291743
Dokument tiež obsahuje aj praktické predpisy týkajúce sa vonkajšieho pustovníckeho života.	The document also gives practical instructions about the external life of an anchoress.	0.280263
Stanovuje presné predpisy týkajúce sa toho, čo by mala jesť a ako sa obliekať, kedy môže spať a akú formu by mali mať jej modlitby.	It sets down precise rules about what she should eat and wear, when she might sleep and what sort of prayers she should say.	0.282353
Ancrene Riwle tiež určuje, že pustovníčka môže v čase od Veľkej noci až do sviatku Povýšenia sv. Kríža v septembri konzumovať dve jedlá denne a po zvyšok roka a na všetky piatky môže jesť len jedenkrát za deň.	The Rule sets down that the anchoress could have two meals a day from Easter until Holy Cross Day in September, and only one meal the rest of the year and on all Fridays.	0.309627
Nemôže jesť mäso, okrem obdobia, keď je chorá.	She was allowed no meat except in time of illness.	0.285
Pokiaľ ide o oblečenie, nie je predpísaná žiadna špecifická farba, dôležité je len to, aby boli šaty jednoduché a v zime teplé.	As for the clothes, no particular colour is specified, but it is said only that it should be plain and warm in winter.	0.269072
Predpis je veľmi prísny, hoci na záležitostiach týkajúcich sa stravovania a odevu si až tak nezakladá.	The Rule is very severe, though, about any sort of unhealthy exaggeration, both in meals as well as in clothes.	0.282955
Pripomínajúc si známe slová sv. Pavla o láske v Prvom liste Korinťanom verš 13, autor Príručky pre pustovníkov hovorí: Aj keby som si spôsobil všetku bolesť a utrpenie, aké môže telo zniesť; a chudobným dal to, čo mám, no lásky k Bohu a blížnym by som nemal, v ňom a pre neho by bolo všetko stratené.	Recalling the famous words of St. Paul in 1 Cor 13 about love, the author of the Ancrene Riwle says: Though I inflicted upon my body all the pains and all the sufferings that a body could endure; and though I gave poor men all that I had; unless I had therewith love to God and to all men, in him and for him, it were all lost”.	0.333119
I keď pustovníčka nežila v rehoľnom spoločenstve, kde bol každodenný život podrobený disciplíne kláštorných zvykov, očakávalo sa od nej, že sa bude riadiť určitým harmonogramom modlitieb, rozjímania, práce ako aj oddychu.	Though the anchoress did not live in a monastic community where the daily life was regimented by monastic routine, she was supposed to follow a certain schedule of prayer, contemplation, work and rest as well.	0.272727
Akonáhle pustovníčka vstúpila do svojej pustovne, nemohla z nej už viac odísť, inak by jej hrozila exkomunikácia.	Once the anchoress entered her anchorhold, she was not allowed to leave it anymore on pain of excommunication.	0.287234
Pri odchode z pozemského sveta sa konali dokonca aj špeciálne obrady, akými boli zádušná omša či procesia k jej cele.	There was even a special enclosure rite celebrated at her departure from the world, such as a Requiem Mass and a procession to the cell.	0.257576
Potom hlavný kňaz, ktorým bol obyčajne miestny biskup alebo jeho zástupca, udelil pustovníčke posledné požehnanie, roztrúsil popol na jej hlavu i do jej cely a zamuroval ju.	Afterwards, the main celebrant, normally the local bishop or his representative, administered extreme unction to the anchoress, scattered ashes on her and her cell, and bricked her in.	0.27973
Odvtedy ju svet pokladal za mŕtvu.	She was considered dead to the world.	0.28
Pozostávala z niekoľkých izieb a bola postavená hneď vedľa kostola. ~~~ Jedno okno ju spájalo s kostolom, čo jej umožňovalo zúčastňovať sa na liturgických službách a druhé zase s okolitým svetom, kde si ľudia mohli chodiť po radu.	It consisted of a suite of rooms and was built next to the Church, with one window looking into the Church so that the anchoress could take part in the liturgical services and, with another window open to the world to allow people to come for counsel.	0.0434678
Jedna z izieb slúžila ako oratórium, kde sa pravidelne modlievala.	One of the rooms would serve as an oratory where daily prayers were said.	0.284483
Taktiež je možné, že pustovňa bola spojená so záhradou alebo dvorom.	There might even have been a garden or a courtyard attached to the anchorhold.	0.264407
Navyše, pustovníčka mohla mať aj slúžku, ktorá mala na starosti všetky úlohy súvisiace s domácnosťou.	Besides, the anchoress was allowed to keep a servant who would take care of all necessary provisions in the household.	0.259091
Na základe pravidiel obsiahnutých v Ancrene Riwle si dokážeme lepšie predstaviť Julianin život.	Following the guidelines of the Ancrene Riwle, we can easily imagine what the life of Julian looked like.	0.496429
Hoci nemáme žiadne informácie o čase, kedy vstúpila do pustovne, všetko nasvedčuje tomu, že to bolo krátko po tom, ako došlo k samotným zjaveniam. ~~~ Z testamentov sa dozvedáme, že od tých čias sa spolu so slúžkami Alice a Sarou rozhodla pre uzavretý život v cele susediacej s farským kostolom sv. Juliána z Norwichu, oproti domu Rádu sv. Augustína.	Though there is no information about the time she entered the anchorhold, it seems plausible that it was only after the revelations took place that she started to live an enclosed life, along with two maidservants, Alice and Sara, as we learn from the wills, in a cell adjacent to the parish Church of St. Julian at Norwich, opposite the house of the Augustinian Friars.	0.0522945
I keď sväté prijímanie mohla prijať len párkrát do roka, cez okno cely videla na oltár, a tak sa hocikedy mohla zúčastňovať na slávení svätej omše.	Though she was allowed to receive Holy Communion only a couple of times a year, through the window of her cell she could look onto the altar and participate in the celebration of Holy Mass.	0.330623
Väčšinu dňa sa modlila, rozjímala nad Bibliou a inými duchovnými či teologickými textami, spracovávala vlastné vízie a rozprávala sa s ľuďmi, ktorí potrebovali s niečím poradiť, ako napr. Margery Kempeová. ~~~ Kde bolo, tam bolo, bola raz krajina škriatkov. ~~~ Jej obyvatelia medzi sebou radi súperili.	She spent most of her day in prayer, in the contemplation of the Bible and other spiritual and theological texts, in editing her own visions, and in giving counsel to people, as the case of Margery Kempe shows.	-0.0694661
Jedného dňa sa škriatkovia zo Západnej ríše vracali z turnaja proti bratrancom z Jazernej ríše. ~~~ Tri dni a tri noci odpočívali v Doorskom lese. ~~~ Cez deň hodovali a celé noci pretancovali v mesačnom svite.	Once upon a time the fairies of the west, going home from a hurling-match with the fairies of the lakes, rested in Dooros Wood for three days and three nights.	-0.053047
Tancovali tak vytrvalo, až si zodrali topánočky a ešte týždeň po oslave mali obuvníčkovia plné ruky práce s výrobou náhradných. ~~~ Vtedy sa vo dne v noci z obuvníckych dielní všade navôkol rozliehal zvonivý zvuk kladiviek. ~~~ Buch- buch, buch-buch. ~~~ Škriatkovia si pochutnávali na červených bobuľkách, ktoré by ste si pri letmom pohľade mohli veľmi ľahko spliesť s plodmi jarabiny. ~~~ Tieto bobuľky sú čarovné a rastú iba v ríši škriatkov.	They spent the days feasting and the nights dancing in the light of the moon, and they danced so hard that they wore the shoes off their feet, and for a whole week after the leprechauns, the fairies’ shoemakers, were working night and day making new ones, and the rip, rap, tap, tap of their little hammers were heard in all the hedgerows.	-0.208723
Sú oveľa sladšie ako akékoľvek ovocie v našom svete. ~~~ Ak by bobuľu zjedol šedivý zhrbený starček, razom by omladol, zmužnel a zmocnel. ~~~ Ak by bobuľku zjedla chradnúca vráskavá starenka, omladla by, opeknela a zosilnela. ~~~ A keby z bobuliek odjedlo nepekné dievčatko, nevyrovnal by sa jej ani ten najkrajší kvet.	The food on which the fairies feasted were little red berries, and were so like those that grow on the rowan tree that if you only looked at them you might mistake one for the other; but the fairy berries grow only in fairyland, and are sweeter than any fruit that grows here in this world, and if an old man, bent and grey, ate one of them, he became young and active and strong again; and if an old woman, withered and wrinkled, ate one of them, she became young and bright and fair; and if a little maiden who was not handsome ate of them, she became lovelier than the flower of beauty.	-0.271079
Škriatkovia si bobuľky strážili tak starostlivo, ako si len lakomec stráži svoje zlato. ~~~ Ak niektorý z drobných obyvateľov opúšťal ríšu, musel pred kráľom i kráľovnou prisahať, že ani jedna bobuľka sa nedostane do rúk smrteľníkov a ani jedna nespadne na zem. Keby sa tak stalo, razom by na mieste vyrástol rozkonárený stromček rodiaci strapce bobuliek a nejeden smrteľník by ich mohol ochutnať.	The fairies guarded the berries as carefully as a miser guards his gold, and whenever they were about to leave fairyland they had to promise in the presence of the king and queen that they would not give a single berry to mortal man, nor allow one to fall upon the earth; for if a single berry fell upon the earth a slender tree of many branches, bearing clusters of berries, would at once spring up, and mortal men might eat of them.	0.00476744
Ale pri tancovačkách, zabávačkách, radostiach a bujarostiach v Doorskom lese sa ktorýsi škriatok, taký drobec, čo by sa sotva na prst zmestil, pozabudol a kdesi zapatrošil čarovnú bobuľku.	But it chanced that this time they were in Dooros Wood they kept up the feasting and dancing so long, and were so full of joy because of their victory over the lake fairies, that one little, weeny fairy, not much bigger than my finger, lost his head, and dropped a berry in the wood.	0.277522
Keď už bolo po zábavách a radovánkach, škriatkovia sa vrátili do svojej krajiny a stratu drobčekovej bobuľky odhalili až po týždni. ~~~ Teraz vám rozpoviem, ako na to prišli.	When the feast was ended the fairies went back to fairyland, and were at home for more than a week before they knew of the little fellow’s fault, and this is how they came to know of it.	0.0640722
Plánovala sa veľká svadba a kráľovná škriatkov poslala šesť sluhov do Doorskeho lesa, aby jej na výrobu šiat chytili päťdesiat motýľov so zlatými bodkami na fialových krídlach, päťdesiat bielych motýľov bez škvŕn a bodiek a päťdesiat motýľov zlatožltých ako prvosienky.	A great wedding was about to come off, and the queen of the fairies sent six of her pages to Dooros Wood to catch fifty butterflies with golden spots on their purple wings, and fifty white without speck or spot, and fifty golden, yellow as the cowslip, to make a dress for herself, and a hundred white, without speck or spot, to make dresses for the bride and bridesmaids.	0.350238
Na šaty pre nevestu a družiĉky museli pochytať sto bielych motýľov bez škvŕn a bodiek.	When the pages came near the wood they heard the most wonderful music, and the sky above them became quite dark, as if a cloud had shut out the sun.	0.294349
Keď sa sluhovia blížili k lesu, začuli prenádhernú hudbu. ~~~ Zrazu sa obloha nad nimi zatiahla, akoby mrak zakryl slnko.	They looked up, and saw that the cloud was formed of bees, who in a great swarm were flying towards the wood and humming as they flew.	-0.0102941
Pozreli nahor, no namiesto mračna uvideli obrovský bzučiaci roj včiel ako letí lesom. ~~~ Veľmi ich vystrašil a triasli sa, až kým sa včely neusadili na strome.	Seeing this they were sore afraid until they saw the bees settling on a single tree, and on looking closely at the tree they saw it was covered with fairy berries.	0
Keď sa mu však bližšie prizreli, uvideli strom posiaty čarovnými bobuľkami. ~~~ Včely si škriatkov nevšímali a sluhovia sa prestali báť.	The bees took no notice of the fairies, and so they were no longer afraid, and they hunted the butterflies until they had captured the full number of various colours.	-0.0284483
Usilovne hľadali motýle, kým nepochytali dosť z každého druhu. ~~~ O včelách a bobuľkách utekali povedať kráľovnej.	Then they returned to fairyland, and they told the queen about the bees and the berries, and the queen told the king.	-0.00309278
Tá hneď správu zvestovala kráľovi. ~~~ Kráľ sa veľmi nahneval. ~~~ Vyslal poslov do každého kúta ríše, aby pred neho zvolali poddaných, lebo čím skôr chcel nájsť vinníka.	The king was very angry, and he sent his heralds to the four corners of fairyland to summon all his subjects to his presence that he might find out without delay who was the culprit.	-0.135455
Zhromaždili sa všetci, okrem drobčeka, ktorému bobuľka spadla. ~~~ Pravdaže bolo každému jasné, že len vinník nemá odvahu ukázať sa.	They all came except the little weeny fellow who dropped the berry, and of course every one said that it was fear that kept him away, and that he must be guilty.	-0.0238938
Poslovia sa ho hneď vydali hľadať. ~~~ Zanedlho ho našli skrývať sa v papradí a predviedli ho pred kráľa.	The heralds were at once sent in search of him, and after a while they found him hiding in a cluster of ferns, and brought him before the king.	-0.0453297
Úbohý škriatok sa tak veľmi bál, že by zo seba len ťažko vydal hláska, ale po chvíľke sa odhodlal prehovoriť. ~~~ Povedal, že nikdy nestratil ani jednu bobuľku, až kým sa po oslave nevrátil do ríše.	The poor little fellow was so frightened that at first he could scarcely speak a word, but after a time he told how he never missed the berry until he had returned to fairyland, and that he was afraid to say anything to anyone about it.	-0.0266871
Vtedy zistil, čo vykonal a bál sa priznať. ~~~ Kráľ nechcel výhovorky ani počuť a potrestal malého vinníka vyhostením do krajiny obrov za horami, aby tam našiel strážcu čarovného stromu.	The king, who would hear of no excuse, sentenced the little culprit to be banished into the land of giants beyond the mountains, to stay there for ever and a day unless he could find a giant willing to go to Dooros Wood and guard the fairy tree.	0.0280544
Po vynesení rozsudku sa ríša škriatkov ponorila do smútku, pretože si tohto mužíčka všetci obľúbili.	When the king had pronounced sentence everyone was very sorry, because the little fellow was a favourite with them all.	0.251724
Žiadny harfista na harfe, žiadny gajdoš na gajdách, ani žiadny huslista na husličkách nehral tak ľubozvučne, ako hral tento drobček na brečtanovom liste. ~~~ Pri spomienke na všetky tie nádherné noci, ktoré pretancovali pri jeho muzike, a pri predstave, že im už nikdy nebude do tanca vyhrávať, ich zaboleli srdiečka.	No fairy harper upon his harp, or piper upon his pipe, or fiddler upon his fiddle, could play half so sweetly as he could play upon an ivy leaf; and when they remembered all the pleasant moonlit nights on which they had danced to his music, and thought that they should never hear or dance to it any more, their little hearts were filled with sorrow.	-0.0100746
Tak ako poddaní, aj kráľovná žialila, ale kráľovmu rozkazu sa nemohla vzoprieť.	The queen was as sad as any of her subjects, but the king’s word should be obeyed.	0.291045
Nastal čas drobčekovho odchodu. ~~~ Kráľovná za ním poslala sluhu s plnou hrsťou ĉarovných bobuliek.	When the time came for the little fellow to set out into exile the queen sent her head page to him with a handful of berries.	-0.0261628
Obri niesli odkaz, že tieto dobroty bude môcť strážca čarovného stromu jesť od svitu do mrku. ~~~ Vydal sa na cestu a takmer všetci kamaráti ho nasledovali k hraniciam ríše.	These the queen said he was to offer to the giants, and say at the same time that the giant who was willing to guard the tree could feast on berries just as sweet from morn till night.	-0.00416667
Keď ho videli stúpať ku krajine obrov, sňali si červené čiapočky a mávali mu, kým sa im nestratil z dohľadu. ~~~ Putoval dňom i nocou a na svitaní bol už na vrchole hory.	As the little fellow went on his way nearly all the fairies followed him to the borders of the land, and when they saw him go up the mountain towards the land of the giants, they all took off their little red caps and waved them until he was out of sight.	-0.0728261
Uvidel krajinu obrov v údolí rozprestierajúcom sa ďaleko pod ním. ~~~ Ešte pred zostupom sa obrátil, aby poslednýkrát uzrel svoju milovanú ríšu, ale veľké mračno mu zabránilo vo výhľade.	On he went walking all day and night, and when the sun rose on the morrow he was on the top of the mountain, and he could see the land of the giants in the valley stretched far below him.	-0.0090604
Bol veľmi smutný, unavený a malé nôžky ho už nevládali niesť.	Before beginning his descent he turned round for a last glimpse of fairyland; but he could see nothing, for a thick, dark cloud shut it out from view.	0.134615
Ako sa predieral nerovným povrchom hôr, myslel iba na mäkkučký zelený les a machom obrastené chodníčky utešenej krajiny, ktorú opustil. ~~~ Škriatka prebudilo chvenie zeme a začul ohlušujúci zvuk ako hrom.	He was very sad, and tired, and footsore, and as he struggled down the rough mountain side, he could not help thinking of the soft, green woods and mossy pathways of the pleasant land he had left behind him.	-0.00441176
Zdvihol zrak a uvidel, ako k nemu prichádza hrôzostrašný obor.	When he awoke the ground was trembling, and a noise that sounded like thunder fell on his ears.	0.433838
Uprostred čela mal jedno oko blčiace ako žeravé uhlíky, ústa široké od ucha k uchu, dlhé krivé zuby, pleť čiernu ako noc, hruď aj ruky zarastené čiernymi hustými chlpmi a okolo tela opásaný železný remeň, z ktorého visel ozrutný kyjak so železnými hrotmi. ~~~ Jedným švihnutím kyjaka mohol rozbiť kameň na márne kúsky.	He looked up and saw coming towards him a terrible giant, with one eye that burned like a live coal in the middle of his forehead, his mouth stretched from ear to ear, his teeth were long and crooked, the skin of his face was as black as night, and his arms and chest were all covered with black, shaggy hair; round his body was an iron band, and hanging from this by a chain was a great club with iron spikes.	-0.0360902
Oheň by ho nepopálil, voda by ho nepotopila a ani žiadna zbraň by ho nezranila. ~~~ Nič by ho neznieslo zo sveta, iba tri údery tohto kyjaka.	With one blow of this club he could break a rock into splinters, and fire could not burn him, and water could not drown him, and weapons could not wound him, and there was no way to kill him but by giving him three blows of his own club.	0.0271739
Bol taký zlostný, že ho obri volali Šarvan Mrzutý.	And he was so bad-tempered that the other giants called him Sharvan the Surly.	0.139535
Keď obor uvidel škriatkovu červenú čiapočku, vydal zo seba výkrik ohlušujúci ako hrom.	When the giant spied the red cap of the little fairy he gave the shout that sounded like thunder.	0.28
Úbohý škriatok sa celý roztriasol od strachu.	The poor fairy was shaking from head to foot.	0.284211
Čo ťa sem privádza? okríkol ho obor.	What brought you here? said the giant.	0.280645
Prosím, pán obor, odpovedal škriatok, kráľ škriatkov ma sem vyhnal a musím tu zostať, kým neprídete a nebudete strážiť čarovný strom v Doorskom lese.	Please, Mr. Giant, said the fairy, the king of the fairies banished me here, and here I must stay for ever and a day, unless you come and guard the fairy tree in Dooros Wood.	0.386929
Kým čo? zreval obor a nohou sotil mužíčka, až sa skotúľal z kopca.	Unless what? roared the giant, and he gave the fairy a touch of his foot that sent the little fellow rolling down head over heels.	0.230649
Chudák škriatok ležal na zemi ako mŕtvy. ~~~ Obra zamrzelo, čo vykonal a jemne škriatka chytil medzi palec a ukazovák.	The poor fairy lay as if he were dead, and then the giant, feeling sorry for what he had done, took him up gently between his finger and thumb.	-0.0257576
Neboj sa, maličký, prihovoril sa mu obor, a prezraď mi všetko o tom strome.	Don’t be frightened, little man, said he, and now, tell me all about the tree.	0.290476
Je to strom s ĉarovnými bobuľkami a rastie v Doorskom lese, povedal škriatok, niekoľko bobuliek mám aj so sebou.	It is the tree of the fairy berry that grows in the Wood of Dooros, said the fairy, and I have some of the berries with me.	0.290526
Ach, naozaj? spýtal sa obor.	Oh, you have, have you? said the giant.	0.204
Ukáž mi ich!	Let me see them.	0.218182
Škriatok vybral z vrecka zeleného kabátika tri bobuľky a podal ich obrovi.	The fairy took three berries from the pocket of his little green coat, and gave them to the giant.	0.220312
Obor si ich poobzeral.	The giant looked at them for a second.	0.12
Všetky naraz prehltol. ~~~ Okamžite ho zaplavil pocit šťastia a začal od radosti vykrikovať a tancovať.	He then swallowed the three together, and when he had done so, he felt so happy that he began to shout and dance for joy.	-0.0170455
Chcem viac, ty malý zlodej! skríkol.	More, you little thief! said he.	0.257143
Oveľa viac, ty malý – ako sa vlastne voláš? opýtal sa obor.	More, you little–––what’s your name? said the giant.	0.280435
Pinklík, prosím, pán obor, odvetil škriatok potom, ĉo sa zriekol všetkých bobuliek.	Pinkeen, please, Mr. Giant, said the fairy, as he gave up all the berries.	0.246774
Obor zreval ešte hlasnejšie ako predtým. ~~~ Výkriky tentoraz zaĉuli aj ostatní obri a hneď za ním bežali.	The giant shouted louder than before, and his shouts were heard by all the other giants, who came running towards him.	-0.0168539
Keď ich Šarvan uvidel prichádzať, dobehol Pinklíka a vložil si ho do kapsy, aby ho nikto z nich neuvidel.	When Sharvan saw them coming, he caught up Pinkeen, and put him in his pocket, that they shouldn’t see him.	0.296591
Prečo si tak reval? opýtali sa ho obri.	What were you shouting for? said the giants.	0.254545
Lebo mi tamtá skala spadla na nohu, odpovedal obor.	Because, said Sharvan, that rock there fell down on my big toe.	0.238636
Nekričal si ako niekto zranený, vyčítali mu obri.	You did not shout like a man that was hurt, said they.	0.293023
A ako som, podľa vás, kričal? oboril sa na nich Šarvan.	What is it to you what way I shouted? said he.	0.227027
Mohol by si odpovedať slušne na slušnú otázku? napomenuli ho. Ty vždy ostaneš Šarvan Mrzutý, dodali a odišli.	You might give a civil answer to a civil question, said they; but sure you were always Sharvan the Surly; and they went away.	0.425637
Keď už boli obri v nedohľadne, Šarvan vybral Pinklíka z kapsy.	When the giants were out of sight, Sharvan took Pinkeen out of his wallet.	0.249057
Daj mi viac bobúľ, ty malý zlodej – myslím tým malý Pinklík, okríkol ho obor.	Some more berries, you little thief––I mean little Pinkeen, said he.	0.274576
Viac už nemám, odvetil Pinklík, ale ak sa staneš strážcom stromu v Doorskom lese, môžeš sa na nich hostiť od svitu do mrku.	I have not any more, said Pinkeen; but if you will guard the tree in Dooros Wood you can feast on them from morn till night.	0.294
Budem strážiť všetky stromy v lese, ak budem môcť jesť bobule, vyhlásil obor.	I’ll guard every tree in the wood, if I may do that, said the giant.	0.24
Musíš strážiť iba jeden, poznamenal Pinklík.	You’ll have to guard only one, said Pinkeen.	0.284211
Ako sa k nemu dostanem? opýtal sa Šarvan.	How am I to get to it? said Sharvan.s	0.25
Najskôr so mnou musíš ísť k ríši škriatkov, odpovedal drobĉek.	You must first come with me towards fairyland, said the fairy.	0.29434
Dobre teda, povedal Šarvan, poďme!	Very well, said Sharvan; let us go.	0.29
Strčil si škriatka do kapsy a zakrátko prišli na vrchol hory. ~~~ Obor sa ešte raz obzrel na svoju krajinu, ale čierny mrak mu zabránil vo výhľade.	And he took up the fairy and put him into his wallet, and before very long they were on the top of the mountain.	-0.0485294
Na údolie rozprestierajúce sa pred ním dopadali slnečné lúče a v diaľke videl zelené lesy a ligotajúce sa vody ríše škriatkov.	Then the giant looked around towards the giant’s land; but a black cloud shut it out from view, while the sun was shining on the valley that lay before him, and he could see away in the distance the green woods and shining waters of fairyland.	0.17842
Neprešlo veľa času a prišiel k hraniciam ríše, ale keď sa ich pokúsil prekročiť, nohy sa mu zaborili do zeme a nemohol sa ani len pohnúť.	It was not long until he reached its borders, but when he tried to cross them his feet stuck to the ground and he could not move a step.	0.400102
Šarvan vydal tri prenikavé výkriky, ktoré sa rozľahli celou ríšou, až sa stromy zatriasli, akoby sa lesom prehnala zúrivá víchrica.	Sharvan gave three loud shouts that were heard all over fairyland, and made the trees in the woods tremble, as if the wind of a storm was sweeping over them.	0.257522
Ach, prosím vás, pán obor, pustite ma von! prosíkal Pinklík.	Oh, please, Mr. Giant, let me out, said Pinkeen.	0.219512
Šarvan vybral mužíčka z kapsy. ~~~ Ten, hneď ako zbadal, že je na hraniciach milovanej ríše, utekal, čo mu nohy stačili. ~~~ Ani len pár krokov neprešiel a stretol všetkých kamarátov, ktorí sa hrnuli z papradia zistiť, kto to tak kričal.	Sharvan took out the little fellow, who, as soon as he saw he was on the borders of fairyland ran as fast as his legs could carry him, and before he had gone very far he met all the little fairies who, hearing the shouts of the giant, came trooping out from the ferns to see what was the matter.	-0.141071
Pinklík im vysvetlil, že výkriky patrili strážcovi čarovného stromu, ktorý na hraniciach zapadol hlboko do zeme a ktorého sa nemusia báť.	Pinkeen told them it was the giant who was to guard the tree, shouting because he was stuck fast on the borders, and they need have no fear of him.	0.297458
Škriatkovia sa veľmi tešili, že sa im Pinklík vrátil. ~~~ Zodvihli ho na plecia a niesli ho do kráľovského paláca. ~~~ Všetci harfisti, gajdoši a huslisti pochodovali pred nimi a hrali tú najveselšiu hudbu, akú ste kedy počuli.	The fairies were so delighted to have Pinkeen back again, that they took him up on their shoulders and carried him to the king’s palace, and all the harpers and pipers and fiddlers marched before him playing the most jocund music that was ever heard.	-0.145775
Kráľ s kráľovnou boli na trávniku pred palácom, keď k nim natešený sprievod dorazil.	The king and queen were on the lawn in front of the palace when the gay procession came up and halted before them.	0.2125
Kráľovnine oči sa rozžiarili radosťou, keď zbadala svojho malého obľúbenca. ~~~ Aj kráľ sa v hĺbke srdca zaradoval, ale vyzeral veľmi vážne, keď vyhlásil: Prečo si sa vrátil, chlapče?	The queen’s eyes glistened with pleasure when she saw the little favourite, and the king was also glad at heart, but he looked very grave as he said: Why have you returned, sirrah?	-0.00604027
Pinklík oznámil jeho veliĉenstvu, že z ríše obrov priviedol strážcu čarovného stromu.	Then Pinkeen told his majesty that he had brought with him a giant who was willing to guard the fairy tree.	0.248
Kto je to a kde je? opýtal sa kráľ.	And who is he and where is he? asked the king.	0.203571
Obri ho volajú Šarvan Mrzutý, odpovedal Pinklík, a teraz je pred bránami ríše uväznený v zemi.	The other giants called him Sharvan the Surly, said Pinkeen, and he is stuck fast outside the borders of fairyland.	0.23625
V poriadku, vyhlásil kráľ, je ti odpustené.	It is well, said the king, you are pardoned.	0.291892
Keď to škriatkovia počuli, vyhodili červené čiapoĉky do vzduchu a zajasali tak hlasno, že včela, čo visela na ružovom púčiku, spadla omráčená na zem.	When the fairies heard this they tossed their little red caps in the air, and cheered so loudly that a bee who was clinging to a rose-bud fell senseless to the ground.	0.516378
Kráľ jednému zo sluhov rozkázal, aby Šarvanovi zaniesol za hrsť bobuliek a ukázal mu cestu do Doorskeho lesa.	Then the king ordered one of his pages to take a handful of berries, and to go to Sharvan and show him the way to Dooros Wood.	0.432088
Ten sa s bobuľami vybral za Šarvanom, ktorého rev chudáka škriatka vyplašil takmer na smrť.	The page, taking the berries with him, went off to Sharvan, whose roaring nearly frightened the poor little fellow to death.	0.196154
Hneď ako obor ochutnal sladké plody, jeho nálada sa vylepšila a spýtal sa sluhu, či môže zrušiť moc kúzla.	But as soon as the giant tasted the berries he got into good humour, and he asked the page if he could remove the spell of enchantment from him.	0.205618
Áno, môžem, prisvedčil škriatok, a aj tak urobím, ak sľúbiš, že sa nepokúsiš prekročiť prah našej ríše.	I can, said the page, and I will if you promise me that you will not try to cross the borders of fairyland.	0.293023
Z celého srdca ti to sľubujem, povedal obor.	I promise that, with all my heart, said the giant.	0.268421
Ale ponáhľaj sa, môj maličký, lebo si už nohy necítim.	But hurry on, my little man, for there are pins and needles in my legs.	0.221739
Škriatok odtrhol prvosienku a z kalíšteka vytrhol päť karmínovočervených lupienkov. ~~~ Jeden hodil smerom na sever, druhý na juh, tretí na východ, štvrtý na západ a posledný vyhodil vysoko do nebies.	The page plucked a cowslip, and picking out the five little crimson spots in the cup of it, he flung one to the north, and one to the south, and one to the east, and one to the west, and one up into the sky, and the spell was broken, and the giant’s limbs were free.	0.0343697
Kúzlo sa stratilo a obor si konečne vyslobodil nohy. ~~~ Potom sa Šarvan s drobným sluhom vydali do Doorskeho lesa a zakrátko zbadali čarovný strom.	Then Sharvan and the fairy page set off for Dooros Wood, and it was not long until they came within view of the fairy tree.	-0.036
Keď Šarvan uvidel čarovné bobuľky ligotajúce sa na slniečku, zakvílil tak nahlas a silno, až škriatka odfúklo späť do ríše.	When Sharvan saw the berries glistening in the sun, he gave a shout so loud and strong that the wind of it blew the little fairy back to fairyland.	0.4
Ale musel sa vrátiť do lesa, aby obrovi pripomenul, že cez deň musí sedieť pri kmeni stromu, pripravený bojovať s každým, kto by sa ulakomil na bobuľky a v noci musí spať v korune stromu.	But he had to return to the wood to tell the giant that he was to stay all day at the foot of the tree ready to do battle with anyone who might come to steal the berries, and that during the night he was to sleep amongst the branches.	0.320996
Dobre teda, zamrmlal obor s plnými ústami bobuliek.	All right, said the giant, who could scarcely speak, as his mouth was full of berries.	0.12
