"Avšak aj trochu osamelé."	"It’s kind of lonely, though.”	0.2625
Aspoň máme jedna druhú.	"At least you have me.”	0.285
Máš pravdu, skonštatovala.	"I guess so,” she said.	0.225
"Vždy lepšie ako nič."	"That’s better than nothing.”	0.195
Zhodila som Melanie na zem a ďalších desať minút sme sa ohadzovali vypchatými zvieratami.	I tackled her to the ground and we spent the next ten minutes hitting each other with stuffed animals.	0.268831
Moja sestra vždy zomrie skôr, než nastane koniec sveta.	My sister always dies before the world ends.	0.221053
Obloha je zničená jazvami môjho úsilia a ja som taká strašne vyčerpaná.	The sky is marred with the scars of my efforts, and I am so, so tired.	0.273214
V žilách mi vyčíňa búrka. ~~~ Nasleduje ďalší kolobeh z mnohých.	The storm hums in my veins, one more cycle in many.	-0.0428571
Už ich nemôžem ani spočítať, pravdepodobnosti sa neustále utvárajú a každým možným nádychom pribúdajú nové.	I can’t count them anymore, numbers constantly in flux, ticking higher with each potential breath.	0.268235
Zaujímalo by ma, či sa tak Melanie cítila každý deň vo svojom živote.	I wonder if this is what Melanie felt like every day of her life, so ripe with power, always at the precipice, always afraid to push in fear of making things worse.	0.121182
Plná moci, avšak uväznená na okraji priepasti s pocitom strachu, že svojimi činmi môže všetko pokaziť.	This time around, I’m on the floor of my apartment, staring at my cell phone in my hand.	0.233333
Tentoraz sedím na podlahe svojho bytu a zízam na mobil.	My roommate is out and I’ve already missed my flight home.	0.287234
Spolubývajúci išiel von a ja som práve zmeškala let domov.	I let it pass, money evaporating into the void, meaningless.	0.560727
Na všetko som sa vykašľala. ~~~ Niekde na juhozápade Melanie vychádza z domu, sama a opustená a jej srdce besnie divokým ohňom.	Somewhere in the southwest, Melanie is walking out of the house, or is about to, her heart roaring with wildfire, lonely, alone.	0.0382353
Iskry jej v dlaniach tancujú do fialova a blesky pripomínajúce žily, jej po rukách blúdia hore dole.	The sparks dance purple in her hands, lightning like veins through her arms.	0.207692
Nemôžeš to napraviť.	You can’t fix this.	0.264706
Nikdy to nebolo v tvojich silách.	It was never yours to control.	0.693956
Moje ruky však šmátrajú po dotykovej obrazovke a mokré palce mi v kontaktoch kĺžu po jej tvári.	But my hands fumble over the touch screen, thumbs sliding wet over her face on the contact screen.	0.2925
Je nastavená na tú istú sprostú zvučku, ktorú mám v mojom mobile, a stupídne vyzváňa umelými hlasmi a predvoleným zvukom.	She’s programmed in the same stupid anime ringtone I have on my phone, and it jingles inanely, all synthetic voices and pre-ordained sound.	0.256311
A ja čakám, mám sucho v ústach a moje telo sa chveje ako obloha pred dažďom nad Mohavskou púšťou.	I wait, mouth dry, my body shaking like the sky above the Mojave before it rains.	0.241791
Reťazce udalostí sa žiarivými horúčkovitými údermi splietajú v mojej hlave ako veniec zo sedmokrások.	Painted in brilliant, feverish strokes in my head, the daisy chain grows.	0.17619
CIVILIZÁCIA je stav človeka.	CIVILIZATION is the state of man.	0.265385
Zákony jeho prirodzenosti ho predurčujú k tomu, aby zdolával výšiny v závislosti od svojej predstavivosti.	Man of all creatures is destined by the laws of his very nature to scale the heights according to his capacities for vision.	0.267742
Celý život strávi hľadaním vzťahov s okolitým svetom.	His life is spent in seeking relations to the outside world.	0.274468
Život – bytie, prispôsobovanie sa, premena, je proces, v ktorom sa vnútorné sily človeka stretávajú s ťažko zvládnuteľnými silami vonkajšieho prostredia.	Living – being, adapting, becoming – is a process wherein man"s inherent forces meet effectively the challenging forces of the outside world.	0.404132
Pri snahe človeka dosiahnuť svoj cieľ sa zo života stáva sled konfliktov.	Living becomes a series of conflicts in man"s striving toward a goal.	0.279661
Nie sú to však konflikty len medzi človekom a jeho okolím, ale aj konflikty vo vnútri samotného človeka – medzi inštinktívnymi požiadavkami rozličných síl v jeho zložitej prirodzenosti.	But there is conflict not only between man and his world, but within man himself – between the instinctive demands of the various powers of his complex nature.	0.344802
O čo jednoduchší by bol život človeka, keby jeho vzťahy k svetu a sebe samému pripomínali vzťahy v rastlinnej a živočíšnej ríši! Tie sú totiž nemenné a zabezpečuje ich inštinktívna prirodzenosť daného organizmu.	How much simpler human life would be if man"s relations to his world and himself were like those in the plant or animal order, where relations are fixed and realized by an instinctive functioning of the creature"s nature!	0.379902
Riešenie ľudských problémov si však vyžaduje vyššie sily, a to najmä sebapoznanie.	But this solution of man"s problems calls for powers of a higher order, demanding knowledge of himself.	0.464103
Človek sa musí vidieť a vnímať ako živočích, človek, jednotlivec, umelec a ako člen spoločnosti.	He must understand and know himself as an animal, as a man, as an individual, as an artist, and as a member of society.	0.624398
Jeho prvotná prirodzenosť sa bude chápať ako lietadlo, ktoré riadia inštinktívne impulzy.	His primary nature will be understood as the plane where instinctive impulses operate.	0.284
Tieto impulzy sú silné sklony k činnosti, sú to pramene budúceho správania.	The impulses are powerful tendencies to action: they are the springs of future conduct.	0.484615
Sú to sily, ktoré musí človek trénovať, aby mohli slúžiť vôli a túžbam intelektu poháňaného ideálmi.	They are forces that need to be trained to serve the will and desires of an intellect impelled by ideals, so that man can bring all his powers to bear upon the life of his choice.	0.270657
Človek potom môže použiť všetky svoje sily, aby mohol žiť život podľa seba. ~~~ Základom duševnej a telesnej činnosti je nájsť vnútorný mier a dostatočne sa prispôsobiť životu okolo nás.	Finding peace within ourselves and bringing about an adequate adjustment to his life around us are the bases of all mental and physical activity.	-0.0414634
Celý život je proces riešenia problémov, ktoré si uvedomujeme.	All living is a process of solving problems as we become aware of them.	0.278182
Riešenie problémov je základom kreatívnej aktivity a je nevyhnutné vo všetkých oblastiach života, ako napr. práca, zábava a umenie.	Problem-solving is the basis of creative activity and is essential to all walks of life – work, play, and art.	0.228261
Akékoľvek umelecké dielo sa začína cieľom a rastie technikou.	Any work of art begins with a purpose and grows through technique.	0.588889
V tanci, tak ako v každom umení, je nevyhnutné trénovať myseľ tak, aby niečo používala ako nástroj, pomocou ktorého by nejaký prostriedok pretvárala do formy umenia.	In dance, as in every art, it is essential to train the mind to use some tool as an instrument with which to mold a medium into an art form.	0.222321
V tanci je nástrojom telo a prostriedkom pohyb.	In dance the body is employed as the instrument, and movement as the medium.	0.131707
Tanečník má preto na zreteli dva ciele.	Consequently, a dancer has two goals to keep in view.	0.202941
Po prvé musí trénovať myseľ, aby používala telo na vyjadrenie svojho stavu, keďže pri tanci ide najmä o kvality pocitov telesného pôvodu.	First, he must train the mind to use the body to reflect its conditions, for the primary concern of dance is the feeling tones of physical origin.	0.289744
Po druhé musí trénovať telo, aby reagovalo na vyjadrujúcu sa myseľ.	Second, he must train the body to be responsive to the expressive mind.	0.289655
Akékoľvek myšlienky a kvality pocitov, ktoré myseľ vyjadruje, musí telo precítiť.	Whatever thought and feeling tones are to be expresses must be felt through the body.	0.3
Preto nemožno prehliadať význam pocitov a emócií a ich schopnosť motivovať svalovú aktivitu.	Therefore the importance of feelings and emotions, and their power to motivate muscle activity, cannot be overlooked.	0.222222
Svaly sa sťahujú v pomere k intenzite emočného zážitku, ktorý chceme vyjadriť.	Muscles contract in proportion to the intensity of the emotional drive of the experience to be expressed.	0.202941
V nami zvolenom živote nás ženie dopredu vnútorná či hnacia sila. ~~~ Sídli v zložitom centre, ktoré vníma, premýšľa, zdôvodňuje, chápe, zapamätáva si, predstavuje si a vytvára. ~~~ Toto centrum sa nazýva myseľ.	This inner force, or motive power that drives us on in the life of our choosing, resides in that complex center which perceives, thinks, reasons, comprehends, remembers, imagines, and creates – the center we call mind.	-0.121854
V súčasnom vzdelávacom systéme sa jednotlivec považuje za rastúci a meniaci sa organizmus, ktorého myseľ sa čím ďalej tým viac stáva jeho najdominantnejšou črtou odlišujúcou ho od všetkých ostatných.	Contemporary education regards the individual as a growing, changing organism whose mind becomes increasingly his most distinctive and dominant characteristic.	0.3769
Slovo myseľ je abstraktný pojem.	The word mind is an abstract term.	0.3
Každá myseľ predstavuje jedinečné usporiadanie dojmov, intuícií a presvedčení, ktoré vyjadruje všetky zážitky.	Every mind is unique organization of impressions, intuitions, and beliefs which interprets all of experience.	0.290625
Reakcie jednej mysle budú odlišné od reakcií mysle, ktorá má inak usporiadané dojmy.	The reactions of one mind will be different from those of a mind that has differently organized impressions.	0.221918
Každý pocítený dojem sa uberá určitým smerom.	Every sensed impression takes its particular direction.	0.225
Buď ho zablokujú protidojmy, alebo sa zmieša s minulými dojmami a vytvorí určitý pocit alebo postoj.	Either it is arrested by counterimpressions, or it blends with past impressions and forms a definite feeling or attitude.	0.41368
Môžeme povedať, že sila mysle je stupeň sily stimulačných a regulačných procesov, ktoré nasledujú po vneme podnetu.	Power of mind may be said to be the degree of strength of the stimulative and regulative processes which follow upon the perception of a stimulus.	0.400667
Z toho dôvodu zážitky, ktoré človek dostatočne nevnímal, prispejú k prejavu menej, alebo k nemu neprispejú vôbec.	Therefore, experiences that have not been sufficiently perceived will contribute little or nothing toward expression.	0.281633
To, čo neurobí dojem, sa nemôže prejaviť.	What has not impresses cannot be expressed.	0.283333
Správne pracujúca myseľ neustále prijíma dojmy, asociuje ich, čistí, triedi a uvoľňuje. ~~~ Taktiež ich transformuje, aby mohli lepšie plniť svoj účel.	A properly functioning mind is constantly receiving impressions, associating them, refining them, selecting and releasing them, and do transforming them that they may better serve its purpose.	-0.0426923
Proces, pri ktorom človek zhromažďuje zážitky a koná činy, ktorými prejavuje pociťovanie, voľbu a vôľu, prebieha v nervovej sústave prostredníctvom mechanizmu podnet – reakcia.	The process whereby man gathers unto himself experience and performs acts manifesting sensation, choice, and volition, is accomplished through the nervous system by means of its stimulus-response mechanism.	0.249351
Na dosiahnutie týchto integrovaných reakcií sa používajú špeciálne prostriedky.	To achieve these integrated responses it employs special tools.	0.214286
Po prvé sú to zmyslové orgány alebo receptory, ktoré prijímajú informácie z vonkajšieho prostredia.	First of all there are those sense organs, or receiving organs (receptors), that pick up information from the outside world.	0.234483
Receptory sú koncové zmyslové štruktúry, ktoré sú prispôsobené na príjem rôznych foriem vonkajších podnetov a na ich prevod do formy, ktorú potom nervové vlákna prenesú do mozgu a miechy.	They are terminal sensory structures adapted to receive various forms of environmental stimuli and to transmit them to the brain in the form of nerve impulses.	0.244444
Vďaka nim sme schopní vžiť sa do každej životnej aktivity okolo nás.	Because of them we are able to "tune in” on all life"s activities around us.	0.274138
Tieto receptory sú jediným prostriedkom, pomocou ktorého sa sily vonkajšieho prostredia a tvorivé sily vo vnútri tela môžu dostať do centrálnej nervovej sústavy a aktivovať ju.	These receptors are the only media through which the forces of the world outside or the generating forces within the body can reach the central nervous system and bring it into activity.	0.292105
Iba prostredníctvom receptorov môžu tieto sily preniknúť do vedomia.	They are the only way such forces can attain awareness.	0.210638
V tomto zmysle sa môžu receptory chápať ako analyzátory nášho prostredia, ktoré ho rozdeľujú na súčasti. ~~~ Každý receptor je zameraný na určitý aspekt vonkajšieho a vnútorného prostredia.	In this sense, the receptors may be thought of as analyzers of our environment, splitting it up into its component parts, each particular receptor attuned to certain aspects of the external environment and the mileu intérieur.	-0.0277778
* Tento termín je použitý z dôvodu ľahšieho pochopenia. ~~~ Označuje duševný aspekt organizmu, nevyjadruje oddelenie mysle od tela.	*A term here used for convenience to designate the mental aspect of the total organism, and not to imply a separation of mind from body.	0
Okrem piatich najzákladnejších zmyslov rozlišujeme aj receptory, ktoré patria k iným zmyslom – reagujú len na podmienky vnútri tela.	Besides the usually mentioned five senses, there are organs of other senses – responsive only to conditions within the body itself.	0.441964
Do skupiny receptorov, ktoré majú pri skúmaní pohybu osobitý význam, patria receptory vo svaloch, v kĺboch a v šľachách.	The group of sense organs that are of special interest in the study of movement are those in the muscles, joints, and tendons.	0.294175
Sú stimulované aktivitou týchto častí, informujú myseľ o presnom stave svalovej kontrakcie a o rozsahu pohybu v kĺbe.	They are stimulated by the activity of these parts, reporting to the mind the exact state of muscular contraction, the range of joint movement.	0.240594
Práve vďaka tomuto pohybovému – kinestetickému – zmyslu môžeme posúdiť načasovanie, silu a rozsah nášho pohybu a vedome či automaticky sa prispôsobiť tejto informácii.	It is by means of this movement sense – the kinaesthetic sense – that we can judge, the timing, force, and extent of our movement, and adjust ourselves consciously or automatically to this information.	0.490345
K tejto skupine receptorov patria orgány rovnováhy, ktoré zabezpečujú telesnú rovnováhu a držanie tela.	To this group of receptors also belong the organs of static and equilibratory sensations, which serve to maintain body balance and posture.	0.207692
Receptory potom prinášajú obrovské množstvo potrebného zmyslového materiálu.	The receptors, then, bring, as grist to the mill, a great mass of sensory material.	0.3
Na tento materiál následne reagujú orgány reakcie – efektory.	The task of executing a reaction to this sensory material belongs to the effectors, which are the organs of response.	0.05
Tak ako sú receptory určené na príjem podnetov, efektory sú určené na ich realizáciu.	Just as the receptors are specialized agents receiving stimuli, the effectors are specialized discharging agents.	0.189041
Medzi nimi sa nachádza vodivé tkanivo, ktoré plní asociačné funkcie a prenáša impulzy dnu a von.	Between these lies a conducting tissue, serving an associative function as well as carrying impulses in and out.	0.425251
Zároveň poskytuje i nekonečné možnosti pre súvzťažné procesy.	It also provides infinite possibilities for correlative action.	0.289091
Vďaka poznatkom o asociácii a prekrývaní impulzov si môžeme okamžite uvedomiť, aké nekonečné a rozsiahle sú možnosti mysle. ~~~ Môžeme pokojne predpokladať, že v mozgu sú percepčné oblasti citlivé na ďalšie formy energie, ktoré prestupujú éter a o ktorých ľudstvo zatiaľ nemá ani tušenie.	With such an arrangement for association and overlapping of impulses, we can at once appreciate how infinite and vast are the possibilities of the mind, and can theorize that there are perceptual areas of the brain awaiting further sensitization to forms of energy pervading the ether, of which, as yet, man remains unaware.	-0.0171429
Pred vytvorením efektívnej motorickej reakcie prejde veľké množstvo prichádzajúceho materiálu intenzívnou zmenou.	Before an effective motor response is made, the great mass of incoming material undergoes a profound change.	0.267742
Zorganizuje sa do určitých myšlienok alebo predstáv o prostredí, na ktoré sa vynaloží energia.	It becomes organized into definite ideas about, or images of, the environment upon which energy is expended.	0.259756
Táto zmena prebieha v mozgovej kôre, v ktorej pretrvávajú zvyšky minulých dojmov a kde prebiehajú mimoriadne zložité selektívne korelačné a asociačné procesy.	This change takes place in the cerebral cortex, where residues of past impressions are retained and where selective correlations and associations of great complexity take place.	0.267391
Vytvárajú sa tam nové vzory správania, ktoré sa týkajú myslenia i konania.	There emerge new behaviour patterns in thought as well as in action.	0.268966
Pred preniknutím k diskriminačným a organizačným centrám sa prichádzajúce impulzy zdržia v podkôrovej retranslačnej stanici – v talame (v lôžku).	As the incoming impulses course toward the discriminating and organizing centers of cortex, they are first delayed at a subcortical relay station, the thalamus.	0.416873
Reflexná činnosť talamu síce nedosiahne zreteľné vedomie, ale napriek tomu obohacuje neskôr vzniknuté vedomie o pocity.	The reflex activity of the thalamus does not attain distinct consciousness, but nevertheless it contributes a feeling tone to the awareness ultimately aroused.	0.205714
Talamus sa často nazýva aj starý mozog.	The thalamus is often spoken of as the "old brain.	0.229412
U vývojovo starších živočíchov bez kôry je talamus veľmi dôležitý a v človeku zachováva jeho primitívne funkcie.	”It is important in lower forms without a cortex, and in man it retains its primitive functions.	0.407407
Vďaka vplyvu starého mozgu súvisí stimulácia priamo s kvalitou pocitov. ~~~ Ich aktívne prejavy sa však zlepšujú vďaka asociačným vplyvom mozgovej kôry.	It is because of this contribution of the "old brain” that stimulation is directly connected with feeling tones, but it is the associative influences of the cortex that contribute toward enhancing their active manifestations.	-0.0709924
Kôra kontroluje, alebo potláča všetky nižšie centrá.	The cortex has a controlling or inhabiting influence over all the lower centers.	0.159574
Ak je cesta medzi talamom a mozgovou kôrou prerušená, reakcie na citový podnet sú nadmerné.	If path from the thalamus to the cortex is cut, there results excessive response to affective stimuli.	0.265385
Kvality pocitov teda spôsobia citové preťaženie, pretože regulačný vplyv kôry je nefunkčný.	There is an overloading of sensation with feeling tone because the regulating influence of the cortex has been released.	0.218519
Takto sa zvyčajne správa nezrelá myseľ dieťaťa, primitívneho človeka alebo nezrelého dospelého.	This type of behaviour is normally that of the immature mind, whether in a child, in primitive man, or in an immature adult.	0.236471
Zdá sa, že v starom mozgu sa nahromadila múdrosť celej rasy – zvyšky rasovej skúsenosti, ktoré pomohli človeku prežiť, a preto sú plné emočných kvalít.	It seems that within this "old brain” resides the stored-up wisdom of the race – residues of racial experience that have helped man to survive and that are, therefore, rich in emotional tone.	0.340385
Prevláda presvedčenie, že citová fáza pociťovania a emočný život ako taký sídlia práve v tomto starom mozgu a nie v mozgovej kôre.	Indeed, the affective phase of sensations and the emotional life in general are believed to reside in this "old brain” and not in the cerebral cortex.	0.256364
Pocity však nie sú presne lokalizované a rozlišované.	The sensations, however, are without clear localization and discrimination.	0.165957
Tieto funkcie totiž vyžadujú spoluprácu kôry.	These need the co-operation of the cortex.	0.267568
Hoci talamus a miecha zodpovedajú za všetky inštinktívne impulzy bez pomoci kôry, podliehajú jej inhibičnému vplyvu.	The thalamus and the spinal cord take care of all impulses of the instinctive type without reference to the cortex, but they are not free of its inhibiting influence.	0.191176
Ďalšou podkôrovou oblasťou, ktorá má významný vplyv na celkový pohyb tela, je mozoček.	Another subcortical area that has profound influence upon all movement is the cerebellum.	0.288
Hoci mozoček pohyb nespúšťa, určitým spôsobom ovplyvňuje svalový tonus a zoslabuje tonus svalov antagonistov.	It does not initiate movement, but in some way it affects the tonicity of the muscles and diminishes the tonus of the antagonist muscles.	0.44433
Udržuje správnu rovnováhu svalových kontrakcií.	It maintains proper balance of muscular contractions.	0.272727
Aj keď si jeho funkčnú aktivitu uvedomujeme, detaily ešte úplne nepoznáme.	The details of its functional activity, although appreciated, are not clearly understood.	0.235385
Je však isté, že mozoček je mechanizmus nevedomej motorickej koordinácie a zohráva úlohu najmä pri reflexných a inštinktívnych činnostiach.	But it is certain that the cerebellum is the mechanism of unconscious motor coordination and is devoted chiefly to reflex and instinctive activities.	0.285246
Vedci zistili, že strata tonusu zapríčinená poruchou mozočka sa prejavuje zvýšenou pohyblivosťou kĺbov.	Medical science has discovered that loss of tonicity, due to the impaired functioning of the cerebellum, results in increases mobility of the joints.	0.182609
Predpokladá sa, že sídlom inteligencie a vedomia (psychiky) je sivá hmota koncového mozgu.	Intelligence and consciousness (the psyche) are believed to reside within the gray matter of the cerebrum.	0.250633
Prebiehajú v nej veľmi zložité korelačné a asociačné procesy.	Correlations and associations of great complexity take place within it.	0.25
Navyše má schopnosť uchovávať si dojmy z minulosti.	It also possesses the ability to retain past impressions.	0.266667
Jej štruktúra umožňuje, aby každá časť nielen prijímala prichádzajúce (aferentné) impulzy, ale aj vysielala odchádzajúce (eferentné) impulzy.	It is so constructed that every part not only receives incoming impulses but originates outgoing impulses as well.	0.214286
Impulzy, ktoré súvisia s asociačnými, so selekčnými a s diskriminačnými procesmi, najskôr prechádzajú do mozgovej kôry, aby sa v nej tieto deje mohli zrealizovať.	Impulses that involve association, selection, and discrimination are referred to the cortex for these processes before being passed on to the effectors for execution.	0.291429
Potom pokračujú k efektorom, ktoré zodpovedajú za realizačné procesy.		-0.3
