Napriek všetkým presvedčivým argumentom aj tí najzanietenejší oxfordiáni musia uznať, že neexistuje ani ten najmenší skutočný dôkaz o priamej spojitosti medzi ich obľúbencom a Shakespearovou tvorbou.	As persuasive as their case may be, even the most ardent Oxfordians must admit there isn’t a scrap of real evidence tying their man to Shakespeare’s work.	0.304134
Veď ako by sme potom vysvetlili slová chvály Ó žiť, tvoje srdce bude biť, / A môžeme tvoje umenie zažiť, a preň ťa velebiť.	And how to explain Ben And art alive still, while thy Booke doth live, /And we have wits to read, and praise to give.	0.281053
Skupina ortodoxných stratfordiánov, kam patrí aj veľká väčšina historikov a profesorov angličtiny, ktorí sa zaujímajú o Shakespeara, pokladá zástancov grófa z Oxfordu len za rojkov, ktorí vôbec neberú do úvahy historické skutočnosti, alebo si ich nesprávne vysvetľujú.	By and large, orthodox Stratfordians – a group that includes the vast majority of historians and English professors with an interest in Shakespeare – dismiss Oxford’s champions as wishful thinkers who ignore or misread historical evidence.	0.340105
Podľa odborníkov je prirodzené, že túžime objaviť stopy, ktoré zanechal náš najuctievanejší spisovateľ. ~~~ Nech je to len sonet o láske na pergamene s vlastnoručným podpisom alebo prvá verzia Macbetha.	It’s natural, they say, that we yearn for traces of our most revered writer – a signed love sonnet on parchment, at least, if not a complete first draft of Macbeth.	-0.0422222
Ak majú podozrenia ohľadom ich neprítomnosti, v skutočnosti to odhaľuje len ich mylné chápanie spôsobu života v období anglickej renesancie.	But finding their absence suspicious, they say, reveals basic misunderstandings about life during the English Renaissance.	0.261111
V Shakespearovej dobe ho ľudia nevnímali ako žánrovo všestranného velikána, vysvetľuje Marjorie Garberová, profesorka angličtiny a vizuálnych štúdií na Harvardovej univerzite a autorka niekoľkých kníh o Shakespearovi vrátane publikácie A predsa Shakespeare (2004).	In his own time, Shakespeare wasn’t thought of as a universal genius,” says Marjorie Garber, professor of English and visual studies at Harvard University and the author of several books on Shakespeare, including Shakespeare After All (2004).	0.61526
Vtedy nikomu nenapadlo odložiť si jeho siahodlhý zoznam a potom predať cez eBay.	Nobody was about to save a laundry list he wrote so they could sell it on eBay.	0.705134
Pre tú kultúru to nebolo príznačné.	It wasn’t that kind of culture.	0.255556
Papier sa typicky ručne vyrábal vo Francúzsku, bol vzácny a drahý. ~~~ Keď už viac nebol potrebný, znovu ho použili na niečo iné, možno na vystlanie misky na pečenie alebo na spevnenie obalu knihy.	Paper, typically handmade in France, was scarce and expensive; when it was no longer needed, it was reused – to line a baking dish, perhaps, or stiffen a book cover.	-0.029562
Písanie listov a denníkov bolo dosť neobvyklé, hlavne v prípade prostých ľudí.	Letter- writing and diary-keeping were unusual, especially for commoners.	0.290909
Pokiaľ ide o autorské rukopisy Garberová tvrdí, že po ich vytlačení už nikto nemal dôvod si ich uschovať.	As for play manuscripts, Garber says, Once they were set in type, there was certainly no reason to save them.	0.293258
Dokonca ani verejnosť ich nepovažovala za literárne diela.	Even in print, plays were considered something less than literature.	0.253846
Taktiež zdôrazňuje, že keď Thomas Bodley v čase Shakespeara založil na Oxfordskej univerzite knižnicu Bodleian, odmietol zaradiť pôvodné hry do katalógu.	When Thomas Bodley set up the Bodleian library at Oxford University in Shakespeare’s time, she points out, he refused to include play texts.	0.534912
Vnímali ich ako odpad, ako brakovú literatúru.	These were considered trash, like pulp fiction.”	0.285366
Bežní odborníci postupne zavrhujú jednotlivé predmety diskusií oxfordiánov.	One by one, mainstream scholars knock down the Oxfordians’ debating points.	0.286364
Nie, Stratford nepatril medzi nekultivované zastrčené miesta.	No, Stratford wasn’t an uncultured backwater; a lord mayor of London and an archbishop of Canterbury had both come from there.	0.401786
Pochádzal odtiaľ aj londýnsky starosta a arcibiskup z Canterbury.	No, a Stratford grammar-school graduate wasn’t akin to a seventh-grade dropout of today.	0.501724
Nie, absolvent stratfordského gymnázia nenadobudol vzdelanie ako žiak, ktorý by školu nechal po siedmom ročníku.		-0.3
Antická literatúra bola v školách bežným predmetom, a tak sa jej prvky odrážajú v hrách.	The Greek and Latin classics echoed in the plays were a standard part of the grammar-school curriculum.	0.4355
Shakespeare možno nikdy nenavštívil Taliansko, ale ani nikto z obdobia renesancie nezažil staroveké Grécko či Rím na vlastnej koži. ~~~ A predsa táto skutočnosť nezabránila tomu, aby sa antický svet stal obľúbeným prostredím pre realizáciu deja básnickej tvorby a divadelných hier.	Shakespeare may never have visited Italy, but neither he nor anyone else during the Renaissance ever set foot in ancient Greece or Rome either, and that did not rule out the Classical world as a popular setting for poetry and drama.	0.0308761
A nemuseli ste byť šľachticom, aby ste písali o kráľoch a kráľovnách.	And no, you didn’t have to be a nobleman to write about kings and queens.	0.525684
Všetci spisovatelia o nich písali, lebo presne to alžbetínska verejnosť od nich vyžadovala.	Writers of every stripe did so – it’s what the Elizabethan public demanded.	0.225
To, čo nakoniec odlišuje Shakespeara od jeho súčasníkov, je rôznorodosť jeho literárnych štýlov a tematiky, vysvetľuje Jonathan Bate z Warwickskej univerzity.	In the end, what sets Shakespeare apart from his contemporaries is the sheer range of his style and his subject matter, says the University of Warwick’s Jonathan Bate.	0.432047
Písal vynikajúce komédie, tragédie aj historické hry.	He was great in comedy and tragedy and history.	0.24
Vedel písať o kráľovskom dvore a tiež o prostých ľuďoch.	He could write about the court, and he could write about ordinary people.	0.2125
Bate tvrdí, že hra nemusí byť autobiografická, tak ako ani sonet nemusí byť výlučne o vyznaní lásky.	A play doesn’t have to be autobiographical, Bate suggests, any more than a sonnet has to be confessional.	0.452549
Shakespeare si vždy nechal na tvári masku.	Shakespeare always kept himself well disguised.	0.679923
Nesnažil sa do diel vniesť vlastné názory a odkláňal sa od tematických rozporov danej doby.	He didn’t insert his own opinions, and he steered away from the topical controversies of the day.	0.284615
Práve toto uľahčilo súčasným režisérom a filmárom prácu pri spracovaní jeho hier.	That’s why it’s so easy for directors and filmmakers today to make his plays contemporary.	0.274648
V tom tkvie aj jeho nadčasovosť.	It’s the key to his endurance.	0.276923
Bate tiež poznamenal, že Shakespeare samozrejme nezačal písať veľdiela hneď ako siahol po brku.	Nor, Bate adds, is it necessary to believe that Shakespeare began writing masterpieces as soon as he picked up a quill.	0.638554
Existuje vierohodný dôkaz, že spočiatku prepisoval práce iných dramatikov.	There is good evidence that he started by rewriting the works of other dramatists.	0.286567
Mnohé z jeho prvých hier vznikli buď v spolupráci s uznávanejšími autormi, s ktorými spolupracoval, alebo prepracovaním starších hier.	Lots of his early plays are either collaborative works, where he’s a kind of junior partner working with more established dramatists, or they’re reworkings of older plays.	0.225641
Dokonca aj dejové línie hĺbavejších a uváženejších diel, akými sú Hamlet či Kráľ Lear, čerpal z už existujúcich prác.	”Even the mature plays like Hamlet and King Lear, Bate says, drew on existing works for their plots.	0.558647
Bate vysvetľuje: V tých dňoch sa originálnosť nijako výnimočne necenila.	In his time, originality wasn’t especially valued.	0.173333
Ako sa dalo predpokladať, Anglicko jeho smrť neoplakávalo.	As for England not mourning his death, that’s not surprising either.	0.259615
Do roku 1616 bol Shakespeare predsa len dôchodca pochádzajúci zo strednej triedy, ktorý žil ďaleko od Londýna a jeho hry už nepredstavovali najvyhľadávanejšie umelecké diela.	By 1616, Shakespeare was, after all, a middle-class retiree living far from London, and his plays were no longer the latest fashion.	0.456405
Počas celého života a ešte nejaký čas potom ľudia nepochybne Shakespeara uznávali a vážili si ho, ale nepovažovali ho za stelesnenie jedinečnosti, hovorí Bate.	In his own lifetime and for some time after, Shakespeare is certainly admired and respected, but he’s not thought of as unique,” says Bate.	0.368718
Preto sa mnohí spisovatelia domnievali, že majú právo skvalitniť jeho tvorbu.	Which is why later writers felt justified in improving” on him.	0.222222
Britský dvorný básnik John Dryden koncom 17. storočia skrátil Troila a Kressidu, ako sám povedal, odstránením tej hromady táranín, ktoré úplne zasypali toľko vznešených myšlienok.	British poet laureate John Dryden shortened Troilus and Cressida in the late 1600s by excising what he called that heap of Rubbish, under which so many excellent Thoughts lay wholly bury’d.”	0.521154
Nemenovaný kritik v nasledujúcom storočí Shakespearovi vyčítal, že odignoroval staroveké národy, nedodržiaval spoločenské konvencie, lebo sa uchýlil k tragikomédii a písaniu o nadprirodzených bytostiach, používal slovné hračky a blankvers.	An unnamed critic in the following century scolded Shakespeare for ignoring the ancients, for violating decorum by resorting to tragicomedy and supernatural characters, and for using puns and blank verse.	0.238636
V porovnaní so Shakespearovými súčasníkmi dosahovala jeho genialita oveľa vyššiu úroveň. ~~~ Táto predstava sa však začína šíriť až v polovici 18. storočia vďaka rozkvetu Britského impéria a zvýšeniu gramotnosti, vraví Bate.	The idea that he was a completely different order of genius from all his contemporaries only begins in the mid-18th century, with the British Empire taking off and literacy growing,” says Bate.	0.0764855
K zidealizovaniu Shakespeara oficiálne prišlo v roku 1769, keď herec David Garrick usporiadal v Stratforde honosnú oslavu výročia bardovho narodenia.	The apotheosis became official with actor David Garrick’s lavish Shakespeare Jubilee, held in Stratford in 1769.	0.37545
V očiach súčasnej verejnosti je Shakespeare takým literárnym géniom, akým je Mozart v oblasti hudby či da Vinci v maliarstve.	For today’s public, of course, Shakespeare is to literary genius what Mozart is to music and Leonardo to painting.	0.569072
Bate preto vysvetľuje, že diskusie o autorstve sú prirodzeným výsledkom uctievania Shakespeara, ktoré je už hlboko zakorenené v našej kultúre.	The authorship debate, says Bate, is a natural consequence of a cult of Shakespeare now deeply rooted in our culture.	0.224242
Marjorie Garberová z Harvardovej univerzity zaujala k tomuto dlhotrvajúcemu sporu mimoriadne zhovievavé stanovisko.	Harvard’s Marjorie Garber takes an unusually tolerant view of the long-running dispute.	0.425574
Tvrdí, že mnohí ľudia, ale predovšetkým spisovatelia, majú radšej záhadu ako jej vyriešenie.	A lot of people, especially writers, prefer the mystery to an answer,” she says.	0.242647
Nech už je odpoveď na hádanku akákoľvek, aj tak to bola jednoducho osoba z konkrétneho obdobia a miesta.	Any answer is going to be simply a human of a particular time and place.	0.527542
Domnieva sa, že v súčasnosti hľadíme na Shakespeara očami jeho priateľa Bena Jonsona, keď mu vzdával hold v Prvom fóliu: Nepatril len do jednej éry, je večný!	We regard Shakespeare today, she believes, the way his friend Ben Jonson did in his First Folio tribute – He was not of an age, but for all time! ”– and asks whether we really want to see him reduced to an ordinary mortal.	0.193985
Tiež sa pýta, či ho naozaj chceme vidieť iba ako obyčajného smrteľníka a podotýka, že mnohí sa radšej držia predstavy transcendentálneho, univerzálneho Shakespeara.	Many people prefer to keep the idea of a transcendent, universal Shakespeare,” she says.	0.235526
Garberová sa rada odvoláva na poznámku, ktorú v roku 1847 Charles Dickens napísal svojmu priateľovi: Shakespearov život je jedna veľká záhada a ja sa každý deň trasiem, aby niečo nevyšlo na povrch.	Garber likes to cite a remark Charles Dickens made to a friend in 1847: The life of Shakespeare is a fine mystery, and I tremble every day lest something should turn up.”	0.51487
Vždy, keď chcem obviňovať Boha, spomeniem si na obdobie obrovskej frustrácie, ktorým som si prešiel pred niekoľkými rokmi, a na to, čo ma toto obdobie naučilo.	Whenever I am tempted to blame God, I remember a period of great frustration I went through several years ago, and what I learned from it.	0.355848
Všetko sa začalo na ceste domov z rybárskej výpravy na severe New Yorku - skvelou príležitosťou na pár dní uniknúť pred tlakom mojej práce - keď som si všimol, že začínam strácať hlas.	It all began on the way home from a fishing trip in upstate New York – a welcome chance to escape the pressures of my work for a few days – when I noticed that I was losing my voice.	0.369485
Spočiatku som to ignoroval. Očakával som, že sa môj stav zlepší v priebehu niekoľkých dní.	At first I ignored it, expecting it to improve within several days.	0.425506
Stal sa však presný opak.	But it only grew worse.	0.27
Nakoniec ma lekár poslal k špecialistovi.	Finally my doctor referred me to a specialist.	0.275676
Diagnóza: paralyzované hlasivky.	The diagnosis: a paralyzed vocal chord.	0.26129
Hoci ma špecialista ubezpečil, že sa mi môj hlas nakoniec vráti, prešli týždne a mesiace, a nič sa nemenilo.	The specialist reassured me that my voice would eventually recover, but weeks and then months went by, and there was no change.	0.247253
Predpísal mi úplný hlasový odpočinok (nemohol som dokonca ani šepkať), a aj napriek tejto frustrácii som to dodržiaval na sto percent.	His prescription was complete voice rest (I wasn’t even allowed to whisper) and frustrating as it was, I held to it religiously.	0.416919
K žiadnemu zlepšeniu však nedošlo.	Still there was no improvement.	0.267857
Premýšľal som, či vôbec ešte niekedy prehovorím.	I wondered if I would ever speak again.	0.209091
Aby toho nebolo málo, práve počas tohto obdobia prežívala moja kongregácia krízu, ktorá spôsobila odchod viacerých jej členov.	To make things worse, right during this time my congregation became embroiled in an extended crisis involving a fallout between several longstanding members.	0.229091
Na každom stretnutí som bol ako pastor požiadaný o vstup. ~~~ Nemohol som však reagovať, preto som iba mlčal alebo písal, čo som chcel povedať.	At meeting after meeting I was asked for my input as senior pastor, but instead of being able to respond, I could only sit by in silence and write down the things I most wanted to say.	-0.0378151
Ak je nám schopnosť hovoriť, alebo jej podobná, považovaná za samozrejmosť odobraná, môžeme ju chápať ako dar.	When a capability like speech – or anything else we take for granted – is taken away from us, we can choose to see it with new appreciation, as the gift it is.	0.195789
Ale ja som bol príliš znepokojený a rozrušený.	But I was too anxious and upset to do that.	0.257143
Úprimne povedané, bol som naštvaný.	To be honest, I was angry.	0.163636
Aj keby ma Boh skúšal, povedal som si, že horšiu chvíľu si vybrať nemohol.	Even if God was testing me, I said to myself, he couldn’t have picked a worse time.	0.270968
S odstupom času som dokázal vidieť celú tú nepríjemnú situáciu z iného uhla pohľadu: začal som si uvedomovať, že mi poskytla šancu vytvoriť si flexibilnejší pohľad na život. ~~~ Odvtedy som sa bral menej vážne a vyťažil z každej situácie čo najviac.	It was only with time that I was able to see the whole annoying predicament from another angle: I began to real-ize that it was providing me with an important chance to develop a more flexible outlook on life, to take myself less seriously, and to make the best of an imperfect situation.	-0.0209135
O tri mesiace neskôr sa mi môj hlas začal vracať. ~~~ Teraz, po ďalších siedmich rokoch, sa vrátil úplne do normálu.	Three months later, my voice began to return; now, seven years later, it is back to normal.	-0.0394737
Ale nikdy nezabudnem na tých dvanásť týždňov.	But I have never forgotten those twelve weeks.	0.3
Andrea, žena z nášho kostola, sa snažila prijať oveľa ťažšie bremeno: trikrát potratila zdravé dieťa.	Andrea, a woman in my church, struggled to accept a much heavier burden: she miscarried three times before having a healthy child.	0.4125
Na rozdiel od môjho, nie je to Andreino o obviňovaní alebo odpúšťaní Bohu.	Unlike mine, Andrea’s story is not, strictly speaking, about blaming or "forgiving” God.	0.233333
Snažila sa skôr prijať stratu svojich detí bez toho, aby podľahla myšlienke, že sa ju Boh pokúsil potrestať.	For her the battle was to accept the loss of her babies without succumbing to the fear that God was somehow trying to punish her.	0.254348
Ale zápas s emóciami a nájdenie pokoja sú si podobné.	But in showing how she was able to wrestle through her emotions and find peace, it illustrates a similar theme.	0.252727
Neil a ja sme sa potešili, keď sme zistili, že som otehotnela len po šiestich mesiacoch manželstva.	Neil and I were delighted to find that I was pregnant after only six months of marriage.	0.421461
Ale v jednu noc, tesne pred Vianocami, som pocítila intenzívnu bolesť, ktorá narastala.	But one night, just before Christmas, I felt intense pain that grew rapidly worse.	0.274286
Lekár nás chcel poslať do nemocnice a naša suseda, ktorá bola zdravotnou sestrou, zostala so mnou až do nášho odchodu do mesta.	Our doctor wanted to send me to the hospital, and our neighbor, a nurse, came to stay with me until we left for town.	0.39254
Potvrdila moje najhoršie obavy - pravdepodobne som stratila svoje dieťa.	She confirmed my worst fears – I would probably lose my baby.	0.223529
Emocionálna bolesť bola minimálne taká silná ako fyzická.	The emotional pain was at least as severe as the physical.	0.287755
Prečo, Bože?	Why, God?	0.2
Prečo ja?	Why me?	0.214286
Prečo musíš tú malú dušu odviesť tak skoro?	Why do you have to take away this tiny soul so soon?	0.259459
Čo som spravila zle?	What have I done wrong?	0.266667
Pre záchranu môjho života bola potrebná operácia.	In order to save my life, an operation was necessary.	0.293182
Prišla som o dieťa a sama som sa zotavovala niekoľko týždňov.	The baby was lost, and I spent weeks recuperating.	0.237209
Trápili sme nad stratou nášho dieťatka a na tú bolesť sme boli sami.	We agonized over our loss and felt alone in our pain.	0.211364
Keď nám jeden z našich príbuzných povedal: "Hlavu hore!	When one of our relatives said to us, "Cheer up!	0.24
Možno budete mať nabudúce šťastie," cítila som sa akoby mi dal niekto facku.	Maybe you’ll have better luck next time,” I felt like I had been slapped in the face.	0.276923
Šťastie?	Luck?	0.15
Práve sme prišli o dieťa, skutočnú osobu, dieťa!	We had just lost a baby, a real person, a child!	0.276923
Od niekoho som dostala pohľadnicu s výrokom: "Pán Boh dal, Pán Boh vzal, nech je zvelebené meno Pánovo."	Someone sent me a card that said, "The Lord giveth, and the Lord taketh away, blessed be the name of the Lord.”	0.289773
To ma naozaj naštvalo.	That made me really upset.	0.255
Ako môžem poďakovať Bohu za tento strašný a bolestivý zážitok?	How could I thank God for this horrible, painful experience?	0.288462
Nemohla som.	I couldn’t.	0.272727
A nemohla som prestať myslieť ani na to, že ma Boh potrestal, hoci som nechápala prečo.	And I couldn’t stop thinking that somehow God was punishing me, even though I couldn’t understand why.	0.242466
Náš pastor ma utešil: Boh je Bohom lásky, nie trestu, a je tu, aby zmiernil našu bolesť.	Our pastor consoled me: God is a God of love, not of punishment, and he is there to ease our pain.	0.608676
Chopila som sa jeho slov ako topiaci slamky.	I grasped at his words as a drowning person grabs onto a pole held out from the shore.	0.0473684
Neilova podpora bola pravdepodobne viditeľným prejavom tejto lásky a zistili sme, že naša bolesť nás nanovo spojila.	Neil’s loving support seemed like a visible sign of this love, and we discovered that our pain united us in a new way.	0.454296
Slová "po každej búrke vyjde slnko" ma obzvlášť potešili, dokonca aj keď slnko nevychádzalo a zdalo sa, že búrka nikdy neprestane.	The words "Weeping shall endure for the night, but joy comes in the morning” especially comforted me, even when I couldn’t feel that joy coming, when it seemed that dawn would never break.	0.175676
Pomaly, postupom času a s láskavou pomocou ľudí okolo mňa som bola schopná cítiť, že tento hlboko bolestivý zážitok mi ukázal zmysel lásky k Bohu, ktorý sa stará o utrpenie ľudí a ktorý bol so mnou počas ťažkého obdobia.	Slowly, with time and with the loving help of those around me, I was able to feel that this deeply painful experience had given me an inkling of the love of God, who cares about the suffering of people and who was, I am convinced, right there beside me in my pain.	0.24918
Boh sa pre mňa stal skutočnejším a začala som veriť jeho láske.	God became more real to me, and I began to trust his love.	0.261702
Ale o niekoľko mesiacov neskôr, v nádeji v šťastný koniec, keď som čakala ďalšie dieťa, stalo sa to isté.	But then, some months later, when I was expecting another baby and hoping fervently that all would go well, the same thing happened again.	0.204545
Ukrutné bolesti, urgentný prevoz do nemocnice a operácia na záchranu môjho života.	Severe pain, an emergency trip to the hospital, and an operation to save my life.	0.282353
Znovu som stratila ďalšiu vzácnu osôbku krátko po tom, čo sa ňou vôbec stala.	Again another precious little person lost just after it had come into being.	0.3
Hlboká bolesť mi doslova roztrhala srdce.	Deep pain tore my heart apart.	0.173077
Do môjho denníka som napísala: "Nerozumiem tomu a možno ani nikdy nebudem.	I wrote in my diary: "I cannot see why; perhaps I never will.	0.216
Potrebujem istotu vo viere - pomôž mi!"	I need the assurance of faith – Help me!"	0.3
Neil stál verne pri mne.	Neil stood faithfully beside me.	0.685714
Pred niekoľkými rokmi zomrela jeho sestra na rakovinu a jeho slová boli skvelým zdrojom inšpirácie: "Medzi nami a Bohom je len fyzická vzdialenosť, ktorá však vôbec nemusí byť veľká."	He had lost a sister to cancer some years before, and what he had written then was a great source of sustenance: "We are separated from God only in physical distance, and that distance is perhaps not great."	0.471154
Tieto slová sa mi vryli do srdca.	I hung on to that with all my strength.	0.257143
V priebehu nasledujúcich týždňov a mesiacov sa bolesť zo straty pomaly strácala, aj keď nikdy nezmizla.	Slowly, over weeks and months, the pain of loss lessened, although it has never departed entirely.	0.282143
O rok neskôr som znova stratila nenarodené dieťa.	About a year later I again lost an unborn child.	0.2775
Opäť ma v srdci zasiahla obrovská bolesť, ale tentokrát bez hľadania odpovede na otázku "prečo?".	Once more there was deep pain in my heart, but this time no desperation over why.	0.223881
Dnes je Andrea matkou krásnej šesťročnej dcéry.	Today Andrea is the mother of a beautiful six-year-old daughter.	0.575
Aj napriek negatívnym emóciám, ktoré ju zaplavia pri premýšľaní nad predošlými troma tehotenstvami, neostala zatrpknutá.	Although thinking about her first three pregnancies always brings back a flood of emotions, she is not bitter.	0.258511
Práve naopak, vďaka týmto skúsenostiam si uvedomila, že svojho manžela, ktorý by s ňou išiel aj na kraj sveta, miluje oveľa viac a cíti nekonečnú vďaku za svoje jediné dieťa.	In fact, she is even able to point to two good fruits of her anguish: a greater love for her husband, who "went to hell and back with me, ” and endless gratitude for her only child.	0.396774
Podobne ako Andrea, Jon a Gretchen Rhoadsoví, mladý pár z neďalekej štvrte, netrpezlivo očakávali narodenie svojho prvého dieťaťa.	Like Andrea, Jon and Gretchen Rhoads – a young couple in a nearby community – eagerly awaited the birth of their first child.	0.902733
Alan sa narodil po zdanlivo bezproblémovom tehotenstve a na začiatku sa zdalo, že je všetko v poriadku.	Alan was born after a seemingly normal pregnancy, and in the beginning everything seemed all right.	0.642353
Po prepustení z nemocnice si jeho rodičia všimli, že sa niečo deje.	After he was discharged from the hospital, though, his parents noticed something was wrong.	0.184211
Niečo veľmi zlé.	Very wrong.	0.190909
Alan nejedol tak, ako mal.	Alan didn’t eat well.	0.836842
Bol čoraz slabší a slabší.	His muscle tone was poor.	0.286364
Ležal veľmi pokojne, takmer bez pohybu a keď dýchal, vydával zvláštne zvuky.	He lay very still, almost without moving, and when he breathed, he occasionally made strange gurgling sounds.	0.172727
Alan bol urgentne prijatý do neďalekej univerzitnej nemocnice. ~~~ Mal len tri mesiace, keď sa zistilo, že nebude pravdepodobne nikdy chodiť ani hovoriť; bol slepý a mal výrazné abnormality bokov, mozgu, uší a žalúdka.	Alan was quickly admitted to a nearby university hospital, but he was three months old before his problems became clear: he would probably never walk or talk; he was blind; and he had significant abnormalities of the hips, brain, ears, and stomach.	0.0390437
Jon a Gretchen boli zničení.	Jon and Gretchen were devastated.	1.24
Síce už dlhšie tušili, že niečo nie je v poriadku, no nečakali, že to bude až také zlé.	They had long suspected that something was wrong, but they hadn’t expected it to be this bad.	0.437089
Začali sa hneď obviňovať a krátko na to začali obviňovať aj Boha: "Prečo my?"	Right away they began to accuse themselves, and it wasn’t long before they began to accuse God: Why us?	0.403077
Jon hovorí, že hoci bol nahnevaný, nikdy v skutočnosti nevedel povedať na koho.	Jon says that though he was angry, he could never real--ly say at whom.	0.468523
Na seba?	Himself?	0.2625
Na Gretchen?	Gretchen?	1.74
Na Alanových lekárov?	Alan’s doctors?	0.2
Na Boha?	God?	0.12
Áno, možno na Boha, ale nevedel vysvetliť prečo.	Yes, perhaps God, but he couldn’t explain why.	0.285
Napriek tomu naňho nezanevrel a namiesto toho dospel k záveru, že "buď nás Boh nemá rád, alebo takto to má jednoducho byť.	Still, he refused to become bitter, but concluded instead that "either God does not love us, or this is just how Alan is meant to be.	0.409847
Možno nikdy nezistíme dôvod, no ak sa budeme stále rozrušovať nad Alanovým stavom, zabijeme všetku radosť, ktorú v ňom máme".	We may never know why, but if we are resentful about Alan’s condition, we will kill any joy we have had in him."	0.247253
Jon aj Gretchen priznávajú, že o prijatí sa veľmi ľahko hovorí.	Both Jon and Gretchen admit that acceptance is easier to talk about, than to actually practice.	0.65
Už dlho chceli pred všetkým utiecť, najmä keď už nedokázali počúvať súcitné slová náhodných ľudí.	There have been plenty of times when they wanted to run away from it all, when they simply couldn’t face another visitor offering meaningless words of sympathy.	0.117857
Zatiaľ čo niektoré dni prinášajú novú nádej, iné prinášajú neúspech alebo ďalšiu skúšku.	And while some days bring progress and new hope, others bring setbacks and trials.	0.27
Vo svojom prvom roku sa Alan podrobil tracheostómii a mnohým ďalším operáciám vrátane apendektómie.	In his first year alone Alan had a tracheotomy and numerous other surgeries, including an appendectomy.	0.693103
Aké ďalšie utrpenie ho ešte postihne?	How much more suffering will he have to endure?	0.236364
Vo svete, kde amniocentéza a interrupcia slúžia ako "riešenie" pri nedokonalých deťoch, Alanovi rodičia odmietajú vidieť svoje dieťa ako záťaž.	In a world quick to offer "early diagnosis” and abortion as the answer to imperfect babies, Alan’s parents refuse to see their child as a burden.	0.43294
"Je tu, aby nám toho ešte veľa povedal," napísal Gretchen, keď mal Alan takmer jeden rok," a rozhodne sa ho nevzdáme.	"He has a great deal to tell us,” Gretchen wrote when he was almost one, "and we are not about to let him go."	0.402273
Jeho malá ručička sa natiahla, prešla spleťou hadičiek, aby sa dotkla môjho líca.	His small hand reaches up through a tangle of wires to find my cheek.	0.231579
Ako som sa sklonila, aby som ho zdvihla z postele, jeho viečka sa mierne zdvihli a on sa na mňa s ospalým pohľadom pousmial.	As I stoop to lift him from his bed, his eyelids lift slightly and he gives me a sleepy grin…	0.334857
Mal ešte len jedenásť mesiacov, keď bol už päťkrát hospitalizovaný a to nerátam bežné návštevy ambulantných lekárov.	In the eleven months since his birth, Alan has been hospitalized five times; we have long since stopped counting the outpatient appointments.	0.240594
Zakaždým, keď sa vrátime domov, máme viac otázok a menej odpovedí; viac sĺz a menej istoty.	Each time we come home with more questions and fewer answers; more tears, and less certainty.	0.292208
Ale Alan sa vždy usmieva, keď sa za mnou načahuje, alebo zvedavo obzerá.	But as he snuggles against me and looks around curiously, he grins.	0.278947
Jeho úsmev je balzamom na dušu.	His smile is a balm to my heart.	0.288462
Koľko bolesti ešte dokáže Alan zniesť?	How much more pain can Alan bear?	0.664286
Aké ďalšie prekážky nás ešte čakajú?	What new hurdles await us?	0.182609
Jeho tracheostómia nás obrala o zopár dobrodružstiev, na ktoré sme sa tešili: fľaštičky a spoznávanie pevnej stravy.	His tracheostomy has taken away the few small adventures we had looked forward to: bottles and the chance to explore solid food.	0.279208
Už žiadne ďalšie radostné úsmevy a žiadne ďalšie slzy smútku a frustrácie.	No more gurgles of joy, either, and no more cries of frustration.	0.250909
"Ak prežije," povedal doktor, "možno už nebude potrebovať tieto hadičky."	If he lives, the doctor tells us, he may outgrow the need for these tubes.	0.280328
Učí ma každý deň k tolerancii.	He is teaching me acceptance every day.	0.207692
Napokon to je prijatie, ktoré Gretchen opisuje ako cestu k "odpusteniu" Bohu.	In the end, it is this acceptance Gretchen writes of that allows us to "forgive” God.	0.743628
Bez neho sa len bezducho búrime voči všetkému v našom živote a bojujeme s každým krížom, ktorý sme nútení znášať.	Without it, we are left rebelling against our lot in life, and fighting every cross we feel unjustly forced to bear.	0.293684
Naopak, s ním získavame schopnosť vidieť naše ťažkosti spojené s ťažkosťami iných a silu ich niesť.	With it, we gain the ability to see our hardships in relation to the suffering of others, and strength to carry them.	0.257647
Sebaodpustenie	Forgiving Ourselves	0.22
Bez odpustenia, odhliadnuc od dôsledkov, ktoré sme napáchali, naša schopnosť konať bude obmedzená a my tak navždy zostaneme obeťami týchto dôsledkov ako to je v prípade kúzelníka, ktorému chýba zázračná prísada na zrušenie kliatby.	Without being forgiven, released from the consequences of what we have done, our capacity to act would, as it were, be confined to a single deed from which we could never recover; we would remain the victims of its consequences forever, not unlike the sorcerer’s apprentice who lacked the magic formula to break the spell.	0.365901
Ak ubezpečujeme osobu, ktorá nám ublížila, že už proti nej nič nemáme, tak všetko, čo musí táto osoba urobiť, je prijať našu láskavosť. Aspoň v to dúfame.	When we assure a person who has hurt us that we no longer hold anything against him, all he has to do is accept our kindness – at least that is what we might hope.	0.404817
Avšak jednoduchšie je o tom hovoriť ako tak učiniť.	But that is often more easily said than done.	0.252632
Pocit viny sa podľa niektorých ľudí nedá odstrániť odpustením ani akýmikoľvek inými prostriedkami.	For many people, the problem of guilt cannot be solved with another’s forgiveness, or by any external means at all.	0.265517
Pre takýchto ľudí pokoj mysle nastane vtedy, keď odpustia sami sebe.	For them, peace of mind comes only when they are able to forgive themselves.	0.274576
S Delfom Franshamom som sa prvýkrát stretol v roku 1953.	I first met Delf Fransham in 1953.	0.478448
Bol to rok, kedy sa presťahoval zo Spojených štátov do vzdialenej juhoamerickej dediny, kde som vyrastal a začal učiť v miestnej škole.	That was the year he moved from the United States to the remote South American village where I grew up and began to teach at the local school.	0.427826
V triede nás bolo jedenásť. ~~~ Samí chlapci, trpaslíci. ~~~ Niekoľko dní pred prvým semestrom sme sa rozhodli podrobiť ho skúške.	There were eleven of us in his class, all boys, and all ruffians, and a few days into his first term we decided to put him to the test.	-0.128571
V jedno bežné paraguajské (vlhké a 40-stupňové) ráno sme sa ponúkli, že ho zoberieme na výlet.	One typical Paraguayan morning (humid and around 110 degrees), we offered to take him on a hike.	0.472721
Oficiálnou verziou bolo ukázať mu pamiatky.	Officially, we wanted to show him the sights.	0.3
V skutočnosti sme však chceli vidieť, koľko toho dokáže zniesť.	Privately, we wanted to see what he was made of.	0.1875
Po najmenej desaťkilometrovej prechádzke cez džungľu, prérie a močiare sme sa nakoniec otočili.	After leading him at least ten kilometers through jungle, prairie, and swampland, we finally turned back.	0.275
Krátko po návrate domov skolaboval na úpal.	Shortly after we arrived home he collapsed with heat stroke.	0.189474
Delf bol niekoľko dní v posteli, no my sme sa nad tým akosi nezamýšľali.	Delf was in bed for days, but we hardly gave it a thought.	0.431307
Dosiahli sme presne to, čo sme chceli – spraviť z neho padavku.	We had achieved exactly what we wanted – proved him a sissy.	0.512769
Boli sme však celkom prekvapení.	But we were in for a small surprise.	0.289655
V deň, keď sa vrátil do školy, povedal: "Chlapci, skúsime to znova."	The day he came back to school he said, "Boys, let’s try that hike again."	0.515252
Nemohli sme tomu uveriť!	We couldn’t believe it!	0.285714
Absolvovali sme presne tú istú trasu s tým rozdielom, že tentokrát Delf nepodľahol teplu.	We covered the same route again and, sure enough, this time he did not succumb to the heat.	0.292
V ten deň si získal náš rešpekt a odvtedy sme mu plne dôverovali.	Delf won our respect and our hearts that day, and we trusted him from then on.	0.244444
K tomu všetkému bol talentovaný športovec, ktorý nás priviedol k futbalu, a miloval ho s nami hrať.	(There was something else to it, too: a talented athlete, he taught us soccer and loved to play with us. )	0.455952
O niekoľko rokov neskôr som úplnou náhodou zistil dôvod, prečo Delf vložil toľko lásky a energie do toho, aby si získal študentov.	Decades later, and only by chance, I found out why Delf had poured so much love and energy into reaching his students.	0.3937
Stratil totiž vlastné dieťa.	He had lost a child of his own.	0.288
Nicholas sa narodil, keď Franshamovci ešte žili v Spojených štátoch. ~~~ Jedného dňa, keď Delf cúval s nákladným autom na príjazdovú cestu, dvojročný Nicholas, ktorý sa hral vonku, bežal privítať otca.	Nicholas was born when the Franshams were still living in the United States, and one day as Delf was backing a truckload of firewood into their driveway, two-year-old Nicholas, who was playing outdoors, ran to meet his father.	0.119697
Delf ho nezaregistroval až do momentu, keď už bolo neskoro a malého Nicholasa prešiel.	Delf did not see him until it was too late, and ran over him.	0.346939
Delfova manželka Katie pracovala v dome, keď Delf priniesol v náruči bezvládne telo ich malého synčeka.	Katie, Delf’s wife, was busy inside the house when he carried in their little boy, limp in his arms.	0.278313
Pamätá si: Bola som v koncoch - úplne zúfalá, ale Delf ma podržal.	She remembers: I was beside myself – absolutely frantic – but Delf steadied me.	0.448831
Vzali sme Nicholala k nášmu lekárovi, ktorý bol zároveň aj súdnym lekárom. ~~~ Ten nám vysvetlil, čo sa stalo.	We took Nicholas to our doctor, who was also the coroner, and explained what had happened…	-0.028125
Nikdy som sa nezamýšľala nad otázkou odpustenia môjmu manželovi, pretože som bola rovnako vinná.	There was never any question about forgiving my husband, as I knew I was just as much to blame.	0.276923
Podobne nevinil ani on mňa, len samého seba.	Likewise he did not blame me, only himself.	0.291892
V bolestiach sme stáli spolu jeden pri druhom.	We stood in our sorrow together.	0.171429
Aj napriek tomu si Delf nevedel odpustiť a sužovalo ho to po celý život.	Delf, however, could not forgive himself, and the accident haunted him for years.	0.25
Odvtedy robil čo mohol, robil si čas pre deti – čas, ktorý nemohol tráviť viac so svojím synom, ktorého zabil.	From then on, he went out of his way to make time for children – time he could not spend with the son he had killed.	0.442857
Pri pohľade späť si pamätám, ako sa mu vždy vtisli slzy do očí a rozmýšľam, čo bolo dôvodom.	Looking back, I remember how his eyes often glistened with tears, and wonder what it was that made them come.	0.240789
Videl v nás nášho syna?	Was it that he saw his son in us?	0.21
Predstavoval si chlapčeka, ktorým sa naše batoľa nikdy nestalo?	Was he imagining the boy his toddler would never become?	0.25
Nech bol dôvod akýkoľvek, Delf bol odhodlaný ukázať svoju lásku k ostatným, čím sa vo svojom vnútri postavil proti utrpeniu, ktoré spôsobil sebe a svojej rodine, keď neúmyselne vzal život svojmu synovi.	Whatever the reason, it seems that Delf’s determination to show love to others was his way of making up for the anguish he had caused himself and his family by unintentionally taking a life.	0.364327
John Plummer žije dnes už pokojný život metodistického pastora v spokojnom meste Virginia, ale veci sa nemali vždy tak.	John Plummer lives the quiet life of a Methodist pastor in a sleepy Virginia town these days, but things weren’t always so.	0.597059
Ako pilot vrtuľníka počas Vietnamskej vojny pomohol v roku 1972 zorganizovať napalmový útok na dedinu Trang Bang – bombardovanie zvečnené ocenenou fotografiou, na ktorej je jedna z obetí Phan Thi Kim Phúc.	A helicopter pilot during the Vietnam War, he helped organize a napalm raid on the village of Trang Bang in 1972 – a bombing immortalized by the prize-winning photograph of one of its victims, Phan Thi Kim Phuc.	1.93636
Počas ďalších dvadsiatich štyroch rokov Johna prenasledovala táto fotografia - obraz, na ktorom bola zachytená podstata vojny: nahé a spálené deväťročné dievča bežiace oproti kamere s oblakmi čierneho dymu tiahnucimi sa za ňou.	For the next twenty-four years, John was haunted by the photograph – an image that for many people captured the essence of the war: a naked and burned nine-year-old running toward the camera, with plumes of black smoke billowing in the sky behind her.	0.368337
Po celý ten čas Johna hrýzlo svedomie.	For twenty-four years John’s conscience tormented him.	0.154545
Veľmi chcel nájsť to dievča, aby jej povedal, že mu to je ľúto, ale nemohol.	He badly wanted to find the girl to tell her that he was sorry – but he could not.	0.665476
V hĺbke upadal do stále väčších depresií (rozpad dvoch manželstiev jeho stavu nepomohol) a začal piť.	Turning in on himself, he grew more and more depressed (the collapse of two marriages didn’t help), and he began to drink.	0.248276
Potom sa neuveriteľnou náhodou stretol John s Phúc počas Dňa vojnových veteránov v roku 1996 pri vojnovom pamätníku vo Vietname.	Then, in an almost unbelievable coincidence, John met Kim during an event at the Vietnam War Memorial on Veterans Day, 1996.	0.428571
Kim prišla do mesta Washington D. C. položiť veniec za mier;John prišiel so skupinou bývalých pilotov, ktorí sa nedokázali vyrovnať so svojou spoločnou minulosťou, ale boli odhodlaní držať spolu.	Kim had come to Washington, D. C. , to lay a wreath for peace; John had come with a group of former pilots unable to come to terms with their shared past, but determined to stick together anyway.	0.583019
V prejave k davu sa Kim predstavila ako dievča zo slávnej fotografie.	In a speech to the crowd, Kim introduced herself as the girl in the famous photograph.	0.464668
Stále má jazvy po celom tele od popálenin. ~~~ Povedala, že neostala zatrpknutá, ale naopak chce, aby ľudia vedeli, že iní utrpeli ešte viac ako ona: "Za tou fotografiou sa skrývajú tisíce a tisíce ľudí, ktorí zomreli.	She still suffered immensely from her burns, she said, but she was not bitter, and she wanted people to know that others had suffered even more than she had: "Behind that picture of me, thousands and thousands of people…died.	-0.00494505
Stratili časti svojho tela.	They lost parts of their bodies.	0.264
Celý ich život bol zničený a nikto si ich nevšimol."	Their whole lives were destroyed, and nobody took their picture."	0.211364
Kim ďalej povedala, že hoci nedokáže zmeniť minulosť, odpustila mužom, ktorí bombardovali dedinu, a že cíti poslanie podporiť mier medzi Amerikou a Vietnamom.	Kim went on to say that although she could not change the past, she had forgiven the men who had bombed her village, and that she felt a calling to promote peace by fostering goodwill between America and Vietnam.	0.466788
