Martinus Beijerinck, holandský botanik, ktorý študoval vírus tabakovej mozaiky v roku 1898 predpokladal, že ide o infekčnú tekutinu.	Martinus Beijerinck, a Dutch botanist who studied tobacco mosaic virus, speculated in 1898 that it was an infectious liquid.	2.3274
Vírus bol istý čas definovaný iba svojou veľkosťou, ako vec omnoho menšia než baktéria, ktorá by však podobne ako baktéria mohla spôsobiť ochorenie.	For a time a virus was defined mainly by its size — a thing much smaller than a bacterium but that, like bacteria, could cause disease.	0.381757
Neskôr sa predpokladalo, že vírus je submikroskopické činidlo nesúce veľmi malý genóm, ktoré sa replikuje vo vnútri živých buniek. ~~~ Ale to bol iba prvý krôčik k lepšiemu pochopeniu.	Still later, a virus was thought to be a submicroscopic agent, bearing only a very small genome, that replicated inside living cells — but that was just a first step toward a better understanding.	-0.00769231
(Pozrite, ako vírusy vyzerajú zblízka.)	(See how viruses look up close.)	0.214286
Francúzsky mikrobiológ André Lwoff napísal vo vplyvnej eseji Poňatie vírusu z roku 1957: Budem obhajovať paradoxné stanovisko, a to, že vírusy sú vírusy.	I shall defend a paradoxical viewpoint, wrote the French microbiologist André Lwoff in The Concept of Virus, an influential essay published in 1957, namely that viruses are viruses.	0.622727
Nie je to veľmi užitočná definícia ale varovanie, iný spôsob ako povedať jediné svojho druhu.	Not a very helpful definition but fair warning — another way of saying unique unto themselves.	0.3
Práve si odkašľal pred začatím zložitejšieho výkladu.	He was just clearing his throat before beginning a complex disquisition.	0.20625
Lwoff vedel, že vírusy je jednoduchšie opísať než definovať.	Lwoff knew that viruses are easier to describe than to define.	0.6
Každá vírusová častica pozostáva z genetickej informácie (zapísanej buď v DNA alebo v RNA), ktorá je vložená do proteínového obalu (známy ako kapsid).	Each viral particle consists of a stretch of genetic instructions (written either in DNA or that other information - bearing molecule, RNA) packaged inside a protein capsule (known as a capsid).	0.341279
Kapsid je v niektorých prípadoch obklopený membránovým obalom (ako karamel na karamelovom jablku), ktorý ju chráni a pomáha jej lepšie sa zachytiť bunky.	The capsid, in some cases, is surrounded by a membranous envelope (like the caramel on a caramel apple), which protects it and helps it catch hold of a cell.	0.420385
Vírus sa môže kopírovať iba vstupom do bunky a privlastnením si 3D tlačiarne, ktorá premieňa genetickú informáciu na proteíny.	A virus can copy itself only by entering a cell and commandeering the 3D-printing machinery that turns genetic information into proteins.	0.425229
Neandertálska lebka, jedna zo zatiaľ najzachovalejších, je uložená vedľa ľudských kostier v Musée de l’ Homme v Paríži.	A Neanderthal skull, one of the most complete yet found, rests near human skeletons in the Musée de l’Homme in Paris.	0.600483
Keď moderní ľudia opustili Afriku, skrížili sa s neandertálcami a nadobudli gény, ktoré sa vyvíjali stovky tisíc rokov.	When modern humans left Africa, they interbred with Neanderthals and instantly acquired genes that had evolved over hundreds of thousands of years.	0.230097
Vedci našli 152 génov zdedených od neandertálcov, ktoré pomáhajú vytvárať imunitnú odpoveď.	Scientists have found 152 genes inherited from Neanderthals that help create an immune response.	2.82735
Dospeli k záveru, že tieto gény umožnili našim predkom bojovať proti novým vírusom, s ktorými sa stretli v Európe.	They have concluded that these genes enabled our ancestors to fight the new viruses they encountered in Europe.	0.293684
Ak má hostiteľská bunka smolu, vytvorí sa veľké množstvo nových vírusových častíc, ktoré prasknú a bunka zostane zničená.	If the host cell is unlucky, many new viral particles are manufactured, they come busting out, and the cell is left as wreckage.	0.294286
Tento druh poškodenia – ktorý spôsobuje SARS-CoV-2 v epiteliálnych bunkách dýchacích ciest – je čiastočne spôsob, akým sa vírus stáva patogénom.	That sort of damage — such as what SARS-CoV-2 causes in the epithelial cells of the human airway — is partly how a virus becomes a pathogen.	0.410277
Ale ak má hostiteľská bunka šťastie, vírus sa možno usadí na útulné miesto – buď bude nečinný, alebo prebehne reverzná transkripcia malého vírusového genómu na hostiteľský genóm, a bude vyčkávať.	But if the host cell is lucky, maybe the virus simply settles into this cozy outpost — either going dormant or back-engineering its little genome into the host’s genome — and bides its time.	0.282911
Táto druhá možnosť má množstvo dôsledkov týkajúcich sa zmiešava nia genómov, evolúcie, dokonca aj pre zmysel nášho bytia (téma, ku ktorej sa ešte vrátim).	This second possibility carries many implications for the mixing of genomes, for evolution, even for our sense of identity as humans, a topic to which I’ll return.	0.286364
Zatiaľ jeden tip: V populárnej knihe z roku 1983 britský biológ Peter Medawar a jeho žena Jean, editorka, tvrdili: Žiadny vírus nie je známy tým, že je prospešný: je dnoducho sa hovorilo, že vírus je nemilé prekvapenie obalené v proteíne.	One hint, for now: In a popular 1983 book the British biologist Peter Medawar and his wife, Jean, an editor, asserted, No virus is known to do good: It has been well said that a virus is ‘a piece of bad news wrapped up in protein.’	1.37671
Mýlili sa.	They had it wrong.	0.12
Rovnako aj veľa iných vedcov v tom čase, a tento názor si osvojuje každý, ktorého znalosti o vírusoch sú obmedzené na také minimum ako chrípka alebo COVID-19.	So did a lot of scientists at the time, and it remains a view still embraced, understandably, by anyone whose knowledge of viruses is limited to such bad news as the flu and COVID-19.	0.473684
Dnes je už známe, že niektoré vírusy sú prospešné.	But today some viruses are known to do good.	0.251351
To, čo je zabalené v proteíne, je genetický prenos, ktorý môžeme považovať za milé i nemilé prekvapenie, všetko záleží.	What’s wrapped up in the protein is a genetic dispatch, and that might turn out to be good news or bad, depending.	0.274468
Kde sa vzali prvé vírusy?	Where did the first viruses come from?	0.15
To si vyžaduje, aby sme sa pozreli takmer o štyri miliardy rokov späť do minulosti. ~~~ Do čias, kedy sa život na Zemi začal vytvárať v dlhých molekulách, jednoduchších organických zlúčeninách a v energii.	This requires us to squint back almost four billion years, to the time when life on Earth was just emerging from an inchoate cookery of long molecules, simpler organic compounds, and energy.	-0.01125
Povedzme, že niektoré z dlhých molekúl (pravdepodobne RNA) sa začali replikovať.	Let’s say some of the long molecules (probably RNA) started to replicate.	0.511905
Darwinovský prírodný výber by sa začal tam, pretože tieto molekuly, prvé genómy, sa reprodukovali, mutovali a vyvíjali.	Darwinian natural selection would have begun there, as those molecules — the first genomes — reproduced, mutated, and evolved.	0.285577
Pri hľadaní konkurencieschopnosti niektoré mohli nájsť spôsob na vytvorenie si ochrany v membránach a stenách, čo viedlo k vzniku prvých buniek.	Groping for competitive edge, some may have found or created protection within membranes and walls, leading to the first cells.	0.255963
Tieto bunky umožnili vznik potomstva priečnym delením na dve bunky.	These cells gave rise to offspring by fission, splitting in two.	0.278182
Rozlišuje sa vznik baktérií a archeónov, to sú dve z troch hlavných domén bunkového života.	They split in a broader sense too, diverging to become Bacteria and Archaea, two of the three domains of cellular life.	0.590385
Tretia doména, eukraryot, vznikla o niečo neskôr.	The third, Eukarya, arose sometime later.	0.243243
Zahŕňa nás a iné tvory (zvieratá, rastliny, plesne, určité mikróby) pozostávajúce z buniek so zložitou vnútornou stavbou.	It includes us and all other creatures (animals, plants, fungi, certain microbes) composed of cells with complex internal anatomy.	0.280189
Toto sú momentálne tri najhlavnejšie vetvy fylogenetického stromu.	Those are the three great limbs on the tree of life, as presently drawn.	0.3
Ale kam zapadajú vírusy?	But where do viruses fit?	0.3
Sú štvrtou hlavnou vetvou?	Are they a fourth major limb?	0.2875
Alebo je to druh imela, parazit, ktorý sa zjavil znenazdajky?	Or are they a sort of mistletoe, a parasite wafted in from elsewhere?	0.271698
Väčšina verzií fylogenetického stromu úplne vynecháva vírusy.	Most versions of the tree omit viruses entirely.	0.2
Jason Sheperd, neurovedec na Utahskej univerzite, drží snímku trojdimenzionálnej rekonštrukcie proteínovej kapsuly, ktorá je podobná vírusu a hrá rozhodujúcu úlohu v poznaní a pamäti.	Jason Shepherd, a neuroscientist at the University of Utah, holds an image of a three-dimensional reconstruction of a virus-like protein capsule that plays a critical role in cognition and memory.	0.646957
ARC gén, ktorý nesie kód na vytvorenie tohto guľatého zázraku, bol získaný suchozemskými stavovcami z predka, ktorý sa podobal vírusu približne pred 400 miliónmi rokov.	The ARC gene, which carries the code to create this spherical marvel, was acquired by terrestrial vertebrates from a viral-like ancestor about 400 million years ago.	1.6761
Kapsula pripomínajúca kapsidy, ktoré obklopujú vírusové genómy, prenáša genetickú informáciu medzi neurónmi v ľudskom mozgu, ako aj v mozgoch mnohých iných zvierat.	The capsule, which resembles the capsids that surround viral genomes, ferries genetic in formation between neurons in the human brain as well as in the brains of many other animals.	0.28125
Jedna myšlienková škola tvrdí, že vírusy by nemali byť zaradené do fylogenetického stromu, pretože sú neživé.	One school of thought asserts that viruses shouldn’t be included on the tree of life because they aren’t alive.	0.296809
Je to pretrvávajúci argument, ktorý závisí od toho, ako definujete pojem živý.	That’s a lingering argument, hinging on how you define alive.	0.487822
Bolo by horšie garantovať zaradenie vírusov do veľkého stanu s názvom Život, a neskôr premýšľať ako sa tam dostali.	More intriguing is to grant viruses inclusion within the big tent called Life, and then wonder about how they got in.	0.3
Existujú tri hlavné hypotézy, ktoré vysvetľujú evolučný pôvod vírusov, pre vedcov známe ako hypotéza prvých vírusov, úniková hypotéza a redukčná hypotéza.	There are three leading hypotheses to explain the evolutionary origins of viruses, known to scientists as viruses - first, escape, and reduction.	0.276
Hypotéza prvých vírusov predstavuje myšlienku, že vírusy začali existovať už pred bunkami a nejako sa sami zostavili z prehistorickej dielne.	Viruses - first is the notion that viruses came into existence before cells, somehow assembling themselves directly from that primeval cookery.	0.297561
Úniková hypotéza predpokladá, že gény alebo úseky genómov z buniek unikli, boli uzavreté v proteínových kapsidoch, zatúlali sa, obrátili na stranu zla a našli si nové miesto ako parazity.	The escape hypothesis posits that genes or stretches of genomes leaked out of cells, became encased within protein capsids, and went rogue, finding a new niche as parasites.	0.376918
Redukčná hypotéza naznačuje, že vírusy vznikli keď sa niektoré bunky zmenšili kvôli konkurencieschopnosti (je jednoduchšie replikovať sa ak si malý a jednoduchý), strácali gény až kým sa zredukovali tak, že prežili iba parazitovaním buniek.	The reduction hypothesis suggests that viruses originated when some cells downsized under competitive pressure (it being easier to replicate if you’re small and simple), shedding genes until they were reduced to such minimalism that only by parasitizing cells could they survive.	0.253846
Existuje aj štvrtý variant, známy ako chimérická hypotéza, ktorá je inšpirovaná inou kategóriou genetických elementov: transpozónmi (nazývané aj skáčuce gény).	There is also a fourth variant, known as the chimeric hypothesis, which takes inspiration from anot her category of genetic elements: transposons (sometimes called jumping genes).	0.41307
Genetička Barbara McClintocková vyvodzuje ich existenciu v roku 1948, za čo získala Nobelovu cenu.	The geneticist Barbara McClintock deduced their existence in 1948, a discovery that earned her a Nobel Prize.	0.672093
Tieto oportunistické prvky dosahujú Darwinovský úspech iba skákaním z jednej časti genómu do inej, v ojedinelých prípadoch z jednej bunky do druhej, dokonca z jedného druhu, využívaním bunkových zdrojov na kopírovanie sa znova a znova.	These opportunistic elements achieve their Darwinian success simply by bouncing from one part of a genome to another, in rare cases from one cell to another, even one species to another, using cellular resources to get themselves copied, over and over.	0.366997
Toto kopírovanie sa ich chráni pred prípadným vyhynutím.	Self-copying protects them from accidental extinction.	0.3
Hromadia sa nezvyčajne.	They accumulate outlandishly.	0.218182
Tvoria napríklad približne polovicu ľudského genómu.	They constitute, for instance, roughly half of the human genome.	0.25
Prvé vírusy teda podľa tejto myšlienky mohli vzniknúť z takýchto prvkov, požičiavaním si proteínov z buniek na ich zaobalenie vo vnútri ochranných kapsidov, je to zložitejšia stratégia.	The earliest viruses, according to this idea, may have arisen from such elements by borrowing proteins from cells to wrap their nakedness inside protective capsids, a more complex strategy.	0.403393
Každá zo spomenutých hypotéz má význam.	Each of these hypotheses has merits.	0.271875
Ale nové zistenia z roku 2003 navádzali názor odborníkov smerom k jednoduchosti: obrovský vírus.	But in 2003 new evidence tipped expert opinion toward reduction: the giant virus.	2.59714
Bol nájdený v meňavkách, jednobunkových eukaryotoch.	It was found within amoebas, which are single-celled eukaryotes.	0.24375
Tieto meňavky odobrali z vody v chladiacej veže v anglickom Bradforde.	These amoebas had been collected in water taken from a cooling tower in Bradford, England.	0.221311
V niektorých z nich sa nachádzala záhadná škvrna.	Inside some of them was this mysterious blob.	0.269231
Bola dostatočne veľká na pozorovanie pomocou svetelného mikroskopu (vírusy boli na to údajne príliš malé, viditeľné iba pomocou elektrónového mikroskopu), a vyzerala ako baktéria.	It was big enough to be seen through a light microscope (viruses supposedly were too small for that, visible only by electron microscope), and it looked like a bacterium.	0.510629
Vedci sa pokúšali v rámci vzorky detekovať bakteriálne gény, žiadne však nenašli.	Scientists tried to detect bacterial genes within it but found none.	0.238983
Tím odborníkov z Francúzskeho Marseille nechali touto vecou infikovať iné meňavky, sekvenovali jej genóm, rozpoznali čo to je a nazvali ju mimivírus, pretože napodobňuje baktérie, aspoň pokiaľ ide o veľkosť.	Finally a team of researchers in Marseille, France, invited the thing to infect other amoebas, sequenced its genome, recognized what it was, and named it Mimivirus, because it mimicked bacteria, at least with regard to size.	0.475113
V priemere bola obrovská, väčšia než najmenšia baktéria.	In diameter it was huge, bigger than the smallest bacteria.	0.294
Jej genóm bol tiež na vírus obrovský, takmer 1,2 milióna písmen dlhý. ~~~ V porovnaní s 13 000 za vírus chrípky a 194 000 za ovčie kiahne.	Its genome was also huge for a virus, almost 1.2 million letters long, compared to, say, 13, 000 for an influenza virus, or even 194, 000 for smallpox.	0.0894231
(DNA podobne ako RNA, je dlhá molekula tvorená štyrmi rôznymi molekulárnymi bázami, ktoré vedci skrátia prvými začiatočnými písmenami.)	(DNA, like RNA, is a long molecule built with four different molecular bases, which scientists abbreviate by their first letters.)	0.439145
Bol to nemožný vírus: príliš veľký ale predsa vírus, ako novoobjavený amazonský motýľ s rozpätím krídel tridsať centimetrov.	It was an impossible virus: viral in nature but too big in scale, like a newly discovered Amazon butterfly with a four-foot wingspan.	0.288889
Jean-Michel Claverie bol vysokopostavený člen Marseillského tímu.	Jean-Michel Claverie was a senior member of that Marseille team.	1.02857
Claverie mi povedal, že objavenie mimivírusu spôsobilo veľa problémov.	The discovery of Mimivirus, Claverie told me, Caused a lot of trouble.	0.585
Prečo?	Why?	0.18
Pretože sekvenovanie genómu odhalilo štyri veľmi nečakané gény – gény na kódovanie enzýmov boli považované za výhradne bunkové a nikdy predtým neboli nájdené vo víruse.	Because sequencing the genome revealed four very unexpected genes — genes for coding enzymes presumed to be uniquely cellular and never before seen in a virus.	0.393162
Tieto enzýmy, ako Claverie vysvetlil, sa nachádzajú medzi komponentami, ktoré prevážajú genetický kód na zhromažďovanie aminokyselín do proteínov.	Those enzymes, Claverie explained, are among the components that translate the genetic code to assemble amino acids into proteins.	0.412762
Takže otázkou bolo, povedal Claverie, akú má ten vírus potrebu pre tie malé enzýmy fungujúce v bunkách, keď majú celú bunku iba pre seba, OK?	So, the question was, Claverie said, what the hell has a virus the need for those fancy enzymes, normally active in cells, when he has the cell at his disposal, OK?	0.372164
Vskutku, čo chce?	What need indeed?	0.3
Logickým záverom je, že mimivírus ich má ako potomok, pretože jeho pôvod vychádza z genomického redukovania bunky.	The logical inference is that Mimivirus has them as holdovers because its lineage originated by genomic reduction from a cell.	0.272727
Objavenie mimivírusu nebola náhoda.	Mimivirus was no fluke.	0.128571
Podobné obrovské vírusy sa čoskoro objavili v Sargassovom mori, a ich prvý názov sa stal pomenovaním rodu, mimivírus, obsahujúci niekoľko gigantov.	Similar giant viruses were soon detected in the Sargasso Sea, and the early name became a genus, Mimivirus, containing several giants.	0.402451
Potom marseillský tím objavil ďalšie dva giganty – znova oba parazity meňaviek – jednu odobrali z plytkých morských sedimentov na pobreží Čile, druhú z austrálskeho rybníka.	Then the Marseille team discovered two more behemoths — again, both parasites of amoebas — one taken from shallow marine sediments off the coast of Chile, the other from a pond in Australia.	0.279866
Tieto dvojnásobne väčšie a nezvyčajnejšieako mimivírus boli pridelené do osobitného rodu, ktorý Claverie a jeho kolegovia pomenovali pandoravírus, pretože pripomínal Pandorinu skrinku, ako vysvetlili v roku 2013, kvôli prekvapeniam očakávaným z ďalšieho výskumu.	Up to twice as big as a Mimivirus, even more anomalous, these were assigned to a separate genus, which Claverie and his colleagues named Pandoravirus, evoking Pandora’s box, as they explained in 2013, because of the surprises expected from their further study.	0.637941
Už pred 150 miliónmi rokov, vírusy infikovali cicavce a zanechali v nich gény, ktoré viedli k dramatickému evolučnému pokroku: k placente, ktorá umožňuje živinám a kyslíku dosiahnuť plod a odstraňuje odpad a oxid uhličitý.	As far back as 150 million years ago, viruses infected mammals and left genes that led to a dramatic evolutionary advance: the placenta, which allows nutrients and oxygen to reach the fetus and waste and carbon dioxide to pass out.	1.32383
Ľudia a ostatné cicavce s placentami sa môžu pohybovať spolu s nenarodenými mláďatami, preto sú menej zraniteľné pred predátormi.	Humans and other mammals with placentas can move around with their unborn young, making them less vulnerable to predators.	0.28
Ľuďom pomáhajú dva gény pochádzajúce z vírusov.	In humans, two genes originating from viruses.	0.292683
Táto membrána môže tiež pomôcť zabrániť imunitnému systému matky napadnúť plod, ktorý môže považovať za cudzí predmet.	This membrane also may aid in preventing the mother’s immune system from attacking the fetus as a foreign object.	0.278125
Hlavnou spoluautorkou Claveriovej práce bola Chantal Abergel, virologička a štrukturálna biologička (a jeho manželka).	Claverie’s senior co-author on that paper was Chantal Abergel, a virologist and structural biologist (and also his wife).	0.897143
O pandoravírusoch mi Abergel rozprával s unaveným smiechom: Boli veľkou výzvou.	Of the Pandoraviruses, Abergel told me, with a weary laugh: They were highly challenging.	0.52
Sú to moje deti.	They are my babies.	0.235714
Vysvetlila, ako náročné bolo určiť čo sú zač – sú veľmi odlišné od buniek, od klasických vírusov, nesú mnoho génov, ktoré sa nepodobajú ničomu, čo sme už videli.	She explained how difficult it had been to tell what they were, these creatures — so different from cells, so different from classical viruses, carrying many genes that resembled nothing ever before seen.	0.215556
Preto sú tak záhadne fascinujúce.	All of that makes them fascinating but also mysterious.	0.12
Chvíľu ich nazývala NFŽ: nová forma života.	For a while she called them NLF: new life - form.	0.284211
Ale z pozorovania s kolegami zistili, že sa nerozmnožujú priečnym delením, a teda ide o vírusy – najväčšie a najkomplikovanejšie zo všetkých už objavených.	But from observing that they didn’t replicate by fission, she and her colleagues realized they were viruses — the largest and most perplexing ones found so far.	0.295489
Tieto objavy naznačili marseillskej skupine, že ide o variant redukčnej hypotézy.	These discoveries suggested to the Marseille group a bold variant of the reduction hypothesis.	0.508333
Možno vírusy pochádzajú z redukovaných starovekých buniek, ale z tých buniek, ktoré už na Zemi neexistujú.	Maybe viruses did originate by reducing from ancient cells, but cells of a sort no longer present on Earth.	0.293333
Tento druh starovekej protobunky sa mohol líšiť od – a byť v konkurenčnom vzťahu s – univerzálnym spoločným predkom všetkých, dnes známych buniek.	This kind of ancestral protocell might have been different from — and in competition with — the universal common ancestor of all cells known today.	0.297581
Možno tieto protobunky stratili konkurenciu a boli vylúčené zo všetkých priestorov dostupných pre voľne žijúce veci.	Maybe these protocells lost that competition and were excluded from all the niches available for free - living things.	0.29703
Možno prežili parazitovaním na iných bunkách, zmenšili svoje genómy, a stali sa tým, čo nazývame vírusy.	They may have survived as parasites on other cells, downsized their genomes, and become what we call viruses.	0.29
Zo stratenej bunkovej ríše možno zostali iba vírusy, ako obrovské kamenné hl vy na Veľkonočných ostrovoch.	From that vanished cellular realm, maybe only viruses remain, like the giant stone heads on Easter Island.	0.296703
Objavenie obrovských vírusov inšpirovalo ďalších vedcov, najmä Patricka Forterre z Pasteurovho inštitútu v Paríži, k sformulovaniu nových predstáv o tom, čo sú vírusy, akú konštruktívnu rolu zohrali a budú zohrávať v evolúcii a vo funkciách bunkového života.	Discovery of the giant viruses inspired other scientists, notably Patrick Forterre at the Pasteur Institute in Paris, to formulate novel ideas about what viruses are and what constructive roles they have played, and continue to play, in the evolution and functions of cellular life.	0.356077
Predchádzajúce definície vírusu boli nedostačujúce, predložil Forterre, pretože vedci si zamieňali vírusové častice – kapsidovo-uzavreté kúsky genómu, riadne známe ako virióny – s vírusom ako takým.	Previous definitions of virus were inadequate, Forterre proposed, because scientists were confusing viral particles — the capsid - enclosed bits of genome, properly known as virions — with the totality of a virus.	0.286207
Tvrdil, že je to také zlé, ako zamieňať si semeno s rastlinou alebo spóru s hubou.	That, he argued, was as wrong as confusing a seed with a plant, or a spore with a mushroom.	0.273529
Argumentoval tým, že virión je iba rozptýlený mechanizmus.	The virion is just the dispersal mechanism, he argued.	0.268085
Skutočná celistvosť vírusu zahŕňa aj jeho prítomnosť v bunke, akonáhle sa zmocní bunkového aparátu na rozmnoženie ďalších viriónov, teda ďalších semien.	The real wholeness of the virus also includes its presence within a cell, once it has seized the cell’s machinery to replicate more virions, more seeds of itself.	0.293233
Pochopiť tieto dve fázy znamená pochopiť, že bunka sa skutočne stala súčasťou životnej histórie vírusu.	To see the two phases together is to see that the cell has effectively become part of the virus’s life history.	0.293333
Forterre podporil tento názor vytvorením nového názvu pre kombinovanú entitu: virobunku.	Forterre bolstered that notion by inventing a new name for the combined entity: the virocell.	0.546203
Táto myšlienka prekonala aj otázku živého a neživého.	This idea also cut through the alive-or-not-alive conundrum.	0.255319
Podľa Forterra je vírus živý vo forme virobunky bez ohľadu na to, že jeho virióny sú neživé.	A virus is alive when it’s a virocell, according to Forterre, never mind that its virions are inanimate.	0.257143
Počas hovoru cez Skype z Paríža mi povedal: Myšlienka za virobunkovým konceptom bola zameraná hlavne na túto medzibunkovú fázu.	The idea behind the virocell concept, he told me by Skype from Paris, was mainly to focus on this intracellular stage.	0.416667
Je to krehká fáza, v ktorej infikovaná bunka poslúcha príkazy vírusu, číta vírusový genóm a replikuje ho, ale nie vždy bez úskokov, sklzov a chýb.	That’s the delicate stage when the infected cell, like a zombie, is obeying the viral mandate, reading the viral genome and replicating it, but not always without skips, staggers, and mistakes.	0.315385
Podvedomie je podivuhodný úkaz.	Consciousness is a strange beast.	0.289655
Väčšinu času buď bdieme, alebo spíme. ~~~ Zďaleka to však nie sú jediné stavy, ktorými naša myseľ prechádza.	Most of the time you are either awake or asleep, yet these are far from the only statues our minds can enter.	-0.00337079
Na nasledujúcich 15 stranách sa vydáme na niektoré z týchto ciest do ľudskej mysle, počnúc od hypnózy až po spánkovú paralýzu.	Over the next 10 pages we explore some of these journeys of the mind, from hypnosis to sleep paralysis.	0.226744
Poniektoré z nich znejú možno strašidelne a exoticky, no pravdou je, že mnohí z nás v určitej etape svojho života zažijú minimálne jednu z týchto príhod.	Some of them may seem scary and exotic, but most of us experience at least one at some point in our lives.	0.15
Všetky odhaľujú tvárnosť ľudskej mysle a krehkosť zmyslu pre naše vlastné ja, tu a teraz.	All reveal the malleability of the human mind and the fragility of that sense of me, here, now.	0.288158
Užite si túto výpravu.	Enjoy the trip.	0.171429
Myslíte si, že bdiete, avšak časť vášho mozgu spí.	You think you're awake, yet part of your brain is sleeping.	0.251163
Môže sa vám to diať práve teraz, hovorí Laura Spinneyová.	It could be happening to you right now, says Laura Spinney.	0.839332
Začiatkom roku 2009 sa v časopise Sleep Medicine objavila záhadná správa o dvoch Talianoch, ktorí nikdy skutočne nespali.	Earlier this year, a puzzling report appeared in the journal Sleep Medicine. ~~~ It described two Italian people who never truly slept.	0.0267483
Hoci ležali a mali zavreté oči, výsledky merania mozgovej aktivity nepreukázali žiadne signály charakteristické pre spánok.	They might lie down and close their eyes, but read-outs of brain activity showed none of the normal patterns associated with sleep.	0.294495
Ich správanie bolo taktiež celkom zvláštne.	Their behaviour was pretty odd, too.	0.234375
Hoci väčšinou počas svojho odpočinku nevnímali okolie, prechádzali sa, ich telá sa chveli a srdcový tep narastal.	Though largely unaware of their surroundings during these rest periods, they would walk around, yell, tremble violently and their hearts would race.	0.208163
Zvyšok času síce boli pri vedomí a vnímali, no mali silnú tendenciu podliehať halucináciám, akoby práve snívali.	The remainder of the time they were conscious and aware but prone to powerful, dream-like hallucinations.	0.28022
Obom diagnostikovali neurodegeneratívne ochorenie zvané multisystémová atrofia.	Both had been diagnosed with a neurodegenerative disorder called multiple system atrophy.	0.27973
Podľa autorov správy Roberta Vetrugna a jeho kolegov z Bolonskej univerzity v Taliansku ochorenie poškodilo ich mozog do takej miery, že dosiahli disociatívny stav, akúsi zónu šera, kedy sa hranice medzi spánkom a bdením celkom zotierajú.	According to the report's authors, Roberto Vetrugno and colleagues from the University of Bologna, Italy, the disease had damaged the pair's brains to such an extent that they had entered status dissociatus, a kind of twilight zone in which the boundaries between sleep wakefulness completely break down.	0.300199
Táto skutočnosť vyvracia všetko, čo sme si o spánku vždy mysleli. Marka Mahowalda, riaditeľa Regionálneho centra pre poruchy spánku v Minneapolise (Minesota) však tento fakt neprekvapil. Práve on vyvrátil dogmu, že spánok a bdenie sú dva rôzne a odlišné stavy.	That this can happen contradicts the way we usually think about sleep, but it came as no surprise to Mark Mahowald, medical director of the Minnesota Regional Sleep Disorders Center in Minneapolis, who has long contested the dogma that sleep and wakefulness are discrete and distinct states.	0.267568
Teraz je tu jasný dôkaz, že základné stavy bytia sa navzájom nevylučujú, tvrdí Mahowald.	There is now overwhelming evidence that the primary states of being are not mutually exclusive, he says.	0.248684
Rozmazávanie hraníc medzi spánkom a bdením je typické práve pre disociatívny stav, no je presvedčený, že sa to môže stať každému z nás.	The blurring of sleep and wakefulness is very clear in status dissociatus, but he believes it can happen to us all.	0.380114
Ak má pravdu, budeme musieť prehodnotiť naše chápanie toho, čo vlastne spánok je a k čomu slúži.	If he is right, we will have to rethink our understanding of what sleep is and what it is for.	0.280263
Možno bdenie nie je fenoménom všetkého a ničoho, ako sme si doteraz mysleli.	Maybe wakefulness is not the all-or-nothing phenomenon we thought it was either.	0.276923
Podľa všeobecne známych poznatkov sa zdravý človek nachádza v jednej z troch fáz vedomia: v bdelom stave, paradoxnom (REM) spánku alebo ortodoxnom (NREM) spánku.	Received wisdom has it that at any given time, healthy people are in one of three states of vigilance: awake, in rapid eye movement (REM) sleep or in non-REM (NREM) sleep.	0.533525
Jednotlivé fázy sú odlišné a môžu byť rozoznané na základe snímok mozgovej aktivity meranej elektroencefalogramom (EEG).	Each state is distinct and can be recognised by characteristic pattern of brain activity, as measured by an electroencephalogram (EEG).	0.445339
Bdelosť je ľahké rozoznať.	Wakefulness is easy to detect.	0.2625
Okrem faktu, že človek má otvorené oči a reaguje na podnety, jeho aktivita EEG ukazuje vlny s vysokou frekvenciou a nízkou amplitúdou.	Apart from the fact that a person's eyes are open and they are responsive, their EEG shows a pattern of high-frequency, low-amplitude waves.	0.678146
Ortodoxný (NREM) spánok je rozdelený do štyroch fáz, z ktorých každá má svoj charakteristický EEG obraz.	NREM sleep is divided into four stages, each of which has its own distinctive EEG pattern.	0.421207
Paradoxný (REM) spánok je ťažšie zachytiť, lebo podľa záznamu EEG je veľmi podobný prvej fáze ortodoxného (NREM) spánku.	REM is trickier to spot because in EEG terms it closely resembles stage 1 NREM sleep.	0.337034
Aby sa odborníci uistili, že skutočne ide o paradoxný spánok, pozorujú rýchle pohyby očí a uvoľnenie svalstva brady a čeľuste.	So to be sure it really is REM, researches also look for the telltale rapid eye movements and a slackening in the muscles of the chin and jaw.	0.420635
Mahowald nie je jediný, kto sa zaoberá týmito jasnými signálmi.	Mahowald is not the only person to have questioned these neat distinctions.	0.518182
Psychiater z Pennsylvánskej univerzity vo Filadelfii David Dinges už odoprel spánok v mene vedy mnohým ľuďom.	David Dinges, a psychiatrist at the University of Pennsylvania, Philadelphia, has probably deprived more people of sleep in the name of science than anyone else.	0.340681
V jednej z týchto štúdií počas druhej polovice 80.-tych rokov Dinges a jeho tím zistil, ako ľahko sa môžu jednotlivé fázy vedomia striedať.	In one such study in the late 1980s, Dinges and his team revealed how easily the different states of vigilance can become intermingled.	0.414474
Keď boli dobrovoľníci podrobení testom pracovnej pamäte, v ktorých mali odčítavať čísla, boli schopní urobiť s malými chybami v priemere 90 výpočtov za tri minúty.	When volunteers were subjected to tests of working memory in which they had to subtract numbers, they could do an average of 90 sums in 3 minutes with few errors.	0.401952
Po 52 hodinách bez spánku ich výkon klesol na približne 70 výpočtov, pričom počet chýb sa výrazne nezmenil.	After 52 hours deprived of sleep, their performance fell to around 70 subtractions, with not many more errors.	2.18485
Po dvojhodinovom spánku však došlo k výraznej zmene.	However, after they had slept for 2 hours the change was dramatic.	0.234783
Keď sme ich náhle zobudili, cítili sa síce čulí a pripravení počítať, no nedokázali urobiť čo i len jeden výpočet, hovorí Dinges.	When we woke them up abruptly, and they rated themselves as alert and ready to go, they couln't do even one subtraction, says Dinges.	0.42493
Dokonca sa zdalo akoby stále snívali, kým sa snažili riešiť úlohu.	People even seemed to be dreaming as they attempted the task.	0.271154
Spolu s množstvom nesprávnych odpovedí prichádza podnet na zamyslenie sa: Čo ak ľudia bežali rýchlejšie než normálni ľudia bežia domov.	One subject mused: What if people ran faster than normal people run home, in the middle of a string of incorrect responses.	0.259223
Ľahšou formou takejto dezorientácie je spánková inercia, ktorá je v súčasnosti všeobecne známou príčinou slabosti, ktorú niektorí ľudia pociťujú po zazvonení budíka.	Known as sleep inertia, a less extreme version of such disorientation is now generally recognised as the cause of the grogginess some people get after their alarm clock goes off.	0.289655
Akoby boli navonok prebudení, no ich mozgové funkcie ešte spia, akoby mozgové spojenia zodpovedné za vnímanie plne fungovali, no pracovná pamäť je ešte vypnutá.	It is as if they are socially awake but functionally asleep, as if the brain circuits underlying responsiveness are up and and running, but those mediating working memory are still offline.	0.252174
Mahowald je presvedčený, že je to len jedna z mnohých porúch, ktoré možno vysvetliť ako rozpad hraníc medzi spánkom a bdením.	Mahowald is convinced that it is just one of many disorders that can be explained as a breakdown in the boundaries between sleep and wakefulness.	0.527444
V tom istom vydaní časopisu Sleep Medicine vymenoval celý rad rôznych stavov ako Vetrugnov opis ľudí s disociatívnym stavom (roč. 10, s. 159).	He lits a whole raft of such conditions in the same issue of Sleep Medicine as Vetrugnos description of people with status dissociatus (vol. 10, p. 159).	0.782645
Jednou z porúch je porucha správania v REM spánku (REM sleep behavior disorder – RBD), kedy ľudia počas REM spánku reagujú zo sna. Vtedy dochádza k prechodu z dočasnej paralýzy alebo kataplexie, ktoré zvyčajne sprevádzajú túto poruchu, k plnej mobilite a bdelosti.	One is REM behavioural disorder (RBD), in which people in REM sleep act out their dreams because the temporary paralsis, or cataplexy, that normally accompanies this state is replaced by the full mobility of wakefulness.	0.573975
Pri spánkovej paralýze dochádza k pravému opaku.	In sleep paralysis the opposite is true.	0.231429
V tomto štádiu prechádza kataplexia do stavu bdelosti, kedy sa človek po prebudení nedokáže hýbať.	Here, cataplexy intrudes into wakefulness, and a person wakes to find him or herself unable to move.	0.3
Tento zvláštny jav zažilo odhadom už vyše 40 % ľudí.	It is estimated that up to 40 percent of people have experienced this disturbing phenomenon.	3.06136
Prekvapivo bežné sú aj hypnagogické halucinácie – zmyslové obrazy, ktoré sa objavujú na prahu spánku, kedy snový komponent paradoxného spánku prechádza do bdelého stavu.	Also suprisingly common are hypnagogic hallucinations – sensory illusions that occur on the cusp of sleep when the dreaming component of REM intrudes into wkefulness.	0.411608
Mahowaldov zoznam zahŕňa taktiež námesačnosť, nočný teror a narkolepsiu, čo je vrodená nestabilita v rozoznávaní hraníc medzi bdelosťou a spánkom, ktorá zahŕňa prudké striedanie jednotlivých fáz s tendenciou zaspať uprostred vety.	Mahowald's list also includes sleepwalking, night terrors and narcolepsy, which is an inherent instability in vigilance state boundaries characterised by rapid cycling between states and the tendency to fall asleep mid-sentence.	0.296985
Zoznam zahŕňa aj také sporné témy ako zážitky blízkosti smrti a únosy mimozemšťanmi.	Controversially, the list also includes near-death experiences and alien abductions.	0.287671
Podľa Mahowalda nie je náhoda, že únosy mimozemšťanmi sa takmer vždy vyskytujú v polohe ležmo počas prechodu z bdelého stavu do spánku.	It is no coincidence, he says, that alien abductions almost always occur in the recumbent position, in the transition from wakefulness to sleep.	0.27913
Spánok je vysoko komplexný stav, v ktorom musia byť zmeny v zmyslovom, svalovom, hormonálnom a nervovom systéme vzájomne koordinované k navodeniu bdelého stavu.	Sleep is a highly complex phenomenon in which changes in sensory, muscular, hormonal and neural systems must be coordinated to create a particular state of vigilance.	0.418525
Keď sa nad tým zamyslíte, u miliardy ľudí na svete dochádza každých 24 hodín nespočetne veľakrát k striedaniu medzi jednotlivými fázami bdelosti, paradoxného (REM) a ortodoxného (NREM) spánku.	When you think about it, there are billions of pepole in the world who are shifting between wakefulness, REM and non-REM multiple times every 24 hours, says Mahowald.	1.38222
Presnosť tohto striedania je priam udivujúca, hovorí Mahowald.	It's amazing that the switching is as accurate as it is.	0.242553
Táto presnosť svedčí o existencii akejsi prispôsobivej sily, ktorá nás udržiava buď v jednej, alebo druhej fáze.	This accuracy suggests that there is a strong adaptive drive to be fully in one state or another.	0.240741
Tiež si však myslí, že disociatívny stav, teda prítomnosť viac ako jedného bdelého stavu súčasne, je bežnejší než sa zdal.	But he also thinks that state dissociation – the presence of more than one vigilance state concurrently – is more common than anyone previously suspected.	0.222115
Hranice medzi spánkom a bdením sú obzvlášť nejasné po odoprení spánku.	The boundaries between sleep and wakefulness are particularly blurred when we are sleep-deprived.	0.177049
Približne pred pätnástimi rokmi si Dinges uvedomil, že hoci jeho dobrovoľníci ochudobnení o spánok pôsobili bdelo, v skutočnosti zažívali krátkodobé mikrospánky alebo výpadky vedomia.	Around a decate ago, Dinges realised that althought his sleep- deprived volunteers seemed to be awake, they were in fact experiencing momentary lapses, or microsleeps.	0.384583
Od tej doby zistil, že tieto letmé zdriemnutia trvajú v priemere od pol sekundy až do dvoch sekúnd a sú tým frekventovanejšie, čím väčší nedostatok spánku máme, až kým už viac nedokážeme byť hore a zaspíme.	Since then, he has discovered that these fleeting naps last between half a second and 2 secons, and become increasingly frequent the longer we are deprived of sleep, until finally we cannot recover and nod off.	0.374104
Dinges ich vníma ako určitý boj medzi nervovým systémom, ktorý sa snaží spustiť spánok, a ostatnými systémami, ktoré sa snažia udržať stav bdenia.	Dinges sees them as the outward sign of a tug-of-war between neural systems that are trying to initiate sleep, and others that are trying to maintain wakefulness.	0.5212
Tieto tvrdenia sa zhodujú s myšlienkami Jamesa Kruegera z Washingtonskej štátnej univerzity v Pullmane, ktorý tvrdí, že jednotlivé spracovateľské jednotky v mozgu, známe ako kortikálne stĺpce, zaspia nezávisle od seba po tom, čo sa unavia.	This chimes with the ideas of James Krueger of Washington State University in Pullman, who has argued that the individual processing units in the brain – known as cortical columns – fall asleep independently when they become tired.	0.283077
Podľa neho k striedaniu bdelého stavu a spánku dochádza vtedy, keď je väčšina stĺpcov buď v jednom, alebo druhom štádiu (Nature Reviews Neuroscience, roč. 9, s. 910).	In his view, shifts between wakefulness and sleep occur when enough columns are in one state or the other (Nature Reviews Neuroscience, vol 9, p 910).	0.819841
Krueger verí, že táto mozaika spánku vysvetľuje spánkovú inerciu a námesačnosť.	Krueger believes this mosaic pattern of sleep explains sleep inertia and sleepwaling.	0.528571
Niektorí ľudia podliehajú mikrospánkom ľahšie než druhí.	Some people are more prone to microsleeps than others.	0.274468
Výskum jeho kolegov z roku 2007 ukázal, že existujú výrazné rozdiely v ľudskej schopnosti odolávať spánku pri únave.	In a 2007 study, Dinges and his colleagues showed that there are enormous differences in people's ability to resist the lure of sleep when tired.	1.97084
V skupine zdravých dospelých ľudí s dostatkom spánku sú rozdiely v čulosti nepatrné.	Among a group of healthy, non. sleep- deprived adults, the differences in alertness are small.	0.267123
Akonáhle však vyprovokujeme systém odoprením spánku, dochádza k väčším a väčším zmenám, hovorí Krueger (Journal of Sleep Research, roč. 116, s. 170).	But as soon as we provoke the system with some sleep deprivation, those differences get larger and larger, he says (Journal of Sleep Research, vol16, p 170).	0.945197
Týka sa to všetkých, najmä však ľudí s takou profesiou, pri ktorej je udržanie bdelého stavu otázkou života a smrti (pozri Základná kontrola majora Toma).	This has implications for all of us, especially those in professions where staying awake is a life-or-death matter (see ground control to Major Tom).	0.530551
Ak jazdíte po diaľnici rýchlosťou 100 kilometrov za hodinu a dostanete krátky výpadok vedomia, vaše prsty sa na volante uvoľnia a odkloníte sa na ceste o 4 stupne, hovorí Dinges.	If you're doing 100 kilometers per hour on a highway and you have a lapse, your fingers go lax on the steering wheel and you drift off the road at a 4 – degree angle, says Dinges.	1.73911
Stačia dve sekundy na úplné vybočenie z trate.	Two seconds is all it takes to be completely out of your lane.	0.2175
Vyše 20 percent dopravných nehôd súvisí s únavou.	Up to 20 percent of traffic accidents are fatigue-related.	4.24419
Zobrazenia mozgu odhalili duševný rezervný systém u ľudí, ktorí dokážu zotrvať v bdelosti aj po tom, čo im bol odoprený spánok (Journal of Neuroscience, roč. 29, s. 7848).	Brain imaging has recently revealed a mental back-up system in people who remain alert when sleep-deprived (Journal of Neuroscience, vol 29, p 7948).	0.760156
Kým u ostatných ľudí bola mozgová aktivita pri únave znížená, ľudia odolní voči spánku dokážu udržať úroveň mozgovej aktivity.	While other people have reducted brain activity when tired, sleep-resistant individuals manage to maintain their brain activity levels.	0.272477
Zaujímavý je aj fakt, že títo ľudia dokážu spustiť nové centrá, ktoré im pomáhajú kompenzovať dlhý čas bez spánku.	More interestingly, they also recruit new areas to help compensate for having been awake for so long.	0.261628
Týchto respondentov vybrali do výskumu kvôli špecifickej genetickej informácii objavenej u asi 40 % ľudí, ktorá podľa všetkého súvisí s odolnosťou voči zaspaniu aj po odoprení spánku.	These people were selected for the study because they had a gene variant found in around 40 percent of people that is thought to be associated with resistance to sleep deprivation.	1.46466
Zdá sa, že títo ľudia sú menej náchylní voči disociovanému stavu, hoci to ešte nie je vedecky preukázané.	It seems likely that such people are also less prone to state dissociation, although this has not yet been tested.	0.434299
Ďalšia skupina ľudí, ktorí v porovnaní s druhými vyzerajú viac čulo, sú ľudia trpiaci primárnou insomniou, ktorá nesúvisí so žiadnym iným stavom.	Another group who appear to be more vigilant than most are people who suffer from primary insomnia – insomnia not associated with any other condition.	0.2952
Existuje dôkaz, ktorý poukazuje na to, že títo ľudia sú v neustálom stave nadmernej aktivity, majú relatívne vysoké metabolické tempo a vysokú hladinu stresového hormónu kortizolu.	There is evidence to suggest they are in a constant state of hyperarousal, with relatively high metabolic rates and high levels of the stress hormone cortisol.	0.364444
Akoby niekto jednoducho spúšťal 24 hodín denne ich aktivitu, a teda sú čulí nielen v noci, no ešte viac cez deň, hovorí Mahowald.	It's as though somebody just cranked up their alertness over 24 hours, so they are more alert at night, but they are also more alert in the day, says Mahowald.	1.73611
Teória nejasných hraníc medzi spánkom a bdelosťou sa začína plno akceptovať a výskumníci ďalej hľadajú nové spôsoby na zachytenie letmých spánkov a kolísania v mozgu.	As the blur between sleep and wakefulness becomes more widely accepted, researchers are devising techniques for capturing the brain's fleeting lapses and vacillations.	0.293706
Napríklad neurovedec Giulio Tononi z Wisconsinskej univerzity v Madisone sleduje mozog ľudí počas spánku, pričom používa EEG s 256 elektródami namiesto zvyčajných 32, aby tak zvýšil priestorové rozloženie a tým uľahčil možnosť zachytiť mozog v momente chvíľkového spánku.	For example, neuroscientist Giulio Tononi of the University of Wisconsin, Madison, is eavesdropping on sleeping brains using EEGs with 256 electrodes rather than the more usual 32, to improve spatial resolution and help him catch the brain in the act of mosaic napping.	1.36771
Podľa Tononiho je mikrospánok len špičkou ľadovca.	Microsleeps are just the tip of the iceberg, Tononi says.	0.273333
Obzvlášť sa zaoberá možnosťou, že niektoré časti nášho mozgu sa môžu vypnúť bez toho, aby sme si to vôbec uvedomili.	He is particularly concerned by the possiblity that parts of our brain might be going offline without us even realising it.	0.281633
V mnohých ohľadoch je to akoby ste zažili dočasnú mentálnu poruchu a pritom o tom nikto, vrátane vás, nemusí ani vedieť, hovorí.	In many respects, it would be like having a temporary mental disorder without anybody, including yourself, being aware of it, he says.	0.413768
Ako príklad možno uviesť zábudlivosť a fantazírovanie, rovnako ako aj abnormálne, či dokonca kriminálne správanie (Pozri Keď zločin nie je zločinom).	Forgetfulness and daydreaming could be examples of this, but so could more bizzare and even criminal behaviours (See When a crime is not a crime, page 32).	0.436364
Medzitým začal Pierre Maquet z Univerzity Liège v Belgicku používať fMRI 1, aby zaznamenal obrazy mozgovej aktivity počas rozličných štádií spánku.	Meanwhile, Pierre Maquet at the University of Liège, in Belgium has started to use fMRI to chart the patterns of brain activity associated with different sleep states.	0.676278
Jeho tím postupne odhaľuje, že rozdiely medzi spánkom a bdelým stavom vyzerajú úplne inak pri porovnávaní obrazov zachytávajúcich aktivitu celého mozgu (vrátane hlbokých štruktúr), kým EEG meria aktivitu len v niekoľkocentimetrovej vonkajšej vrstve kortexu.	His team is already finding that the distinctions between sleep and wakefulness look quite different when you compare patterns of activity across the whole brain, including deep structures, as opposed to using EEG, which measures activity in just the outer few millimetres of the cortex.	0.274667
Spolu s týmito metódami prichádza aj nádej, že sa konečne objasní taká diskutovaná otázka, akou je funkcia spánku.	Lurking in the background is the hope that these approaches will shed light on the vexed issue of what sleep is for.	0.29375
Podľa hlavnej teórie je spánok dôležitý pre konsolidáciu pamäte.	A leading theory is that it is important for memory consolitadion.	0.3
Stále však zostáva nevyjasnená otázka, prečo sa u dvoch Talianov s disociatívnym stavom neprejavil žiaden deficit v pamäti, a to aj napriek kompletnému rozpadu oboch fáz REM a NREM spánku.	Yet one of the puzzling aspects of the two Italians with status dissociatus is that, despite complete disruption of both their REM and NREM sleep, they showed no memory deficit.	0.471401
Prispieva tento fakt len k názoru, že spánok nemá žiaden iný účel iba šetriť našu energiu a udržať nás v bezpečí (New Scientist 15 marec 2008, s. 30)?	Does this add grist to the mill of those who beileve that sleep has no other purpose than to save energy and keep us safe (New Scientist, 15 March 2008, p 30)?	1.73618
Alebo to znamená, že títo ľudia v skutočnosti zažili istý druh mozaikového spánku, tak ako tvrdí Mahowald?	Or does it mean, as Mahowald believes, that the two individuals were in fact experiencing some sort of mosaic sleep?	0.276923
