Prikáže bohu s hlavou barana - Chnumovi, stvoriteľovi hliny ľudstva, ktorý formuje na svojom hrnčiarskom kruhu: Choď i utvor lepšie než všetkých bohov. ~~~ Vytvor ju pre mňa, dcéru moju, ktorú som splodil.	He commands Khnum, the ram-headed god of creation who models the clay of mankind on his potter's wheel: Go, to fashion her better than all gods; shape for me, this my daughter, whom I have begotten.	-0.00823171
Je naďalej otázne, pre koho bola určená práve takáto propaganda.	Exactly who was the intended audience for such propaganda is still disputed.	0.246429
Ťažko si predstaviť, že by si Hatšepsut musela podporiť legitímnosť mocnými spojencami, akými boli veľkňazi boha Amona či členovia elity, akým bol architekt Senenmut.	It's hard to imagine Hatshepsut needed to shore up her legitimacy with powerful allies like the high priests of Amun or members of the elite such as Senenmut.	0.392727
Komu potom adresovala jej príbeh?	Who, then, was she pitching her story to?	0.25
Bohu?	The gods?	0.15
Budúcnosti?	The future?	0.272727
Nám z National Geographic?	National Geographic?	2.24
Odpoveď by sme mohli nájsť v jej odkaze na cíbika chocholatého, bežného operenca vyskytujúceho sa v močaristých oblastiach Nílu, ktorého starí Egypťania poznali pod názvom rekhyt.	One answer may be found in Hatshepsut's references to the lapwing, a common Nile marsh bird known to ancient Egyptians as rekhyt.	0.303829
V hieroglyfických textoch je slovo rekhyt zvyčajne prekladané ako obyčajní ľudia.	In hieroglyphic texts the word rekhyt is usually translated as the common people.	0.541429
Toto slovo sa často vyskytuje v nápisoch z obdobia Novej ríše, no pred pár rokmi Kenneth Griffin momentálne pôsobiaci na Univerzite v Swansea vo Walese spozoroval, že Hatšepsut používala túto frázu oveľa častejšie než ostatní faraóni 18. dynastie.	It occurs frequently in New Kingdom inscriptions, but a few years ago Kenneth Griffin, now at Swansea University in Wales, noticed that Hatshepsut made greater use of the phrase than other 18th-dynasty pharaohs.	0.424804
Zdá sa, že jej nápisy poodhaľujú osobnú asociáciu so slovom rekhyt, a to je jedinečné, vraví.	Her inscriptions seemed to show a personal association with the rekhyt which at this stage is unrivaled, he says.	0.588384
Hatšepsut často majetnícky spomínala môj rekhyt a žiadala súhlas od rekhyt, akoby táto neobyčajná panovníčka bola skrytá populistka.	Hatshepsut often spoke possessively of my rekhyt and asked for the approval of the rekhyt—as if the unusual ruler were a closet populist.	0.615789
Keď sa Hatšepsut spovedá, že jej srdce nevie, po čom túži, a že premýšľa, čo ľudia povedia, tak ľudí, ktorých mala na mysli označila slovom rekhyt. ~~~ Sú totiž takí všední ako cíbiky chocholaté na Níle.	When Hatshepsut's heart flutters this way and that as she wonders what the people will say, the people she may have had in mind were the ones as common as lapwings on the Nile, the rekhyt.	0.0177507
Po jej smrti okolo roku 1458 pred K. si jej nevlastný syn naplnil osud ako jeden z veľkých faraónov Egyptskej histórie.	After her death, around 1458 B. C., her stepson went on to secure his destiny as one of the great pharaohs in Egyptian history.	1.785
Tak ako jeho nevlastná matka, aj Thutmose III. dal postaviť množstvo pamätihodností. ~~~ No bol aj bojovníkom, aký nemal páru, a bol označený ako Napoleon starovekého Egypta.	Thutmose III was a monument maker like his stepmother but also a warrior without peer, the so-called Napoleon of ancient Egypt.	0.128082
Počas 19 rokov viedol 17 vojenských ťažení v oblasti Levant, vrátane víťazstva nad Kanaáncami v bitke pri Megide v súčasnom Izraeli, ktorý si dodnes pestuje vojenskú tradíciu.	In a 19-year span he led 17 military campaigns in the Levant, including a victory against the Canaanites at Megiddo in present-day Israel that is still taught in military academies.	0.508286
Mal mnoho manželiek a jedna z nich mu porodila následníka trónu Amenhotepa II.	He had a flock of wives, one of whom bore his successor, Amenhotep II.	0.68202
Thutmose III. si našiel čas aj na gastronómiu a egyptskú kuchyňu obohatil o kuracie mäso.	Thutmose III also found time to introduce the chicken to the Egyptian dinner table.	0.478873
V pokročilom veku, kedy by si už mohli ostatní muži pokojne spomínať na ich mladícke dobrodružstvá, si Thutmose III. zjavne krátil čas inak.	In the latter part of his life, when other men might be content to reminisce about bygone adventures, Thutmose III appears to have taken up another pastime.	0.394748
Rozhodol sa, že postupne vymaže z histórie svoju vznešenú nevlastnú matku.	He decided to methodically wipe his stepmother, the king, out of history.	0.290476
Keď si Zahi Hawass predsavzal nájsť Jeho Veličenstvo kráľovnú Hatšepsut, bol presvedčený, že tá neodetá múmia ležiacom v menšej hrobke nebola ona.	When Zahi Hawass set out to find Her Majesty King Hatshepsut, he was fairly certain of one thing: The naked mummy found resting on the floor of a minor tomb was not her.	0.532298
Keď som začal pátrať po Hatšepsut, nikdy by som si nepomyslel, že jedného dňa zistím, že táto múmia patrí práve jej, vysvetľuje Hawass.	When I started searching for Hatshepsut, I never thought I would discover that she was this mummy, Hawass says.	0.23617
Spočiatku nemala žiadny zjavný kráľovský výzor; bola zavalitá a ako Hawass uviedol v článku publikovanom v odbornom periodiku KMT, mala obrovské ovisnuté poprsie, aké by sa skôr pripisovalo jej dojke.	For starters, she had no apparent regal bearing; she was fat, and as Hawass wrote in an article published in the journal KMT, she had huge pendulous breasts of the sort more likely to be found on Hatshepsut's wet nurse.	0.477851
Pár mesiacov predtým navštívil Hawass hrobku Hatšepsut KV20, aby našiel kľúč k odhaleniu záhady jej posledného odpočinku.	Months earlier Hawass had visited Hatshepsut's tomb, KV20, to search for clues to her whereabouts.	0.600882
Hawass s klobúkom na hlave sa spustil 213 metrov do jednej z najnebezpečnejších hrobiek v Údolí kráľov.	Wearing his trademark fedora, Hawass lowered himself 700 feet into one of the most dangerous tombs in the Valley of the Kings.	0.405303
Tunel lemovaný hrboľatými bridlicami a vápencom zapáchal po netopierích výkaloch.	The tunnel through friable shale and limestone reeked of bat droppings.	0.246774
Keď v roku 1903 Howard Carter čistil tunel, vyjadril sa nasledovne: Je to jedna z najúnavnejších prác, aké som kedy riadil.	When Howard Carter cleared it in 1903, he called it one of the most irksome pieces of work I ever supervised.	0.526061
V hrobke Carter našiel dva sarkofágy s menom Hatšepsut, nejaké vápencové panely a kanopskú truhlicu, no žiadnu múmiu.	In the tomb Carter found two sarcophagi bearing Hatshepsut's name, some limestone wall panels, and a canopic chest, but no mummy.	0.746952
Carter objavil čosi v neďalekej hrobke KV60, menšej stavbe, ktorej vchod bol vytesaný do vstupnej haly hrobky KV19.	Carter made another discovery in a tomb close by—tomb KV60, a minor structure whose entrance was cut into the corridor entrance of KV19.	0.725199
V KV60 Carter našiel dve príliš obnažené múmie žien a pár mumifikovaných husí.	In KV60 Carter found two much denuded mummies of women and some mummified geese.	0.724094
Jedna múmia bola uložená v rakve, druhá ležala na zemi.	One mummy was in a coffin, the other on the floor.	0.256098
Carter vzal husi a zatvoril hrobku.	Carter took the geese and closed the tomb.	0.680184
O tri roky neskôr premiestnil iný archeológ múmiu v rakve do Egyptského národného múzea.	Three years later another archaeologist removed the mummy in the coffin to the Egyptian Museum.	0.276316
Nápis na rakve bol neskôr spájaný s opatrovateľkou Hatšepsut.	The inscription on the coffin was later linked to Hatshepsut's nurse.	0.266667
Múmiu na zemi ponechali tak, ako bola, odkedy ju tu skryli pravdepodobne kňazi počas opätovných pochovávaní za čias 21. dynastie, okolo roku 1000 pred K. ~~~ V priebehu rokov egyptológovia stratili cestu k vchodu do KV60 a múmia na zemi akoby skutočne zmizla.	The mummy on the floor was left as she was, as she had been since being stashed there, probably by priests during the reburials of the 21st dynasty, around 1000 B. C. Over the years Egyptologists lost track of the entrance to KV60, and the mummy on the tomb floor effectively disappeared.	0.51
Zmena však nastala v júni 1989, keď Donald Ryan, egyptológ a lektor na Pacifickej luteránskej univerzite vo washingtonskom meste Tacoma, prišiel preskúmať niekoľko malých neozdobených hrobiek v údolí.	That changed in June 1989, when Donald Ryan, an Egyptologist and lecturer at Pacific Lutheran University in Tacoma, Washington, came to explore several small, undecorated tombs in the valley.	0.6955
Ryan, podnietený vplyvnou egyptologičkou Elizabeth Thomasovou, zahrnul do svojej žiadosti o povolenie výskumu Thomasovej predpoklad, že v KV60 by sa mohla nachádzať múmia Hatšepsut.	Prompted by the influential Egyptologist Elizabeth Thomas, who suspected that KV60 might house Hatshepsut's mummy, Ryan had included it on his application for a research permit.	0.648235
V prvý deň práce prišiel neskoro, a tak sa Ryan túlal po okolí, aby si pripravil náčinie.	Arriving too late his first day to start work, Ryan decided to stroll around the site to drop off some tools.	0.401802
Mysliac si, že KV60 by mohla byť nablízku, prechádzal sa nad vchodom do KV19 a len tak začal zametať vchod do hrobky.	He wandered over to the entrance of KV19 and for the heck of it, thinking KV60 might be nearby, started sweeping the entranceway with his broom.	0.489736
Zametal odzadu smerom od dverí KV19.	He worked backward from the door of KV19.	0.700446
Do pol hodiny našiel trhlinu v kamennej chodbe.	Within half an hour he'd found a crack in the rock corridor.	0.234146
Kamenné dvierka poodhalili schodisko.	A stone hatch revealed a set of stairs.	0.281818
O týždeň neskôr za sprievodu Beethovenovej Patetickej sonáty hrajúcej z magnetofónu vstúpil Ryan s miestnym dozorcom starožitností do stratenej hrobky.	A week later, with Beethoven's Pathétique Sonata playing on a tape deck, he and a local antiquities inspector entered the lost tomb.	0.24375
Bolo to strašidelné, spomína si.	It was spooky, he recalls.	0.221739
Ešte nikdy predtým som neobjavil múmiu.	I had never found a mummy before.	0.225
S dozorcom sme veľmi opatrne vstúpili dnu.	The inspector and I walked in very carefully.	0.283784
Na zemi ležala akási žena.	There was a woman lying on the floor.	0.195652
Preboha!	Oh my gosh!	0.266667
Múmia po celé tie roky ležala v hrobke, ktorú v časoch starovekého Egypta vyrabovali zlodeji.	The mummy was lying in a tomb that had been trashed in ancient times by robbers.	0.236364
Ľavú ruku mala prekríženú cez hruď v pozícii, v akej sa s najväčšou pravdepodobnosťou bežne pochovávali egyptské kráľovné 18. dynastie.	Her left arm was crooked across her chest in a burial pose some believe to be common to 18th- dynasty Egyptian queens.	0.241837
Ryan sa pustil do súpisu toho, čo objavil.	Ryan set about cataloging what he found.	0.666429
Našli sme rozbitú prednú časť rakvy a zoškriabané škvrny od zlata, spomína.	We found the smashed-up face piece of a coffin and flecks of gold that had been scraped off, he recalls.	0.433846
Nevieme, ako veľmi hýbal Howard Carter s Hatšepsut, tak sme to zdokumentovali ako neporušené nálezisko.	We didn't know how much had been moved around by Howard Carter, so we documented it as an intact site.	0.466071
V postrannej miestnosti našiel Ryan obrovskú hŕbu baliaceho materiálu, mumifikované kravské nohy a nahromadenú kopu zásobovacích múmií, t. j. zabalené batôžky jedla uskladnené pre nebožtíka na cestu večnosťou.	In a side chamber Ryan found a huge pile of wrappings, a mummified cow's leg, and a stacked pile of victual mummies, wrapped bundles of food laid up for the deceased's long journey through eternity.	0.474169
Čím viac Ryan skúmal múmiu, tým si bol istejší, že by mohla byť významnou osobnosťou.	The more Ryan studied the mummy, the more he thought she might be someone important.	0.483275
Bola neobvykle dobre mumifikovaná, vysvetľuje.	She was extraordinarily well mummified, he says.	0.3
Ležala v kráľovskej pozícii.	And she was striking a royal pose.	0.265385
Pomyslel som si: No veď ona je kráľovná!	I thought, Why, she's a queen!	0.207692
Mohla by to byť Hatšepsut?	Could it be Hatshepsut?	0.271429
Je to možné.	Possibly.	0.27
Múmia sa ale nepodobala na akúkoľvek konkrétnu osobu.	But there was nothing to link the mummy to any specific individual.	0.23617
No aj tak nebolo správne nechať ju ležať nahú na zemi medzi rozhádzanými handrami, nech už bola ktokoľvek.	Still, it didn't seem right to leave whoever she was lying naked on the floor in a mess of rags.	0.253846
Predtým, než Ryan zavrel hrobku, spolu s kolegami narýchlo upratal pohrebnú miestnosť.	Before he closed the tomb, Ryan and a colleague tidied the burial chamber up a bit.	0.500334
V miestnom tesárstve si nechali zhotoviť jednoduchú rakvu.	At a local carpenter's shop they had a simple coffin built.	0.288
Neznámu dámu vložili do jej nového lôžka a uzavreli krytom.	They lowered the unknown lady into her new bed and closed the lid.	0.276471
Hatšepsutino predĺžené obdobie anonymity sa chýlilo ku koncu.	Hatshepsut's prolonged period of anonymity was nearing its end.	0.627879
Historici už dlho stavali Hatšepsut do úlohy zlej macochy mladého Thutmosa III.	Historians long cast Hatshepsut in the role of evil stepmother to the young Thutmose III.	0.500334
Informácie o jej údajnej krutosti boli odplatou Hatšepsutinho nevlastného syna, keď po jej smrti napadol jej pamätihodnosti a vymazal jej kráľovské meno z verejných pamiatok.	The evidence of her supposed cruelty was the payback she posthumously received when her stepson had her monuments attacked and her kingly name erased from public memorials.	0.291837
Thutmose III. skutočne zasiahol do ikonografie kráľovnej Hatšepsut tak dokonale, ako pobil Kanaáncov pri Megide.	Indeed, Thutmose III did as thorough a job smiting the iconography of King Hatshepsut as he had whacking the Canaanites at Megiddo.	0.451136
Jej podobizeň a kartuša, či symbol mena, sa odstránili zo stien svätyne v Karnaku. ~~~ Texty na jej obeliskoch sa prekryli kameňom, čím sa dosiahol neúmyselný efekt ich pôvodného stavu.	At Karnak her image and cartouche, or name symbol, were chiseled off shrine walls; the texts on her obelisks were covered with stone (which had the unintended effect of keeping them in pristine condition).	-0.0163462
V Deir el Bahri, mieste jej najokázalejšieho architektonického úspechu, sa jej sochy porozbíjali a vyhodili do jamy pred jej zádušným chrámom.	At Deir el Bahri, the site of her most spectacular architectural achievement, her statues were smashed and thrown into a pit in front of her mortuary temple.	0.823503
Chrám je známy ako Djeser Djeseru, svätyňa nachádzajúca sa na západnom brehu Nílu, na druhej strane od novodobého Luxoru. ~~~ Chrám sa rozprestiera oproti zátoke obkolesenej útesmi farby leva, ktoré rámujú žltohnedé kamene chrámu tak, ako nemes (pokrývka hlavy) rámuje tvár faraóna.	Known as Djeser Djeseru, holy of holies, on the west bank of the Nile across from modern Luxor, the temple is set against a bay of lion-colored cliffs that frame the tawny temple stones the way the nemes frames a pharaoh's face.	0.0288462
Djeser Djeseru sa s tromi poschodiami, stĺporadím, priestrannými terasami spojenými naklonenými plošinami, so zaniknutou papyrusovou nádržou v tvare písmena T, myrhovníkmi slúžiacimi ako tienidlá a chodníkom lemovaným sfingou zaraďuje medzi najúchvatnejšie chrámy, aké kedy boli postavené.	With its three tiers, its porticoes, its spacious ramp-linked terraces, its now vanished sphinx-lined causeway and T-shaped papyrus pools and shade- casting myrrh trees, Djeser Djeseru is among the most glorious temples ever built.	0.387006
Pravdepodobne ho navrhol staroveký architekt Senenmut ako centrum kultu kráľovnej Hatšepsut.	It was designed (perhaps by Senenmut) to be the center of Hatshepsut's cult.	0.216923
Predstavy o Hatšepsut ako o kráľovnej sa zachovali neporušené, ale kdekoľvek sa vyhlásila za kráľa, tam nastúpili služobníci jej nevlastného syna s dlátami a vandalizmus vykonali starostlivo a precízne.	Images of her as queen were left undisturbed, but wherever she had proclaimed herself king, the workers of her stepson followed with their chisels, the vandalism careful and precise.	0.26129
Ničenie nebolo emocionálnym rozhodnutím. ~~~ Bol za tým politický zámer, vraví Zbigniew Szafrański, riaditeľ poľsko-egyptskej archeologickej delegácie, ktorý pracoval na Hatšepsutinom zádušnom chráme od roku 1961.	The destruction was not an emotional decision; it was a political decision, says Zbigniew Szafrański, the director of the Polish archaeological mission to Egypt that has been working at Hatshepsut's mortuary temple since 1961.	0.159243
Kým bagre koncom 90. rokov 19. storočia odpratávali sutiny zo značne zničeného chrámu, záhada týkajúca sa Hatšepsut nabrala na sile. ~~~ Akou panovníčkou bola?	By the time excavators cleared the debris from the mostly buried temple in the late 1890s, the mystery of Hatshepsut had been refined: What kind of ruler was she?	-0.00111111
Odpoveď sa zdá byť zrejmá niekoľkým egyptológom, ktorí sa rýchlo chopili myšlienky, že Thutmose III. zaútočil na pamiatku Hatšepsut, aby sa pomstil za jej trúfalé prisvojenie si panovníckej moci.	The answer seemed self-evident to a number of Egyptologists quick to embrace the idea that Thutmose III had attacked Hatshepsut's memory as revenge for her shameless usurpation of his royal power.	0.398204
William C. Hayes, kurátor egyptského umenia v Metropolitnom múzeu umenia a riaditeľ vykopávok v Deir el Bahri v 20. a 30. rokoch 20. storočia napísal v roku 1953 toto: Netrvalo dlho, kým sa táto márnivá, ambiciózna a bezohľadná žena ukázala v celej svojej sile.	William C. Hayes, the curator of Egyptian art at the Metropolitan Museum of Art and a principal at the Deir el Bahri excavations in the 1920s and '30s, wrote in 1953: It was not long … before this vain, ambitious, and unscrupulous woman showed herself in her true colors.	0.759817
Keď v 60. rokoch minulého storočia archeológovia objavili dôkazy naznačujúce, že vyhnanstvo Jeho Kráľovského Veličenstva Hatšepsut začalo najmenej dvadsať rokov po jej smrti, skočila sa telenovela o prchkom nevlastnom synovi prahnúcom po odvete jeho bezohľadnej macoche.	When archaeologists discovered evidence in the 1960s indicating that the banishment of King Hatshepsut had begun at least 20 years after her death, the soap opera of a hotheaded stepson wreaking vengeance on his unscrupulous stepmother fell apart.	0.264455
Ďalší možný a o čosi logickejší scenár vravel o potrebe Thutmosa III. posilniť legitímnosť následníctva svojho syna Amenhotepa II. navzdory konkurenčnému nároku ostatných členov rodiny.	A more logical scenario was devised around the possibility that Thutmose III needed to reinforce the legitimacy of his son Amenhotep II's succession in the face of rival claims from other family members.	0.281481
Hatšepsut, ktorá bola kedysi osočovaná pre jej nemilosrdnú ctižiadostivosť, je dnes obdivovaná pre svoju politickú taktnosť.	And Hatshepsut, once disparaged for ruthless ambition, is now admired for her political skill.	0.197561
Nikto ani len netuší, aká v skutočnosti bola, myslí si Catharine Roehringová, súčasná kurátorka sekcie, ktorú predtým spravoval Hayes.	Nobody can know what she was like, says Catharine Roehrig, now a curator in the same department once headed by Hayes.	0.541837
Vládla dvadsať rokov, pretože mala schopnosť uviesť veci do pohybu.	She ruled for 20 years because she was capable of making things work.	0.294828
Som presvedčená, že bola veľmi rozvážna a dokázala manipulovať ľuďmi bez toho, aby ich zavraždila, prípadne oni ju.	I believe she was very canny and that she knew how to play one person off against the next—without murdering them or getting murdered herself.	0.239394
Bezprostredne dve desaťročia po tom, čo Donald Ryan znovuobjavil umiestnenie KV60, požiadal Zahi Hawass kurátorov Egyptského múzea, aby zhromaždili všetky neidentifikované múmie pravdepodobných kráľovien 18. dynastie, vrátane dvoch tiel, ktoré sa našli v KV60.	Close to two decades after Donald Ryan rediscovered the location of KV60, Zahi Hawass asked the curators at the Egyptian Museum to round up all the unidentified and possibly royal female mummies from the 18th dynasty, including the two bodies—one thin, one fat—that had been found in KV60.	0.794549
Jedno z tiel bolo štíhle a druhé korpulentné. ~~~ Štíhlu múmiu získali z úschovy v podkroví múzea. ~~~ Druhú, robustnejšiu, označenú ako KV60a a ponechanú v hrobke, v ktorej sa našla, previezli z Údolia kráľov.	The thin mummy was retrieved from storage in the museum's attic; the fat one, KV60a, which had remained in the tomb where it had been found, was transported from the Valley of the Kings.	-0.114074
Počas štyroch mesiacov koncom roka 2006 a začiatkom 2007 opakovane prechádzali múmie cez CT skener, ktorý ich archeológom umožnil dôkladne preskúmať a odhadnúť ich vek a príčinu smrti.	Over a four-month period in late 2006 and early 2007, the mummies passed through a CT scanner that enabled the archaeologists to examine them in detail and to gauge their age and cause of death.	0.708097
CT skenerom prešli štyri mumifikované kandidátky, no bezvýsledne.	The CT results from the four candidate mummies were inconclusive.	0.622807
Keď však schránka prešla skenerom, výskumníci zostali zaskočení. ~~~ V schránke sa nachádzal zub.	When the box was run through the scanner, the researchers were astonished to detect a tooth.	-0.0115385
Tím zubárov ho označil za druhú stoličku s chýbajúcou časťou koreňa.	The team dentist identified it as a secondary molar with part of its root missing.	0.249153
Ashraf Selim, profesor rádiológie Káhirskej univerzity znovu prekontroloval snímky čeľuste štyroch múmií.	When Ashraf Selim, professor of radiology at Cairo University, reexamined the jaw images of the four mummies, there in the right upper jaw of the fat mummy from KV60 was a root with no tooth.	0.562591
V čeľusti korpulentnejšej múmie z KV60 sa vpravo dole nachádzal koreň bez zuba.	I measured the root in the mummy and the tooth, and we found that they both matched, Selim says.	0.251471
Meral som koreň v ústnej dutine múmie aj spolu so zubom a zistili sme, že sa zhodujú, vraví Selim.	To be sure, the scientists have proved only that a tooth in a box belongs to a mummy.	0.405721
Isteže, vedci dokázali len to, že zub zo schránky patrí múmii.		-0.3
Identifikácia je založená na predpoklade, že obsah schránky sa správne označil a že bol kedysi životne dôležitou súčasťou slávnej faraónky.	The identification is based on the assumption that the contents of the box are properly labeled and were once vital parts of the famous female pharaoh.	0.285124
Schránka označená Hatšepsutinou kartušou nie je bežná kanopská váza, v akej by sa nachádzali mumifikované orgány.	And the box inscribed with Hatshepsut's cartouche is not the typical canopic vessel in which mummified organs are found.	0.287879
Nie je kamenná, ale drevená a mohla by sa vyžívať na uskladnenie šperkov, olejov či drobných cenností.	It's made of wood, not stone, and might have been used to hold jewelry or oils or small valuables.	0.277778
Niekto by povedal, že sme nenašli jasný dôkaz, tvrdí Selim.	Some would say we have not found absolute proof, Selim says.	0.3
Súhlasil by som.	And I would agree.	0.28
V schránke spájanej s Hatšpsut a nájdenej v tajomnej miestnosti kráľovských múmií sa nachádza zub, ktorý dokonale zapadne do bezzubého úsmevu múmie ležiacej vedľa milovanej opatrovníčky významnej egyptskej faraónky.	The cache of royal mummies contains a tooth that exactly matches a hole in the smile of a mummy found next to the beloved nurse of Egypt's great female pharaoh?	0.272727
Je skvelé, že sa našiel zub, ktorý spojil Hatšepsutinu kartušu s múmiou.	And how marvelous that the tooth was there to connect Hatshepsut's cartouche with a mummy.	0.227419
Ak by ten zub balzamovači neboli bývali zdvihli a nevložili dovnútra spolu s pečeňou, určite by sme neprišli na to, čo sa Hatšepsut prihodilo, dodáva Hawass.	If the embalmer hadn't picked it up and put it in with the liver, there is no way we would have known what happened to Hatshepsut, Hawass says.	0.258974
Vyvrátením teórie, že Hatšepsut by mohol zavraždiť jej nevlastný syn, CT skenery zmenili históriu.	Already the CT scans have changed history, dispelling theories that Hatshepsut might have been killed by her stepson.	0.647674
Pravdepodobne zomrela na infekciu spôsobenú hnisavým vačkom pod zubom, no na zdravotnom stave jej nepridali ani komplikácie s pokročilým štádiom rakoviny kostí a možný diabetes.	She probably died of an infection caused by an abscessed tooth, with complications from advanced bone cancer and possibly diabetes.	0.334008
Hawass sa zamýšľal aj nad tým, či mohli veľkňazi boha Amona premiestniť jej telo do hrobky jej pestúnky, aby ho ochránili pred vykrádačmi hrobov.	Hawass speculates that the high priests of Amun may have moved her body to the tomb of her nurse to protect it from looters; many royalty of the New Kingdom were hidden in secret tombs for security.	0.322439
Múmie mnohých panovníkov z obdobia Novej ríše sa z dôvodov bezpečnosti ukryli do tajných hrobiek.	As for the DNA tests, the first round began in April 2007 and has shown nothing definitive.	0.268421
Pokiaľ ide o testy DNA, prvá fáza testov sa začala v apríli 2002, avšak nepriniesla končené výsledky.		-0.3
Pri starodávnych vzorkách nemáte nikdy stopercentnú zhodu, pretože genetické reťazce nie sú ucelené, vysvetľuje Anguélique Corthalsová, profesorka biomedicíny a forenzných disciplín na Univerzite Stony Brooks v New Yorku, ktorá je aj zároveň jednou z troch konzultantiek pracujúcich s Egypťanmi.	With ancient specimens you never have a 100 percent match, because the genetic sequences aren't complete, says Angélique Corthals, a professor of biomedicine and forensic studies at Stony Brook University in New York and one of three consultants working with the Egyptians.	0.492811
Posvietili sme si na mitochondriálnu DNA možnej Hatšepsutinej múmie a jej starej mamy Ahmose Nefertari.	We looked at mitochondrial DNA for the suspected Hatshepsut mummy and her grandmother Ahmose Nefertari.	0.8625
Existuje približne 30 až 35-percentná šanca, že tieto dve vzorky nie sú pokrvné príbuzné, no nemôžem sa spoliehať len na to, že to sú len predbežné výsledky.	There is about a 30 to 35 percent chance that the two samples are not related, but I cannot emphasize enough that these are just preliminary results.	0.494931
Ďalšie kolo testov by mohlo už čoskoro priniesť jasnejší verdikt.	Another round of tests may soon deliver a clearer verdict.	0.258
Na jar minulého roka požiadal fotograf Kenneth Garreth riaditeľku Egyptského múzea v Káhire Wafaa El Saddikovú, či by mohla posúdiť zoznam Hatšepsutiných klenotov, ktoré by rád odfotografoval pre tento článok – vápencovú sfingu Hatšepsut zo sutín jej chrámu, drevenú schránku ukrývajúcu zub, vápencovú bustu Hatšepsut prezlečenú za boha podsvetia Usira.	Last spring photographer Kenneth Garrett asked Wafaa El Saddik, director of the Egyptian Museum in Cairo, to review a list of Hatshepsut treasures he hoped to photograph for this article: a limestone sphinx of Hatshepsut from the ruins of her temple, the wooden box containing the tooth, a limestone bust of Hatshepsut in the guise of the underworld god Osiris.	0.47449
El Saddiková prišla na posledný bod zoznamu - mumifikované telo samotnej Hatšepsut.	El Saddik came to the final item on the list: the mummified body of Hatshepsut herself.	0.530769
Želáte si, aby sme odsunuli sklo? spýtala sa nedôverčivo, akoby stáročia zanedbávaná múmia vlastnila niečo nevýslovne vzácne.	You want us to remove the glass? she asked incredulously, as if the mummy, long neglected, now possessed something unspeakably precious.	0.280909
Náš fotograf prikývol a riaditeľka sa zachvela.	The photographer nodded.	0.0521739
riaditeľka sa zachvela.	The director shuddered.	0.3
Toto sú svetové dejiny, o ktorých rozprávame! zvolala.	This is the history of the world we're talking about! she exclaimed.	0.2375
Nakoniec nariadila, že jedna sklenená tabuľa sa môže preniesť z vitríny nachádzajúcej sa v miestnosti kráľovských múmií bez toho, aby boli ohrozené svetové dejiny.	In the end, it was decreed that one of the panels of glass could be removed from the case in the Royal Mummy Room without jeopardizing the history of the world.	0.277099
Ako som upieral pohľad na pozostatky významnej egyptskej panovníčky a pripravovali sa svetlá, pristihol som sa pri myšlienke, prečo bolo také dôležité skúmať jej telo.	Staring at what was left of the great female pharaoh as the lights were being set up, I found myself wondering why it was so important to authenticate her corpse.	0.277612
Nejestvuje nič, čo by mohlo vdýchnuť život do úžasnej histórie starovekého Egypta než skutočná žena uchovávaná navzdory prírode a hnilobným procesom.	On the one hand, what could better animate the astonishing history of ancient Egypt than the actual woman preserved in defiance of nature and the forces of decay?	0.286154
Bola tu medzi nami ako veľvyslankyňa staroveku.	Here she was now, among us, like an ambassador of antiquity.	0.235714
Ale čo sme od nej vlastne chceli?	On the other hand, what did we want from her?	0.203571
Nebolo niečo neznesiteľne morbídne na zvedavosti, ktorá prilákala milióny zvedavcov do miestností s kráľovskými múmiami a ktorá v nich vyvolala históriu ohľadom kráľovského úmrtia?	Wasn't there something oppressively morbid about the curiosity that brought millions of rubberneckers to the Royal Mummy Rooms and made a fetish of the royal dead in the first place?	0.412208
Čím dlhšie som hľadel na Hatšepsut, tým viac som sa odvracal od tých záhadných očí a šokujúco zachovaného neživého mäsa.	The longer I stared at Hatshepsut, the more I recoiled from those unfathomable eyes and the suffocating fixity of that lifeless flesh.	0.264706
Väčšina z nás žije podľa kréda cíbika, ktoré je protikladom viery faraónov – popol na popol, prach na prach.	Most of us live by the lapwing creed that is the antithesis of the pharaohs' faith: ashes to ashes, dust to dust.	0.293407
Ohromilo ma, koľko zo života Hatšepsut sa dá vnímať v jej textoch, v ktorých je dodnes aj po mnohých tisíckach rokov prítomná spoveď jej srdca.	It struck me how much more of Hatshepsut was alive in her texts, where even after so many thousands of years, you can still feel the flutter of her heart.	0.285
V živote nie je dôležité to, čo vieme, ale to, čo robíme.	The great end of life is not knowledge but action.	0.264286
Na popísanie toho, o čom je táto kniha, stačia dve slová: DOSAHOVANIE VÝSLEDKOV!	Two words describe what this book is about: PRODUCING RESULTS!	0.216667
Ja si pod pojmom úspech predstavujem neustálu snahu stať sa niečím viac.	To me, success is the ongoing process of striving to become more.	0.261818
Cestu k nemu musíme budovať neustále. ~~~ Keď som sa riadil technikou opísanou v tejto knihe, za veľmi krátky čas som dosiahol prekvapivé výsledky.	The road to success is always under construction, and by applying the technology in this book, I was able to produce astonishing results in a very short period of time.	-0.0193548
V každom z nás je sila premeniť svoje sny na skutočnosť.	The power to magically transform our lives into our greatest dreams lies waiting within us all.	0.0829787
Je načase ju prebudiť!	It's time to unleash that power!	0.18
Pre mnoho ľudí je sila veľmi sugestívne slovo a v niektorých vyvoláva negatívne asociácie. ~~~ Ja ju ale vnímam ako schopnosť dosahovať želané výsledky a zároveň obohatiť ostatných.	Power is a very emotional word for many people, and has a negative connotation for some people, but to me, ultimate power is the ability to produce the results you desire most and create value for others in the process.	0.0737013
Skutočná sila spočíva v schopnosti podeliť sa, nie byť egoistom.	Real power is shared, not imposed.	0.04
Je to schopnosť charakterizovať ľudské potreby a uspokojiť tie svoje, a aj potreby ľudí, na ktorých vám záleží.	It's the ability to define human needs and fulfill them both your needs and the needs of the people you care about.	0.457895
Žijeme síce v informačnom veku, ale na to, aby sme dosiahli želané výsledky, nám samotné informácie nestačia.	Although we're in an information age, information is not enough to produce the results we want.	0.251852
Vedomosti sú len potenciálna sila.	Knowledge is only potential power.	0.3
Za každým úspechom stoja činy.	Action is what unites every success.	0.244444
Pre mňa je skutočnou silou schopnosť konať.	For me, real power is the ability to act.	0.264706
Výsledok, ktorý v živote dosiahneme, závisí od toho, ako sami so sebou komunikujeme.	The results we get in life is determined by how we communicate to ourselves.	0.257812
V dnešnom svete sa kvalita života rovná kvalite komunikácie.	In the modern world, the quality of life is the quality of communication.	0.249057
Všetko, čo si povieme a predstavíme, ako sa hýbeme a zapájame svaly, aj naša mimika ovplyvňuje to, do akej miery svoje znalosti využijeme.	What we picture and say to ourselves, how we move and use the muscles of our bodies and our facial expressions will determine how much of what we know we will use.	0.258974
Každý z nás komunikuje dvoma spôsobmi, ktoré formujú naše životné skúsenosti.	We all produce two forms of communication from which the experience of our lives is fashioned.	0.247059
Najprv prebieha vnútorná komunikácia: veci, ktoré si predstavujeme, hovoríme a cítime vo svojom vnútri.	First, we conduct internal communications: those things we picture, say, and feel within ourselves.	0.286207
Stupeň spokojnosti, ktorý dosiahnete – šťastie, radosť, extáza, láska alebo čokoľvek, čo si želáte – je priamym výsledkom vnútornej komunikácie.	The level of success you experience internally - the happiness, joy, ecstasy, love or anything you desire - is the direct result of how you communicate to yourself.	0.271429
Nie životné udalosti ako také, ale vaše vnímanie týchto udalostí ovplyvňuje to, čo cítite.	How you feel is not the result of what is happening in your life - it is your interpretation of what is happening.	0.242308
VŠETKO MÁ IBA TAKÝ VÝZNAM, AKÝ TOMU MY SAMI PRIPÍŠEME.	NOTHING HAS ANY MEANING EXCEPT THE MEANING WE GIVE IT through our internal communication.	0.0978261
Ďalším druhom komunikácie je vonkajšia: slová, intonácia, mimika, postoj a gestá, prostredníctvom ktorých komunikujeme s okolitým svetom.	Secondly, we experience external communications: words, tonalities, facial expressions, body postures, and physical actions to communicate with the world.	0.263115
Obe formy komunikácie - vnútorná aj vonkajšia - sú impulzom produkujúcim efekt.	Every communication we make - internal and external - is an action, a cause set in motion, and that cause produces an effect.	0.609365
Vytváranie citov prostredníctvom vnútornej komunikácie môžete vnímať podobne ako prácu filmového režiséra.	You might think of the process of producing emotional states by managing your internal communication as being similar to a director's job.	0.23125
Ten rozhoduje o tom, čo budete vidieť a počuť, aby u vás zámerne vyvolal určitú reakciu.	To produce the precise results (s)he wants, the director of a movie manipulates what you see and hear.	0.427822
Ak sa naučíte podobným spôsobom riadiť svoj vnútorný film, výsledky sa dostavia v reálnom živote.	Likewise, if you can learn to manipulate your internal movie, you will be able to create the external results you want in your life.	0.207143
Povedzme, že sa už nejaké výsledky dostavili.	You're already producing results.	0.212903
Možno však nie také, aké ste si predstavovali.	They just may not be the results you desire.	0.275676
Väčšina ľudí zastáva názor, že nad svojím vnútorným rozpoložením a myšlienkovými pochodmi nemá žiadnu kontrolu.	Most of us think of our mental states and most of what goes on in our minds as things that happen outside our control.	0.29375
Ale opak je pravdou. ~~~ Svoju myseľ a reakcie môžete regulovať do väčšej miery, ako si dokážete predstaviť.	But the truth is you can control your mental activities and your behaviors to a degree you never believed possible before.	0.0425595
Ak ste deprimovaní, vo svojom filme ste vnútornou komunikáciou vytvorili scénu nazvanú depresia.	If you're depressed, you created and produced the scene in the movie you call depression by the way you communicated to yourself internally with your mind and body.	0.112941
Tvorba depresie, extázy, alebo akéhokoľvek citového rozpoloženia vyžaduje určité kroky.	It takes specific actions to produce depression or ecstasy, or any emotional state.	0.270833
Ak sa ich naučíte ovládať, budete mať kontrolu nad svojimi emóciami i správaním.	Learning to manipulate these actions will lead you to control of your emotions and your behavior.	0.23913
Myseľ môžete riadiť tak šikovne, ako to na pľaci robí Steven Spielberg.	You can run your brain as skillfully as Steven Spielberg runs his set.	0.5206
Každá kapitola tejto knihy sa zameriava na iný aspekt toho, ako sa ju naučiť ovládať.	Each chapter of this book deals with some aspect of how to run your brain.	0.245902
Ľudia, ktorí majstrovsky zvládli toto umenie, podnikli presné kroky, ktoré ich priviedli k cieľu.	People who have attained excellence follow a consistent path to success.	0.195238
Nazývam ich Základný vzorec úspechu.	I call it the Ultimate Success Formula.	0.290909
Skladá z týchto štyroch bodov: ZÁKLADNÝ VZOREC ÚSPECHU	Here are the four steps: THE ULTIMATE SUCCESS FORMULA	0.286957
1) VYTÝČTE SI CIEĽ – presne definujte, čo chcete	1) KNOW YOUR OUTCOME - precisely define what you want	0.570732
2) KONAJTE	2) TAKE ACTION	1.21
3) NAUČTE SA ROZPOZNAŤ, ČI SA K CIEĽU PRIBLIŽUJETE, ALEBO SA OD NEHO VZĎAĽUJETE	3) DEVELOP SENSORY ACUITY TO RECOGNIZE THE KINDS OF RESPONSES YOU'RE GETTINGARE YOU GETTING CLOSER TO YOUR OUTCOME, OR FURTHER AWAY FROM IT?	0.267164
4) BUĎTE FLEXIBILNÍ A AK SA NEPRIBLIŽUJETE K SVOJMU CIEĽU, VYBERTE SA INOU CESTOU;	4) DEVELOP FLEXIBILITY TO CHANGE YOUR APPROACH IF YOU'RE NOT GETTING CLOSER TO YOUR OUTCOME.	0.461429
Steven Spielberg, John F. Kennedy, Martin Luther King ml., Ted Turner, Tina Turner, Pete Rose a Dean Barbara Black z právnickej fakulty Kolumbijskej univerzity sú ľudia, ktorí sa v živote riadili Základným vzorcom úspechu. ~~~ Všetci v sebe vypestovali sedem základných spúšťacích mechanizmov, ktoré im dodali silu spraviť všetko potrebné na úspech.	Steven Spielberg, John F. Kennedy, Martin Luther King Jr., Ted Turner, Tina Turner, Pete Rose, and Dean Barbara Black of the Columbia University School of Law, are people that applied the Ultimate Success Formula in their lives, and who also shared what I believe are seven fundamental character traits that they have all cultivated within themselves that give them the fire to do whatever it takes to succeed.	0.564135
7 ZÁKLADNÝCH SPÚŠŤACÍCH MECHANIZMOV	7 FUNDAMENTAL CHARACTER TRAITS OF SUCCESS	6.86364
1) VÁŠEŇ – dáva životu energiu, šťavu a zmysel.	1) PASSION - gives life power, juice, and meaning.	0.5775
Či už túžite byť skvelými rodičmi, športovcami, vedcami, umelcami alebo obchodníkmi, bez zanietenia sa nimi nestanete (pozri 9. kapitolu);	There is no greatness without a passion to be great - great parent, athlete, scientist, artist, businessperson (see Chapter XI)	0.266972
2) VIERA – nadšenie a viera dláždia cestu k dokonalosti (pozri 4. a 5. kapitolu);	2) BELIEF - passion and belief provide the fuel toward excellence (see Chapters IV, V)	0.465441
3) STRATÉGIA – spôsob organizovania prostriedkov (7. a 8. kapitola);	3) STRATEGY - a way of organizing resources (Chapters VII, VIII)	0.818182
4) SYSTÉM HODNÔT – rebríček hodnôt z etického, mravného a praktického hľadiska (18. kapitola);	4) CLARITY OF VALUES - the fundamental ethical, moral, and practical evaluations we make about what's most important in our lives (Chapter XVIII)	0.346341
5) ENERGIA – všetci ľudia, ktorí dosiahli dokonalosť, mali energiu chytiť sa každej šance a využiť ju (9. a 10. kapitola);	5) ENERGY - people of excellence have all have the energy to take opportunities and shape them (Chapters IX, X)	0.410599
6) SCHOPNOSŤ VYTVÁRAŤ VÄZBY - schopnosť spojiť sa s ľuďmi v hĺbke svojho srdca (13. kapitola);	6) RAPPORT-BONDING POWER - the ability to connect with people at a deepest levels of your heart (Chapter XIII)	0.604191
7) DOKONALÉ OVLÁDANIE KOMUNIKÁCIE – podstata tejto knihy.	7) MASTERY OF COMMUNICATION - the essence of what this book is about.	0.592157
Neúspešní ľudia vnímajú nepriazne osudu ako obmedzenia. ~~~ Tí úspešní sa naučili tieto nešťastia prijať ako výzvu, ktorá ich posilní.	People who fail take the adversities of life and accept them as limitations; people who succeed have learned to turn those adversities into challenges that teach them strength.	-0.0456522
Ľudia, ktorí formujú naše životy a kultúru, majú tiež schopnosť ostatným predostrieť víziu, otázku, alebo na nich preniesť radosť či životné poslanie.	The people who shape our lives and our cultures also have the ability to communicate a vision or a quest or a joy or a mission to others.	0.379083
Každá kapitola tejto knihy sa určitým spôsobom zaoberá dokonalým ovládaním vnútornej a vonkajšej komunikácie.	Every chapter of this book deals in some way with mastery of internal and external communication.	0.249398
Kniha sa delí na 3 časti:	This book is divided into 3 parts:	4.9
1. časť: Naučte sa efektívnejšie využívať svoju myseľ a telo.	Part 1: How to take charge of and run your own brain and body more effectively.	0.232075
2. časť: Zistite, čo skutočne v živote chcete a efektívnejšie komunikujte s ostatnými.	Part 2: Discover what you really want in your life and communicate more effectively with others.	0.272
3. časť: Odhaľte, čo vás motivuje a ako môžete svoju motiváciu ešte zvýšiť.	Part 3: Discover what motivates us, what we can contribute on a larger, global scale.	0.476786
Čo keby existoval spôsob, ako značne zrýchliť proces učenia? Čo keby ste sa mohli naučiť za niekoľko minút to, v čom sa iní zdokonaľovali celé roky?	What if there was a way to take action that greatly accelerated the learning process - what if you could learn in minutes what someone took years to perfect?	0.285484
NAPODOBŇOVANIE! – pozri 2. kapitolu.	MODELING! - see Chapter II.	0.1875
1. KAPITOLA – KĽÚČOVÉ BODY	CHAPTER I - KEY POINTS	0.236842
To, čo v živote dosiahneme (naše ciele) je podmienené tým, ako sami so sebou komunikujeme.	What we do (our results) in life is determined by how we communicate to ourselves.	0.265217
Najmä v dnešnej dobe.	In the modern world.	0.283333
KVALITA ŽIVOTA SA ROVNÁ KVALITE KOMUNIKÁCIE.	THE QUALITY OF LIFE IS THE QUALITY OF OUR COMMUNICATION.	0.24
Vaše pocity sú priamym výsledkom toho, ako sami so sebou komunikujete – je to vaša vlastná interpretácia udalostí.	How you feel is the direct result of how you communicate to yourself - your interpretation of what is happening.	0.445129
VŠETKO MÁ LEN TAKÝ VÝZNAM, AKÝ TOMU MY SAMI PRIPÍŠEME.	NOTHING HAS ANY MEANING EXCEPT THE MEANING WE GIVE IT.	0.3
Využívame dve formy komunikácie: 1. vnútorná komunikácia – čo si predstavujeme, hovoríme a ako sa cítime; 2. vonkajšia komunikácia – slová, intonácia, mimika, polohy tela a fyzické aktivity.	We produce two forms of communication: 1) Internal communication - how we picture, say, and feel within ourselves 2) External communication - words, tonalities, facial expressions, body postures and physical actions	0.259756
OBE FORMY KOMUNIKÁCIE SÚ IMPULZOM a tento impulz produkuje efekt (výsledok).	EVERY COMMUNICATION WE MAKE IS A CAUSE SET IN MOTION, and that cause produces an effect (result).	0.232836
Ak sa už výsledok dostavil a je ním depresia, je to spôsobené tým, ako sami so sebou komunikujete.	You're already producing results.	-0.193548
Napr. čo robíte so svojím telom, tón, akým so sebou hovoríte, to, ako si predstavujete svoj život. ~~~ Na dosiahnutie cieľa treba vynaložiť úsilie.	But if your result is depression, there are specific ways you are communicating with yourself - e. g. , things you are doing with your body, the tonality with which you talk to yourself, the way you picture your life - it takes effort to produce any result.	-0.105242
Vaša úloha je podobná práci filmového režiséra – musíte ovplyvňovať, čo vidíte a počujete (vnútorná komunikácia).	Your job is similar to a film director's job - you need to manipulate what (the way you communicate to yourself).	0.460513
SILA SPOČÍVA V KOMUNIKÁCII.	COMMUNICATION IS POWER.	0.259091
Žijeme v informačnom veku, ale samotné informácie nestačia.	you see and hear We're in an information age, but information is not enough.	0.237736
ČIN JE KĽÚČOM KU KAŽDÉMU VEĽKÉMU ÚSPECHU.	ACTION IS WHAT UNITES EVERY GREAT SUCCESS.	0.291667
Vedomosti sú len potenciálnou silou.	Knowledge is only potential power.	0.280645
SILA JE V SCHOPNOSTI KONAŤ.	POWER IS THE ABILITY TO ACT.	0.3
Skutočná sila spočíva v schopnosti podeliť sa, nie byť egoistom.	Real power is shared, not imposed.	0.04
Je to schopnosť charakterizovať ľudské potreby a naplniť ich spolu s potrebami ľudí, na ktorých vám záleží.	It's the ability to define human needs and to fulfill them - both your needs and the needs of the people you care about.	0.447101
1. KAPITOLA	CHAPTER I	0.233333
CVIČENIA 1.	EXERCISES 1.	1.27273
Ak si chcete navodiť pocit šťastia:	When you are producing the result called happiness:	0.164516
a) Čo si predstavujete?	a) What do you picture?	0.885
b) Čo si hovoríte?	b) What do you say to yourself?	0.7125
c) Čo cítite?	c) What do you feel in your body?	0.675
d) Teraz si to vyskúšajte a všimnite si, ako jednoducho dokážete takýto pocit dosiahnuť, ak ovplyvníte svoju vnútornú komunikáciu.	d) Do those things now, and notice how easily you can produce that result by manipulating the way you communicate to yourself.	0.580189
e) Ak neviete, čo by ste si predstavili alebo povedali, jednoducho predstierajte, že to viete. Spýtajte sa Ak by som si niečo predstavoval, čo by to bolo?	e) If you can't think of what you see, say, etc., just act as if you can - ask yourself If I were picturing something, what would it be?	0.352097
Alebo: Keby som si mal niečo hovoriť, čo by som povedal?	or If I were to say something to myself, what would I be saying to myself? etc.	0.191489
Spravte si zoznam vecí, ktoré vás v živote nadchýnajú.	What beliefs do you have about what you feel passionate about?	0.261702
Čo si o nich myslíte? Ako prebieha vaša vnútorná komunikácia, keď ste nadšení? Čo si predstavujete?	How do you communicate to yourself when you feel passionate - what do you picture?	0.230435
Čo si hovoríte?	What do you say to yourself?	0.0857143
Čo cítite, keď ste plní vášne?	What do you feel in your body when you feel passionate?	0.0692308
2. KAPITOLA	CHAPTER II	0.27
Aká zmena dokáže niečo zmeniť?	What is the difference that makes a difference?	0.144444
Táto otázka mi v hlave vŕtala celý život.	I've been obsessed by that question for my entire life.	0.197143
Byť úspešným neznamená mať menej problémov. Úspešní ľudia zápasia s rovnakými problémami ako tí, ktorí svoj cieľ nedosiahnu.	People who succeed do not have fewer problems than people who fail.	0.0315789
Udalosti ako také sa nedelia na zlyhania a úspechy.	It is not what happens to us that separates failures from successes.	0.204545
Dôležité je, ako danú situáciu vnímame a čo s ňou urobíme.	It is how we perceive what happens and what we do about what happens that makes the difference.	0.116327
Porovnajte W. Mitchella, ktorý zostal po dvoch ťažkých nehodách s popáleninami a úplne paralyzovaný s navonok úspešným Johnom Belushim.	Think of W. Mitchell's two terrible accidents, and contrast it with John Belushi's external success.	0.380603
W. Mitchell si neustále opakoval, že všetko sa deje z nejakého dôvodu.	W. Mitchell chose to consistently communicate to himself that his experience had occurred for a purpose.	0.611538
Práve vďaka vnútornej komunikácii nevnímal svoj život ako tragédiu, ale dokázal sa naň pozerať z tej lepšej stránky.	His internal communication formed sets of beliefs and values that continued to direct his life from a sense of advantage rather than tragedy - even after he was burned and paralyzed.	0.141
John Belushi mal navonok všetko, ale vnútorne bol prázdny, až nakoniec umrel na predávkovanie drogami.	John Belushi had everything externally, but internally, he'd been running on empty for years before he died of drug abuse.	0.624438
Už dávnejšie som si uvedomil, že úspech zanecháva stopy a že neobyčajne úspešní ľudia dosahujú takého výsledky určitým spôsobom.	Long ago, I realized that success leaves clues, and that people who produce outstanding results do specific things to create those results.	0.278378
Verím tomu, že keby som kráčal rovnakou cestou ako oni, dosiahol by som presne to isté.	I believed that if I precisely duplicated the actions of others, I could reproduce the same quality of results that they had.	0.168493
Nazýva sa to NAPODOBŇOVANIE – ak úplne presne napodobníte určité psychické a fyzické aktivity istej osoby, dosiahnete rovnaký výsledok. ~~~ Ak to dokážu iní, dokážete to aj vy.	This is called MODELING - If you precisely reproduce the specific mental and physical actions of another person, you will get the same results - if it's possible for others in the world, it's possible for you.	-0.0251678
Richard Bandler a John Grinder, spoluzakladatelia NLP (Neurolingvistického programovania) zistili, že existujú tri druhy duševných a fyzických aktivít, ktoré priamo vplývajú na úroveň dosahovaných výsledkov.	Richard Bandler and John Grinder, co-founders of NLP (Neuro-Linguistic Programming) found that there are three forms of mental and physical actions that correspond most directly to the quality of results we produce.	0.875293
Ak chcete napodobňovať efektívne, musíte presne skopírovať tieto základné zložky:	In order to model effectively, these fundamental ingredients must be duplicated:	0.291549
1) Systém presvedčenia – Či si už myslíte, že niečo dokážete alebo nie, v oboch prípadoch máte pravdu.	1) Belief system - Whether you believe you can do something or you believe you can't, you're right.	0.447051
2) Mentálna syntax – spôsob, akým si organizujete myšlienky.	2) Mental Syntax - the way people organize their thoughts.	0.582
Je to ako kód – prísady v určitom poradí.	Mental syntax is like a code - ingredients and order.	0.202941
3) Fyziológia – myseľ a telo sú prepojené.	3) Physiology - the mind and body are totally linked.	0.558333
Dýchanie, držanie tela, postoj, mimika, typ a charakter vašich pohybov – čiže spôsob, akým využívate svoju fyziológiu, skutočne ovplyvňuje, v akom ste psychickom rozpoložení.	The way you use your physiology - the way you breathe and hold your body, your posture, your facial expressions, the nature and quality of your movements - actually determines what state you're in.	0.274342
OD NEHO ZÁVISÍ, V AKOM ROZSAHU A AKÝM SPÔSOBOM BUDETE REAGOVAŤ.	THE STATE YOU'RE IN THEN WILL DETERMINE THE RANGE AND QUALITY OF THE BEHAVIORS YOU'RE ABLE TO PRODUCE.	0.122222
Dá sa povedať, že napodobňujeme neustále.	We're actually modeling all the time.	0.263636
Ako sa dieťa naučí rozprávať?	How does a child learn to speak?	0.288462
Žijeme v spoločnosti, ktorá je dostatočne rovnorodá na to, aby niečo, čo funguje na jednom mieste, fungovalo aj na druhom.	We live in a culture that's consistent enough so that what works in one place will very often work in another.	0.257143
V napodobňovaní najviac vynikajú Japonci.	The world's greatest modelers are the Japanese.	0.268421
Kniha Kena Blancharda a Spencera Johnsona – Minútový manažér (The One-Minute Manager) – je model pre jednoduché a účinné riadenie medziľudských vzťahov vytvorený na základe napodobňovania najlepších manažérov USA.	The One-Minute Manager by Ken Blanchard and Spencer Johnson is a model for simple and effective management of any human relationship.	0.519617
Tento program môžete brať ako na návod na vedomé a presnejšie napodobňovanie.	It was put together by modeling some of the most effective managers in the country.	0.286567
Máte šancu uvedomele robiť veci, ktoré ste celý život robili podvedome.	Think of this program as a guidebook for conscious modeling with greater precision, a chance for you to become conscious of something you've always been doing in your life.	-0.101613
Ak niekoho vidíte dosahovať nadštandardné úspechy, ihneď by ste si mali položiť otázku: Ako to robí?	If someone is doing something outstanding, the immediate question that should pop in your mind is, How does (s)he create that result?	0.205814
2. KAPITOLA – KĽÚČOVÉ BODY	CHAPTER II - KEY POINTS	0.255
V živote platí jedno zábavné pravidlo; ak odmietnete prijať čokoľvek okrem toho najlepšieho, potom často to najlepšie aj dostanete.	It's a funny thing about life; if you refuse to accept anything but the best, you very often get it.	0.332927
W. Somerset Maugham: Úspešní ľudia nemajú o nič menej problémov ako tí, ktorí neuspeli.	W. Somerset Maugham: People who succeed do not have fewer problems than people who fail.	0.9
Problémy už nemajú akurát tak ľudia na druhom svete.	The only people without problems are those in cemeteries.	0.266667
Udalosti ako také sa nedelia na zlyhania a úspechy.	It's not what happens to us that separates failures from successes.	0.204545
Dôležité je, ako danú situáciu vnímame a čo s ňou urobíme.	It is how we perceive it and what we do about what happens that makes the difference.	0.171429
Nie veci, ale ľudia sa menia.	Things do not change; we change.	0.264
Henry David Thoreau: Úspech zanecháva stopy.	Henry David Thoreau: Success leaves clues.	1.56992
Verím, že keď budem robiť presne to, čo iní ľudia, dosiahnem rovnaký cieľ ako oni.	I believe that if I precisely duplicate the actions of others, I can reproduce the same quality of results.	0.208696
Jedným z predpokladov NLP je to, že všetci máme rovnakú nervovú sústavu. ~~~ Ak ktokoľvek na svete niečo dokáže, vy to dokážete tiež – za predpokladu, že svoju nervovú sústavu využijete rovnako a ste ochotní obetovať potrebný čas a úsilie.	One of the presuppositions of NLP is that we all share the same neurology, so if anyone in the world can do anything, you can, too, if you run your nervous system in the same way - if you're willing to pay the price in time and effort.	0.0448413
Ľudia, ktorí hýbu svetom, sú často profesionáli v napodobňovaní – Japonci, Inovácia a podnikanie (Innovation and Entrepreneurship), Minútový manažér (The One Minute Manager), Hľadanie dokonalosti (In Search of Excellence), atď.	The movers and shakers of the world are often professional modelers - the Japanese, Innovation and Entrepreneurship, The One Minute Manager, In Search of Excellence, etc.	0.746651
Dá sa povedať, že napodobňujeme celý čas: Ako sa dieťa naučí hovoriť?	Actually, we're modeling all the time: How does a child learn to speak?	0.294915
Ak firma uspeje v jednom meste, zvyčajne sa jej podarí preraziť aj v inom podobnom meste ešte skôr, ako ju niekto stihne predbehnúť.	Successful businesses in one city will usually produce a success in a similar kind of city before the lag time is up.	0.256701
Napodobnite niekoho:	Model someone's:	0.225
2. KAPITOLA – CVIČENIA NA NAPODOBŇOVANIE	CHAPTER II - MODELING EXERCISES	0.214286
1. Rozhliadnite sa okolo seba a nájdite niekoho, kto určitým spôsobom vyniká v osobnom alebo pracovnom živote.	1. Look around you and find someone who is excellent at some aspect of his/ her life - either personally or professionally.	0.441404
Nemusíte obdivovať všetky aspekty jeho života. ~~~ Aj keď má napríklad vyššiu pracovnú pozíciu, jeho manželstvo nemusí byť práve ukážkové.	You don't have to admire all aspects of that person's life - a person might be superior in business judgments, and not much of a marriage partner.	-0.00252101
Pamätajte na to, že sa sústredíte na znamenité vlastnosti. ~~~ Ak sa pozriete zblízka, zistíte, že nikto nežije presne taký život, aký by ste chceli vy.	Remember, you're looking for excellent characteristics - no one has exactly the life you'd like to live if you look closely enough.	-0.0216216
Keď ste už našli človeka, od ktorého by ste niečo chceli odkopírovať, klaďte otázky súvisiace s jeho vierou.	Once you've found a person with an aspect that you would like to model, begin to ask questions that relate to that person's belief system.	0.225
V siedmej a deviatej kapitole sa naučíme, ako napodobniť mentálnu syntax a fyziológiu.	How to duplicate mental syntax and physiology will be dealt with in Chapters VII and IX, respectively.	0.466286
Základ napodobňovania spočíva vo viere.	The foundation of modeling lies in a person's belief systems.	0.158333
Zistite súvislosť medzi vierou a úspechom zvolenej osoby v oblasti, ktorú kopírujete.	Ask him or her questions about what they believe about their success in the area that you're modeling.	0.256
Povedzme, že obdivujete niekoho manželstvo a chceli by ste odhaliť tajomstvo muža, ktorého manželka tak veľmi miluje a rešpektuje.	Let's say you admire someone's marriage, for example, and you decide you would like to find out what the husband does that seems to cause his wife to love and respect him so much.	0.209735
Tak začnete: Sam, čo si MYSLÍŠ, vďaka čomu si taký dobrý manžel?	So you begin: Sam, what do you BELIEVE that makes you such a good husband?	0.49188
Sam možno povie niečo ako Neviem, asi mám šťastie.	Now, Sam may say something like, I don't know - I'm lucky, I guess.	0.516279
V tom prípade musíte pátrať ďalej: A keby si vedel, čo si myslíš, že je hlavným dôvodom úspechu tvojho manželstva, ČO BY TO BOLO?	So you'll have to probe further, Well, if you did know what you believed about marriage and your wife that makes you successful in your marriage, WHAT WOULD IT BE?	0.221495
Otázka: Presvedčenie, ktoré v sebe má, len si ho momentálne nie je vedomý.	The question, If you he truly does have, but is not currently conscious of.	0.3
Ak bude naďalej tvrdiť, že nevie, položte mu tú istú otázku viackrát.	You might even have to ask the same question once or twice more if he continues to say I don't know.	0.188136
Ak ku komplimentu o obdive jeho manželstva pridáte vytrvalosť a rýdzu zvedavosť, nakoniec sa dopracuje k presvedčeniu typu: Možno je to tým, že vždy, keď sa na svoju manželku pozriem, pomyslím si, aká je úžasná, alebo Neviem, čo by som bez nej robil, podporuje ma úplne vo všetkom.	But with persistence and genuine curiosity, added to the compliment you're giving him about admiring his marriage, he will eventually come out with a belief like Well, I guess every time I look at my wife I think to myself, 'What a great person she is, ' or I don't know where I'd be without her: she supports every aspect of my life.	0.373938
Spravil by som pre ňu čokoľvek.	I'd do anything for her.	0.214286
NEZABÚDAJTE, ŽE PÁTRATE PO PRESVEDČENÍ.	REMEMBER, YOU'RE A BELIEF SYSTEM DETECTIVE.	0.275
Úspech neprichádza náhodou.	People don't become successful by chance.	0.173077
Základom každého úspechu je silná viera.	There are powerful beliefs that are the foundation of a person's success.	0.075
Odhaľte ju a ja vám neskôr ukážem, ako si ju osvojíte.	Discover those beliefs, and I'll show you how to install them in yourself later in the book.	0.0866667
ODHAĽTE ASPOŇ 5 HLAVNÝCH PRESVEDČENÍ TEJTO OSOBY V OBLASTI, KTORÚ NAPODOBŇUJETE.	FIND AT LEAST 5 MAJOR BELIEFS THIS PERSON HAS ABOUT THE AREA YOU'RE MODELING.	3.02231
2. Vyberte si ďalšieho človeka, ktorého by ste chceli napodobniť.	2. Find another person you would like to model.	0.4725
Zvoľte si niekoho, kto vyniká po inej stránke – ak ste si predtým zvolili niekoho na základe úspechov v súkromnom živote, teraz uprednostnite takého, ktorého obdivujete z pracovného hľadiska.	Choose someone who is excellent in a different aspect - if you chose a personal context for your first candidate, choose a person whom you admire in a professional context some aspect of his/her excellence.	0.283537
Napodobnite jeho vieru.	Model their beliefs.	0.252632
3. Presvedčenia, ktoré sú podľa vás kľúčové v životoch daných ľudí, si napíšte na papier. ~~~ Umiestnite ho na viditeľné miesto v dome alebo aute, aby ste si mohli neustále pripomínať presvedčenia, ktoré chcete mať.	3. Take the beliefs that seem to really make the difference in these people's lives, write or type them out and put them in a conspicuous place in your house and car, so that you remind yourself of beliefs you would like to have.	-0.00497238
Neskôr vám priblížim, ako ich prijať za svoje.	Later on, I'll take you further into installing beliefs.	0.2325
SPRAVILI STE PRVÝ KROK KU ZMENE, KTORÁ PRINESIE ZMENU.	DISCOVERING THE DIFFERENCE THAT MAKES THE DIFFERENCE.	0.293617
3. KAPITOLA	CHAPTER III	0.3
Ak máte pocit, že všetko, na čo siahnete, sa premení na zlato – alebo na blato – je to vďaka neurofyziologickému stavu, v akom sa nachádzate.	The experience of being on a roll, when you could do no wrong - or the opposite - is a result of the neurophysiological state you are in.	0.283784
Pochopenie tohto stavu je kľúčom k uvedomeniu si zmien a dosiahnutiu dokonalosti.	Understanding state is the key to understanding change and achieving excellence.	0.3
Dokonca i naše správanie je výsledkom stavu, v akom sme.	Our behavior is the result of the state we're in.	0.24878
S tým, čo máme k dispozícii, vždy narábame najlepšie ako vieme, ale nie vždy dokážeme všetky zdroje využiť.	We always do the best we can with the resources available to us, but sometimes we find ourselves in unresourceful states.	0.263736
