Zabudnite na tradičný marketing. ~~~ Nefunguje.	Traditional marketing doesn’t work: get over it!	-0.00357143
Zabudnite na všetko, čo ste doteraz počuli o marketingu.	Forget everything you’ve heard about marketing.	0.25814
Odložte všetky tie marketingové plány, vyškrtnite všetky reklamy v časopisoch a prestaňte si kupovať zoznamy s e-mailovými schránkami ľudí.	Put away those marketing plans, cancel that magazine ad, and stop buying mailing lists.	0.112
Tradičný marketing nefunguje.	Traditional marketing doesn’t work.	0.996429
Je drahý a neefektívny.	It’s expensive and ineffective.	0.185714
V dnešnej dobe tzv. ekonomiky pozornosti 13 ľudí filtruje reklamy v časopisoch, dokáže si dopredu pretočiť reklamy v televízii, ignoruje billboardy a odhadzuje váš starostlivo vytvorený reklamný leták, ktorý našli vo svojej schránke spolu so zvyškom podobných letákov.	In today’s attention economy, people screen out magazine ads, they Tivo out TV ads, ignore billboards and throw away your carefully crafted direct mail campaign with the rest of the junk mail.	0.17037
Trávia viac a viac času on-line, najčastejšie na sociálnych sieťach.	They spend more and more time online— especially on social networking sites.	0.27
Kým vy sa snažíte zaujať novým obchodom, oni aktualizujú svoje profily na Facebooku a "tweetujú" svoje myšlienky na Twitteri.	While you’re trying to attract new business, they’re updating their Facebook profiles and "tweeting” their every thought on Twitter.	0.280556
Ak patríte medzi maloobchodníkov, môže to byť pre vás veľmi užitočná správa.	If you’re a small business owner, this is good news.	0.15
Dokážete byť totiž tam, kde vaši potenciálni zákazníci a ušetriť peniaze, ak výsledok svojej snahy zverejníte on-line.	You can go where your market is and save money by focusing your marketing efforts online.	0.188
Ak sprístupníte vaše produkty a služby on-line pre zákazníkov, ste na polovičnej ceste k úspechu.	If you can make your products or services easy to find online, you’re halfway there.	0.24507
Táto publikácia vám ukáže, ako začať práve teraz a využiť pri tom prostriedky on-line marketingu.	This book will show you how to get started right now with the new online marketing tools.	0.259459
Ťažiskom publikácie je nová forma marketingu, ktorý využíva prostriedky s nízkymi alebo takmer žiadnymi nákladmi, ako sú blogy, podcasty, Facebook, YouTube a Twiter.	This book has a focus on the new marketing: the new low-to-no cost online tools like blogs, podcasts, Facebook, YouTube and Twitter.	0.60559
Nie sú to jednoducho len najnovšie prostriedky on-line marketingu, ale zásadne nový spôsob v tejto oblasti.	These are not simply the latest online marketing tools, but a fundamentally new approach to marketing.	0.459425
Táto publikácia však nie je manifest o tom, ako si nájsť najnovšiu on-line zábavku.	But this is not a trend- chasing manifesto for seeking out the latest shiny new online toy.	0.278873
Pozornosť orientuje skôr na vašu marketingovú stratégiu než na prostriedky a ich vlastné využitie.	The focus is firmly on your marketing strategy, rather than on the tools for their own sake.	0.264935
Nie každý prostriedok je vhodný pre každý druh biznisu.	Not every tool is right for every business.	0.210811
Napriek tomu, že hovoríme o širokom rozsahu nových prostriedkov, ktoré sú k dispozícii, vo sfére on-line marketingu sú vnímané v ešte širšom kontexte: vytvárajú vašu webovú stránku, využívajú marketing vo vyhľadávačoch, vytvárajú úspešné e-mailové kampane.	And although it covers the wide range of the new tools available, it puts them in the wider context of online marketing: building your website, using search engine marketing, and creating a winning email campaign are equally important.	0.263819
Viacero činností na Twitteri, Facebooku, YouTube a i. bude smerovať k riadeniu frekvencie stránky či k presviedčaniu ľudí, aby sa prihlásili na váš e-mailový odber noviniek.	Many of your activities on Twitter, Facebook, YouTube, etc. , will be aimed at driving traffic to your website, or encouraging people to sign up to your email newsletter.	0.287413
Všetky tieto prostriedky však budú najlepšie fungovať pokiaľ bude medzi nimi spolupráca.	These things work best together.	-0.206897
To, čoho ste svedkami, môžeme nazvať marketingovou revolúciou.	What we are witnessing is nothing short of a marketing revolution.	0.294643
Namiesto bezcieľneho vykrikovania nezáživných marketingových odkazov ľuďom, ktorí sa môžu ale nemusia zaujímať o váš produkt či službu, dokážete dnes nájsť ľudí, ktorých zaujíma práve vaša ponuka a to tak, že preniknete do ich on-line komunít, kde zdieľajú spoločné záujmy.	Instead of indiscriminately shouting sterile corporate marketing messages at people who may or may not be interested in your product or service, today you can find people who are already interested in what you have to offer, by tapping into online communities of interest.	0.366649
Na súčasnom konkurenčnom trhu musíte byť na očiach.	In today’s competitive marketplace you need to be findable.	0.253333
Musíte sa dostať tam, kde sú vaši zákazníci a zapojiť ich do konverzácie, z ktorej dostanete spätnú väzbu.	You need to go where your customers are and engage them in a two-way dialogue.	0.372115
Prvá éra v oblasti marketingu začínala masovým marketingom. ~~~ Zrod reklám ako ich poznáme, kde priemerné produkty boli opakovane propagované podľa možností čo najväčšej skupine obyčajných ľudí využívajúc metódy masovej komunikácie, prevažne televíziu.	The first era of marketing was mass marketing—the dawn of advertising as we know it, where average products were repeatedly advertised to the largest possible number of average people, using mass communication methods, particularly television.	-0.00785714
Ktokoľvek, kto videl seriál Mad Men 14, bude mať prehľad o týchto "útočných" dňoch prvých reklamných agentúr.	Anyone who has seen the TV series Mad Men will have some insight into those heady days of the first ad agencies.	0.626812
Druhú fázu predstavuje tzv. priamy marketing. ~~~ Jeho náplňou bolo segmentovať a oslovovať konkrétnych zákazníkov, vytvárať si zoznamy o nich a následne ich "bombardovať" letákmi (ehm, myslím tým priamu poštu).	The second phase was direct marketing—a far more focused approach of segmenting and targeting a particular market, creating marketing lists, and then bombarding them with junk mail (er, I mean direct mail).	0.0239286
Čím viac sa snažil získať si cieľovú skupinu, tým viac strácal záujem zo strany ľudí.	While more targeted, this is still an interruption of people’s attention.	0.2625
Dnes sa nachádzame v ére sociálneho marketingu.	We are now in the era of social marketing.	0.24
Cieľová skupina je stále na dosah, v skutočnosti je na trhu ešte väčšia medzera než kedykoľvek predtým. ~~~ Rozdiel je v tom, že ich nevyrušujeme, ani sa nesnažíme hľadať povolenie na komunikáciu s nimi, keďže vytvárame komunity našim produktom a službám.	We can still reach targeted markets—even more niche than before, in fact—but the difference now is that we are not so much interrupting them, or even seeking permission to communicate with them, as creating communities around our products and services.	-0.000700935
Vďaka ním nás majú ľahko na dosah takže namiesto toho, aby sme museli vyhľadávať my ich, vyhľadávajú oni nás.	We are making ourselves findable by these communities so that, instead of having to find, target and mail them, they come looking for us!	0.225
Ako je to možné?	How did this come about?	0.15
Prečo je v dnešnom modernom svete sociálny marketing čoraz viac dominantný?	What is it about modern life that makes social marketing increasingly dominant?	0.536364
Ľudia sú tvory spoločenské.	Humans are social creatures.	0.288
Je naším prirodzeným inštinktom byť v kontakte s inými ľuďmi.	We have a natural instinct to connect with others.	0.230233
V dnešnej dobe však žijeme izolovaný život.	Yet modern life is isolating.	0.161538
Viac ako polovica ľudí žije v mestách.	More than half of us live in cities.	0.27
Tretina žije osamote.	A third of us live alone.	0.285
Zdá sa, že dni klebetenia s našimi susedmi ponad plot alebo v miestnom obchode už patria do románu slečny Marplovej.	The days of gossiping with neighbors over the garden fence, or in the corner store, seem to belong in a Miss Marple novel.	0.290816
Veľa ľudí dnes pracuje z domu.	More and more of us work from home or telecommute at least some of the time.	-0.115385
Ak aj máme kolegov, naše multikomunikačné prostredie nám už nedovoľuje iba tak si s nimi posedieť pri obede či na káve a preberať včerajšie rodinné záležitosti alebo program v televízii.	Even if we have office colleagues, our multi-channel media milieu means we no longer have so many of those watercooler moments when we discuss last night’s television with them.	0.284
Trendom je, že široko-záberové vysielanie začína nahrádzať užšie, špecifické, čiže médium, ktoré sa sústreďuje na naše záujmy, potreby a túžby.	The trend is away from broadcasting toward narrowcasting—media that is individually tailored to our interests, needs and desires.	0.268142
Každému nášmu rozmaru, chuti či priorite môže byť vyhovené, avšak kde sú ostatní, ktorí zdieľajú naše záujmy?	Our every individual whim, taste, and preference may be met—but where are the others who share our niche interests?	0.287234
Vďaka internetu s nimi dokážeme byť v kontakte stále.	Thanks to the Internet, we can now connect with them.	0.293333
Pretože sociálne médium je personálne médium, kde záleží na originalite, veľké spoločnosti majú občas problém ho využívať a niektoré ho používajú skutočne zle.	Because social media is a personal medium where authenticity matters, it is not always easy for big corporations to use—and some have got it really, really wrong.	0.42281
Najlepšie je ak vediete malý podnik. Dokážete si vybudovať dôveru a vytvoriť si kontakty vďaka svojej osobnosti a originalite.	It’s perfect if you’re a small business or entrepreneur: You can build trust and make connections by using your personality, and being genuine.	0.41422
Každý, kto má prístup k internetu a je trošku kreatívny, dokáže dnes komunikovať so svetom textovou formou, audiom, videom či obrázkami.	Anyone with an Internet connection and a bit of creativity can now communicate with the world via the written word, audio, video, and images.	0.431235
Za posledných pár rokov došlo k radikálnej a výraznej zmene v oblasti vytvárania a distribuovania myšlienok z veľkých mediálnych agentúr k jednotlivcom. Vďaka tomu môže byť dnes vydavateľ každý.	A radical power shift of content creation and distribution from large media institutions to individuals has taken place over the past few years: Everyone is a publisher now.	0.362632
To je dôvod, prečo ste sa práve vy stali Osobnosťou roka 2006 pre časopis Time.	That’s why Time magazine’s Person of the Year in 2006 was YOU.	2.75769
Myšlienka je prvým krokom vášho úspešného on-line marketingu, pokiaľ ju využijete tak, aby ste upútali vašich potenciálnych zákazníkov a klientov, ktorí vás budú vyhľadávať pomocou svojich prehliadačov.	That content is the starting point for your online marketing campaign, as you use it to reach and engage with potential customers and clients who will seek it out with their online searches.	0.266038
Revolúcia on-line marketingu začala a vy môžete byť jej súčasťou.	The online marketing revolution has arrived—and you can be part of it.	0.284211
Ak ste začiatočníkom vo svete biznisu alebo už ste jedným z usilovných biznismenov, výzvy a požiadavky, ktorým čelíte, vás môžu vystrašiť.	If you’re a new or aspiring business owner, the challenges and tasks you face can appear daunting.	0.336546
Kedy a ako si nájsť čas na obchodovanie s produktom či službami a takisto spôsob ako ich doručiť?	How do you find time to market your product or service as well as doing the work required to deliver it?	0.285185
Táto publikácia vám ukáže rýchle triumfy, jednoduché a efektívne spôsoby, ako rozbehnúť biznis už dnes.	This book will show you quick wins, easy and effective ways to reach out to your market today.	0.253846
Ak pracujete vo väčšej firme nájdete tiež veľa rád, ktoré vás inšpirujú a pomôžu vám vyhnúť sa bežným nástrahám.	If you work for a larger business, you will also find plenty of tips here to inform and inspire and you—and help you avoid common pitfalls.	0.386842
Určite využívate stránky a služby ako sú Facebook, Twitter, Youtube, Flickr a iTunes, aby ste boli v kontakte s kamarátmi, vymieňali si s nimi fotky či sťahovali hudbu. ~~~ Ale pýtate sa, ako môžu byť takéto stránky užitočné vo vašom obchode?	You may already use sites and services like Facebook, YouTube, Twitter, Flickr, and iTunes to keep in touch with friends, share photos or download music—but wonder how such sites can be used for marketing your business.	0.0580257
Možnosť výberu prostriedkov pre on-line marketing je priam zarážajúci.	The range of online marketing tools out there can seem bewildering.	0.574138
Kde však začať?	Where do you start?	0.235714
Ako sa popasovať s publicitou?	How do you cut through the hype?	0.3
Táto publikácia vám vysvetlí, čo a ako funguje a ako to správne využívať.	This book shows you what works, why it works, and how to use it.	0.456593
Ukáže vám krok za krokom, ako si efektívne vybrať prostriedky on-line marketingu.	It takes you step by step through the process of choosing and using online marketing tools effectively.	0.228169
Ku všetkým prostriedkom, ktoré sú v publikácii spomenuté, nájdete tiež tipy ako si zmanažovať ich prácu a kontrolovať výsledky (len si treba nájsť čas pre všetky aktualizácie).	For each tool covered, there are also tips on managing the workload (just where will you find the time for all those updates? ) and measuring your results.	0.248837
Vďaka rozsiahlemu slovníku sa priučíte odbornému slangu a pokiaľ nie ste dosť pripravený ponoriť sa do toho sám, poradí vám, ako nájsť niekoho, kto to urobí za vás.	An extensive glossary cuts through the jargon; and if you’re not quite ready to take the plunge yourself, it also advises you on how to find someone to do it for you.	0.502485
Súčasťou každej kapitoly je časť "Ako to funguje v praxi".		-0.3
Nájdete tam konkrétne prípadové štúdie z oblasti biznisu, ktorým sa podarilo uspieť vďaka prostriedkom on-line marketingu.	We will look at case studies of businesses that have succeeded with online marketing tools, in the "…in action” section of each chapter.	0.280556
Prípadové štúdie a iné spomínané firmy v tejto publikácii vás možno prekvapia, pretože väčšina z nich nie je zameraná technicky ako ste si možno predstavovali.	The case studies and other businesses mentioned along the way in this book may surprise you: Most are not technology businesses, as you might imagine.	0.27874
Stretnete sa tu s maloobchodníkmi s oblečením, farmármi, výrobcami potravín, hypnoterapeutom, fotogalériou, dodávateľom svadobného papierenského tovaru, maloobchodníkom so skladačkami či majiteľom coffee shopu - čiže ľuďmi ako ste vy.	They include clothing retailers, farmers, food producers, a hypnotherapist, a photographic gallery, a wedding stationery supplier, a jigsaw retailer, and a coffee shop owner—people just like you.	0.341849
A ak si myslíte, že nikto vo vašom odvetví sa neobťažuje s využívaním nových metód on-line marketingu, je to pre vás vynikajúca správa, pretože ste vo výhradnej pozícii. ~~~ Môžete byť prví a stať sa konkurenciou.	And if you think that no one in your industry bothers with the new online marketing methods, that’s brilliant news: You’re in the privileged position of having a competitive advantage in your industry by being the first mover.	-0.0101124
Nový marketing nie je jednoduchý marketing.	The new marketing isn’t austerity marketing.	1.14945
Má však veľa výhod, pokiaľ nemáte dostatok financií.	But it does also have advantages when funds are tight.	0.3
Ak má vaša firma problémy, ktoré sú výsledkom finančnej krízy alebo hospodárskeho úpadku, bude vás lákať znížiť predaj.	If your business is struggling as a result of the credit crunch or recession, it can be tempting to cut back on your marketing.	0.294175
Je to však posledná možná situácia, kedy to urobiť.	Actually, it is the very worst time to do so.	0.543243
Zníženie produkcie nikdy nevedie ku zvýšeniu predaja.	Less marketing never leads to more sales.	0.2
Avšak pokiaľ sa budete riadiť princípmi v tejto publikácii, budete schopní znížiť váš rozpočet, zatiaľ čo vaše zisky porastú.	However, by following the principles in this book, you will be able to cut back your marketing budget while increasing your reach.	0.294444
On-line marketing je neustále vyvíjajúce sa odvetvie s novými prostriedkami sociálnych médií, ktoré sa vynárajú po celý čas.	Online marketing is an ever-evolving field, with new social media tools cropping up all the time.	0.386109
Môže byť náročné držať s nimi krok.	It can be hard to keep up.	0.171429
Pre aktualizáciu informácií v tejto knihe, kliknite na sprievodnú webovú stránku www. getuptospeed.biz ktorá obsahuje:	For updates on all the information in this book, take a look at the accompanying website at www. getuptospeed.biz which includes:	0.660714
Okrem toho môžete byť so mnou v kontakte prostredníctvom tejto stránky a podeliť sa s vlastnými skúsenosťami v oblasti prípadové štúdie v ďalšom vydaní on-line marketingu.	You can also get in touch with me via the site and submit a case study sharing your own experience of online marketing.	0.275
Sociálne médiá sú príkladom dvojsmernej komunikácie a ja chcem vašu spätnú väzbu!	Social media is a two-way conversation, and I want to hear from you!	0.457085
Od vás ako od čitateľa tejto knihy je pre mňa dôležitý váš názor.	As the reader of this book, your opinion is the most important.	0.29434
Kontaktujte ma on-line, dajte mi vedieť čo sa vám páčilo a čo nie, čo by ste chceli vidieť v nasledujúcom vydaní a povedzte mi o vašej skúsenosti s on-line marketingom.	Connect with me online, let me know what you did or didn’t like, what you would like to see in the next edition, and tell me about your experience of online marketing.	0.293431
Môžete ma tiež nájsť na Twitteri ako #getuptospeed alebo #jonreed, takisto nájdete odkazy na mňa na iných sociálnych stránkach, ktoré používam na www.getuptospeed.biz alebo mi napíšte e-mail na jon@getuptospeed.biz.	You can also follow me on Twitter at @getuptospeed or @jonreed, find links to me on all the other social sites I use at www. getuptospeed.biz, or email me at jon@getuptospeed.biz.	0.324
Prajem vám veľa šťastia vo vašom podnikaní.	For now, I wish you the best of luck with your business.	0.236842
Či už ste začiatočník, úplne nový alebo uznávaný biznismen dúfam, že táto kniha bude pre vás osožným návodom a že vďaka nej využijete vašu snahu v marketingovej oblasti čo najefektívnejšie.	Whether you’re aspiring, brand new or more established, I hope you will find this book a useful guide for focusing your marketing efforts where they are most effective.	0.363307
Pred tým, ako vhupneme do tejto témy a oboznámime sa so všetkými tými úžasnými pomôckami, ktoré máme dnes k dispozícii, vráťme sa o krok späť a zamyslime sa nad tým, čo chceme dosiahnuť.	Before we jump in with all the exciting new tools available, let’s take a step back and think about what you want to achieve.	0.268544
Príliš veľa ľudí si myslí: "Každý má svoj blog na internete (alebo vysiela podcast, "tweetuje" či "facebookuje"). ~~~ Mal by som aj ja mať nejaký blog. Idem si ho vytvoriť!"	Too many people think: "Everyone’s blogging (or podcasting, tweeting, or on Facebook)—I should be blogging—let’s start a blog!”	-0.019898
Takýto začiatok je nesprávny.	This is the wrong starting point.	0.277778
Len preto, že je rýchle, jednoduché a bezplatné vytvoriť si účet na WordPress Facebook, Twitter, MySpace, alebo na YouTube, neznamená, že by ste to mali urobiť aj vy.	Just because it’s quick, easy, and free to set up an account with WordPress, Facebook, Twitter, MySpace, or YouTube doesn’t mean you should.	0.747059
Na začiatok (nech už je to akákoľvek forma marketingu) by ste si mali určiť ciele a zámery vášho marketingu a identifikovať cieľovú skupinu, následne zistiť, kde s ňou môžete prísť do kontaktu a potom zvoliť správne nástroje na to, aby ste ju zaujali.	Like any form of marketing, your starting point should be your marketing aims and objectives, then identifying your community and where they hang out, then you choose appropriate tools to reach them.	0.318128
Táto kapitola vám poskytne rýchlo kurz v stratégii on-line marketingu a pomôže vám pochopiť, ako fungujú sociálne médiá a ako vám umožňujú vhodne a efektívne využívať akékoľvek prostriedky.	This chapter will give you a crash course in online marketing strategy and help you understand some key principles of social media that will enable you to use any tool appropriately and effectively.	0.396086
Takmer dve miliardy ľudí využívajú internet (môžeme povedať, že sú zastihnuteľní on-line).	There are almost two billion people online.	-0.0315789
Práve niektorí z nich sú vaši ideálni klienti alebo zákazníci.	Some of them are your ideal clients or customers.	0.214286
Ak ste schopní čo i len zlomok z nich získať pre svoj obchod, potom váš obchod má šancu.	If you can reach even a tiny fraction of them, you will have a viable business.	0.267692
Internet so sebou prináša nespočetné množstvo výhod, ktoré dokážeme využiť, ak sa chceme na trhu predať.	The Internet has brought enormous benefits to the way we market our businesses.	0.417227
Webová stránka je ako výklad obchodu, ktorý je otvorený nonstop.	A website is like a virtual shopfront that is always open.	0.257143
Vďaka e-mailom sú cieľové skupiny stále informované o najnovších produktoch.	Email reaches targeted audiences with news of our latest products.	0.248276
Blog poskytuje pravidelne aktualizované informácie pre zákazníkov a záujemcov, na ktoré môžu reagovať.	A blog provides regularly updated information for customers and prospects, which they can comment on.	0.289773
Ľudia nás môžu počúvať na svojich MP3 prehrávačoch kdekoľvek sú.	People can listen to us wherever they are on an MP3 player.	0.52987
Môžu sledovať video ukážky našich produktov na internete. ~~~ Masívny nárast širokopásmového zobrazovania nám dnes umožňuje sledovať obrovské streamované video dokumenty.	They can watch video demonstrations of our products online, now that massive take-up of broadband enables us to watch large streaming video files.	0.0853846
Sociálne siete nám umožňujú priamo sa spojiť s ľuďmi, ktorí sa zaujímajú o náš tovar.	Social networks enable us to make direct connections with people who are interested in our wares.	0.254167
Dokážeme si získať našu cieľovú skupinu oveľa jednoduchšie ako kedykoľvek predtým a moc, akú má internet, dokáže túto malú skupinu rozšíriť globálne.	We can reach niche audiences more easily than ever before—and the power of the Internet makes these niches global.	0.201031
Nezáleží na tom, ako je vaša potenciálna skupina zameraná, pretože vďaka vášmu on-line marketingu si dokážete túto skupinu nielen získať tým, že sa zviditeľníte on-line, ale docielite aj to, že vás začne sama vyhľadávať.	However specialized our niche, there is a market for it online, which not only can we reach but, by increasing our visibility online, will also come looking for us.	0.188321
On-line marketing má veľa spoločného s marketingom tradičným, no na rozdiel od neho je lacnejší, efektívnejší a oveľa viac profituje.	Online marketing does a lot of the same things that traditional marketing does—it just does them more cheaply and effectively with a greater reach.	0.559627
Možno vám je dobre známy pojem z oblasti tradičného marketingu – lievik predaja.	You may be familiar with the traditional marketing concept of the "sales funnel.	0.3
Opisuje fázy, ktorými vytláčate svojich potenciálnych zákazníkov z pozície masového trhu ľudí, ktorí nemajú poňatia o tom, že existujete, na cieľového verného zákazníka, ktorý prichádza späť, aby získal viac.	”It describes the stages through which you push potential customers from being a mass market of people who are unaware of your existence to a highly targeted loyal customer who comes back for more.	0.270909
Takisto vysvetľuje, ktoré marketingové metódy je vhodné použiť v konkrétnej fáze.	It also describes which marketing methods to use at which stage.	0.207273
Metódy on-line marketingu sa široko prekrývajú s metódami tradičného marketingu, avšak v každej fáze zviditeľňujete seba tak, aby vás ľudia mohli vyhľadávať a pútate pozornosť cieľovej skupiny namiesto toho, aby ste púšťali do obehu nič nehovoriacu reklamu a dúfali v to najlepšie.	Online marketing methods loosely map on to traditional methods, but at every stage you are making yourself visible to people who will seek you out, and engaging a highly targeted audience, rather than broadcasting an indiscriminate message and hoping for the best.	0.416767
Hovorené slovo je Svätým grálom marketingu a je ťažko dosiahnuteľné off-line.	Word of mouth is the Holy Grail of marketing—and very difficult to achieve offline.	0.286765
On-line marketing ním však prekypuje.	But it is turbo-charged with online marketing.	0.238235
Ľudia trávia určitý čas na internete, najmä na sociálnych sieťach, ako napr. Facebook či Twitter. ~~~ Má zmysel pustiť sa do toho.	Given the amount of time people spend on the Internet, particularly on social sites such as Facebook and Twitter, it makes sense to join in.	0.0348214
Priemerný spotrebiteľ má tendenciu mať ďaleko väčší prehľad o väčšine obchodov ak využíva sociálne médiá.	The average consumer tends to be way ahead of most businesses in their use of social media.	0.236842
Pokiaľ váš zákazník trávi čas na týchto stránkach, mali by ste byť tam, kde aj on.	If your market is spending time on these sites, so should you—go where your market is.	0.282353
Dôvody, prečo on-line marketing funguje v biznise: 1. Riadi frekvenciu na vašej stránke.	Specific reasons why online marketing works for business include 1. Drive traffic to your site.	0.709091
Toto je pravdepodobne najhlavnejší dôvod, prečo používať on-line marketing.	This is probably the single biggest reason for using online marketing.	0.565574
Webová stránka je jadrom vášho obchodu a cieľom vašich on-line marketingových aktivít je riadiť jej frekvenciu.	Your website is the hub of your business, and the aim of your online marketing activities is to drive traffic to it.	0.296875
Nové spôsoby ako sa spojiť s vašimi zákazníkmi.	New ways to connect with your market.	0.215625
Ak si vytvoríte on-line prezentáciu na sociálnych sieťach, ktoré vaši zákazníci navštevujú, stanete sa viditeľnými aj pre nových záujemcov skôr, ako keby ste sa riadili myšlienkou, že si treba vytvoriť webovú stránku, ktorú vám budú navštevovať.	By establishing a presence on social sites that your market use, rather than taking an "if you build it they will come” approach to your business website, you’ll become visible to a new set of prospects.	0.225444
Buduje dôveru.	Build trust.	0.25
Ľudia vždy preferujú obchodovanie s ľuďmi, ktorých poznajú.	People always prefer to do business with people they know.	0.282
Vaši klienti a zákazníci vás môžu spoznať vďaka vašej on-line prezentácii.	Your clients and customers can get to know you through your online presence.	0.3
Konverzácia.	Start a conversation.	0.138462
On-line marketing je konverzácia, nie prednáška.	Online marketing is a conversation—not a lecture.	0.728571
Obojstranná komunikácia medzi vami a vaším zákazníkom alebo záujemcom je oveľa efektívnejšia ako jednosmerné vysielanie vašej reklamy.	A two-way dialogue with your customers and prospects is much more effective than a one-way broadcast of your marketing message.	0.439144
Vytvára hodnotu.	Create value.	0.230769
Jedna časť tajomstva on-line marketingu spočíva v tom, že vytvoríte nejaký obsah (myšlienku) a vyjdete s ním na verejnosť.	Part of the secret of online marketing is creating useful content and giving it away.	0.1625
Ak vytvoríte schopnú myšlienku alebo zaujímavý obsah, ktorým zacielite vašu skupinu, začne sa za vami vracať, aby získala viac.	If you can create a useful resource or interesting content targeted at your niche, they will keep coming back for more.	0.27
Buduje komunity a vzťahy.	Build communities and relationships.	0.156522
Premýšľajte o svojom trhu ako o spoločenstve záujmov, ktoré sa sústreďuje na konkrétnu tému súvisiacu s vaším biznisom.	Think of your market as a "community of interest, ” built around a particular topic related to your business.	0.26413
Možno budete schopní vytvoriť spoločnosť sústredenú na váš obchod alebo produkt, pokiaľ bude dostatočne lákavý.	You may also be able to create a community around your business or product—if it is interesting enough!	0.262069
Poskytuje rýchle, aktuálne informácie o vašom obchode alebo predmete záujmu.	Provide quick, up-to-date information about your business or topic of interest.	0.291176
Podoba v štýle "horúcich noviniek" viacerých foriem on-line marketingu ho robí ideálnym pre oznamy o najnovších produktoch alebo službách, špeciálnych ponukách alebo jednoducho o vzácnych informáciách o vašom sektore alebo oblasti pôsobenia.	The "breaking news” aspect of many forms of online marketing makes it ideal for announcements about new products or services, special offers, or simply valuable topical information about your sector or area of expertise.	0.263298
Zhromažďovanie údajov.	Data capture.	0.0923077
Tvorba databázy potenciálnych zákazníkov je základný cieľ vašej e-mailovej marketingovej kampane.		-0.3
Väčšina snahy, ktorú vynaložíte na svoj on-line marketing, sa zameria na tvorbu zoznamu.	Building a database of potential customers is a core aim of your email marketing campaign.	0.3
No nielen na tvorbu zoznamu facebookových fanúšikov alebo užívateľov Twitteru, ale aj na posielanie pozvánok, ktorými povzbudíte ľudí, aby sa prihlásili na e-mailový odber vašich noviniek.	But much of your online marketing effort will also be geared toward list building—not just your lists of Facebook fans and Twitter followers, but the calls to action you will use to encourage people to sign up to your email newsletter.	0.241463
Prieskum trhu.	Market research.	0.257143
Jedna z výhod používania nových prostriedkov on-line marketingu je to, že ste oveľa bližšie k vašim zákazníkom a máte prehľad o tom, čo chcú.	One of the benefits of using the new online marketing tools is that you are much closer to your market and aware of what they want.	0.266355
Môžete byť však o krok vpred a vypýtať si od nich spätnú väzbu týkajúcu sa vašich produktov alebo služieb, ba dokonca vytvoriť on-line dotazník a pomocou vašich stránok ho spustiť do obehu.	But you can go a stage further and ask them for their feedback on your products or services, or even create an online questionnaire and market it through your online marketing channels.	0.383167
Nízke náklady, zanedbateľné riziko, efektívnosť.	Low-cost, low-risk, effective.	0.134483
Väčšina prostriedkov je k dispozícii buď zadarmo, alebo veľmi lacno.	Most of the tools are available either free or very cheap.	0.232653
Investícia väčšinou spočíva skôr v čase ako v peniazoch.	The investment is often in time rather than money.	0.25814
Riziká využívania sociálnych médií a otvorenej komunikácie so zákazníkmi sú nízke pokiaľ sa riadite zásadami v tejto publikácii.	The risks of using social media and communicating openly with your market are low, as long as you follow the principles in this book.	0.297297
Sú ďaleko viac vyvážené výhodami, ktoré získate neskôr.	They are far outweighed by the benefits you will gain.	0.280435
Pre tých, ktorí sa stále sústreďujú na dodržiavanie kontroly, je dôležité si pamätať, že my už sme kontrolu stratili a pravdepodobne u nás nikdy nebola na prvom mieste.	For anyone still concerned about maintaining control, it is important to remember that we have already lost control—and probably never really had it in the first place.	0.297887
Ľudia už o nás hovoria.	People are already talking about us.	0.12
Pre vás je však dôležité mať prehľad o tom, kde sa nachádzajú tieto rozhovory, aby ste sa mohli k nim pripojiť a ovplyvňovať ich.	It is important for you to be aware of where those conversations are taking place, to join them, and to influence them where appropriate.	0.27757
Ďalšou výhodou on-line marketingu je schopnosť vytvoriť funkčný biznis z medzier na trhu.	Another benefit of online marketing is the ability to create a viable business out of a niche market.	0.273077
Je jednoduchšie než kedykoľvek predtým odhaliť tieto medzery.	Niches work well online, and it’s easier than ever before to reach them.	0.267273
Možno ste už počuli o koncepcii, s ktorou prišiel Chris Andersona - síce The Long Tail, čiže Dlhý chvost.	You may have heard of Chris Anderson’s concept of The Long Tail.	0.803419
Je to variant Paretovho princípu (80/20) aplikovaný na príjem získaný vďaka sortimentu produktov.	It’s a variation of the 80/20 rule, applied to the revenue generated by a product range.	0.465637
Princíp tvrdí, že 80 % príjmu pochádza z 20 % produktov.	Typically, 80 percent of your revenue will come from 20 percent of your products.	3.15957
Nízky počet predaných tzv. bestsellerov vám zaručí vyšší príjem než vyšší počet predaných položiek, o ktoré nie je taký záujem.	A small number of "bestsellers” generates more income than a large number of low-selling items.	0.20122
Častý predaj produktov vo forme zľavových vĺn nie je ničím novým. ~~~ Čo je však nové?	A frequency distribution of number of products by volume of sales is not a new idea.	-0.00214286
Myšlienka, že ten dlhý chvost, ktorý predstavujú produkty s nižším dopytom, vám dnes môžu priniesť zisk a dokonca na nich môžete zarobiť oveľa viac ako na popredných "trhákoch". Vďaka tomu, že ich uverejňujete on-line, máte totiž nízke náklady na ich distribúciu.	What’s new is the idea that the "long tail” of low-sellers can now be profitable—and even make more money than the "head” of blockbuster items—thanks to the low distribution costs of selling online.	0.197605
Amazon je klasický príklad, kde na prvý pohľad nekonečný výber produktov dokáže osloviť publikum a ich občasné zľavové vlny dokazujú, že tieto produkty sú nielen dobré, ale dá sa na nich aj pekne zarobiť.	Amazon is a classic case of this, where a seemingly infinite variety of niche products reach a niche audience, and their low unit sales volumes over time combine to make these products not only viable but also a nice earner.	0.44701
Pokiaľ máte vo svojom biznise vytýčený smer a dokážete ponúkať svoje produkty a služby, takisto môžete profitovať z myšlienky Dlhého chvosta a využívať on-line marketing na to, aby ste získali zákazníkov.	If your business has an identifiable niche, and you can provide products or services at a distance, you too can benefit from the Long Tail by using online marketing to reach your community.	0.455222
Napriek tomu, že som až doteraz hovoril o nových prostriedkoch využívania on-line marketingu, je správnejšie o nich hovoriť ako o sociálnych médiách.	Although I’ve so far been talking about "the new online marketing tools, ” these are more properly referred to as social media.	0.238318
Sociálne médiá sú jednoducho zbierka bezplatných on-line prostriedkov a programov, ktoré ľudia využívajú na publikáciu, konverzáciu či na zdieľanie vlastných nápadov a myšlienok on-line.	Social media is simply a collection of free, online tools and platforms that people use to publish, converse, and share content online.	0.302609
To je to, čomu hovoríme "Web 2.0" – čiže druhá generácia spolupracujúcich on-line prostriedkov.	It’s what we used to call "Web 2.0”—a second generation of more collaborative online tools.	0.480769
Prostriedky sociálnych médií zahŕňajú blogy, podcasty, on-line videá, stránky, na ktorých sa zverejňujú fotografie, sociálne siete, virtuálne svety a sociálne zálohované stránky.	Social media tools include blogs, podcasts, online video, photo-sharing sites, social networks, virtual worlds and social bookmarking sites.	0.217742
Pod pojmom sociálne médiá si môžete tiež predstaviť zbierku web stránok a on-line služieb ako sú Facebook, LinkedIn, MySpace, Twitter, Flickr, Second Life, iTunes, Delicious, StumbleUpon, atď.	You might also think of social media as a collection of websites and online services: Facebook, LinkedIn, MySpace, Twitter, Flickr, Second Life, iTunes, Delicious, StumbleUpon and so on.	1.3583
Pre naše účely je lepšie o nich uvažovať ako o metóde marketingu, ktorá v širšom zmysle zahŕňa web stránky a e-mailový marketing.	For our purposes, it is most helpful to think of it as an approach to marketing, and a subset of online marketing tools which, more broadly, include websites, search engine marketing, and email marketing.	0.387475
Je to posun od marketingu, ktorý využíva metódu tzv. nátlaku (tým, že sa ľuďom snaží nátlakom vnucovať nejakú správu/odkaz) ku marketingu, ktorý využíva metódu tzv. priťahovania, čo znamená, že ľudí ku sebe priťahuje zaujímavým, hodnotným obsahom tak, že ho začnú vyhľadávať sami.	It is a shift from "push” marketing, where we are pushing a marketing message at people, to "pull” marketing, where we are attracting people toward us with engaging, interesting, valuable content that people will seek out.	0.298102
V dnešnej dobe ľudia "gúglia" to, čo ich zaujíma tak, že jednoducho zadajú do jeho prehliadača požiadavku, ktorú potrebujú.	People today think in a Googlesque way—they seek out what interests them.	0.0952381
Ak dokážete preniknúť k týmto záujmovým skupinám, už nikdy nebudete musieť predávať, pretože ľudia vás nájdu sami.	If you can tap into those communities of interest, you won’t ever need to sell again—people will come looking for you.	0.3
Možno o tom premýšľate ako o marketingu založenom na súhlase alebo ústnom podaní či konverzácii.	You might think of it as permission-based marketing, word-of-mouth marketing, or conversational marketing.	0.256627
Pred časom som sa na jednej konferencii stretol s výrazom tzv. martini marketingu, aj keď si myslím, že by som ho mal prestať používať na svojich prednáškach či workshopoch, pretože väčšina poslucháčov, ktorým prednášam, je príliš mladých na to, aby som od nich získal nejakú odozvu.	One phrase I came across a little while ago on the conference circuit is martini marketing—though it’s one that I shall have to stop using in lectures and workshops because most people I speak to these days are too young to get the reference!	0.308167
V 70.-tych rokoch vysielali v televízii reklamnú kampaň pre Martini, v ktorej použili slogan: "kedykoľvek, kdekoľvek, hocikde".	There was a TV advertising campaign for Martini in the 1970s which used the strap line: "any time, anyplace, anywhere.	0.264
Tento slogan naozaj predstavuje spôsob, ako on-line marketing dnes funguje - idete za svojou cieľovou skupinou, získate si ju ponukou, o ktorú má záujem, kedy a kde to vyhovuje jej.	That really sums up how marketing should work these days—going where your market is, reaching them with content they want, when and where they want you to.	0.354066
Je to posun od tzv. megafónového marketingu, kde náhodne vykrikujete na heterogénnu masu ľudí, ktorí sa môžu ale nemusia zaujímaťo to, čo vravíte.	This is a shift away from megaphone marketing—randomly shouting your message at a heterogeneous mass of people who may or may not be interested in what you have to say.	0.389
Využívaním sociálnych médií zviditeľňujete seba pre ľudí, ktorých zaujíma práve to, čo chcete povedať.	By using social media, you are making yourself visible to people who are already interested in what you have to say.	0.276667
Viete sa k nim dostať, upútať ich zaujímavým obsahom a budovať s nimi vzťah.	You can tap into these communities of interest, engage them with useful content, and build a relationship with them.	0.335938
Marketing, ktorý využíva sociálne médiá skutočne funguje najmä v malom podniku, pretože sa viac sústreďuje na budovanie vzťahu so zákazníkom, než len na nezáživnú marketingovú kampaň.	Social media marketing works for small businesses because it focuses on building customer relationships rather than sterile marketing campaigns.	0.224409
Odolajte túžbe použiť to zaručené, neosobné, spoločenské vyjadrovanie.	Resist the temptation to use that safe, impersonal corporate voice—stand out from the crowd and be yourself!	0.497396
Vyjdite z davu a buďte sami sebou. ~~~ Za krátky čas sme prešli dlhú cestu v oblasti sociálnych médií.	We’ve come a long way in a very short space of time with social media.	0.0426724
Internetová sieť existuje len niečo vyše 20 rokov.	The World Wide Web has only been around for about 20 years.	3.93258
A sociálne média tak ako ich poznáme my, fungujú len od roku 2006. Je to rok, kedy časopis Time nominoval ako Osobnosť roka práve "vás".	And social media as we know it has only really been around since 2006—the year that Time magazine nominated their Person of the Year as "You.	0.404765
V tejto oblasti je rok 2006 veľmi významný najmä preto, lebo Facebook sa rozšíril do celého sveta, a teda už to nebola len záležitosť americkej univerzity.	”The year 2006 was a significant one in social media:Facebook opened its network to anyone, rather than just U. S. college kids; Twitter launched; and a new company called YouTube was bought by Google.	1.65742
Vznikol Twitter a novú spoločnosť YouTube odkúpil Google.	These are now three of the biggest sites on the Internet.	0.28125
Toto sú práve tie tri najmasívnejšie webové stránky na internete.	Yet some of the early myths about social media still persist.	0.271154
Predsa len niektoré z niekdajších mýtov týkajúcich sa sociálnych médií stále pretrvávajú.		-0.3
Pokúsme sa ich hneď teraz vyvrátiť.	Let’s dispel a couple of them now.	0.27931
Mýtus č. 1: Je to pre deti V časoch tzv. MySpace generácie sa biznis veľmi tešil sociálnym médiám. ~~~ Využívali sa sociálne médiá, aby získali mladú generáciu detí, ktoré boli v kontakte a tvorili médiá priamo v ich detských izbách.	Myth #1—It’s just for kids Business got very excited about social media a few years ago, when there was a lot of talk of the "MySpace Generation”—i.e., using social media to reach a young demographic of kids connecting online and creating media in their bedrooms.	0.0480787
Realita roku 2006, kedy bol Facebook študentská sieť, však dnes už neplatí.	This may have been true in 2006 when Facebook was a student network, but it is much less so now.	0.470769
Dnes najrýchlejšie rastúcu generáciu vo všetkých sociálnych sieťach tvoria ľudia okolo 35 rokov.	The fastest- growing demographic in all social networks is people over the age of 35.	0.245833
Na Facebooku sa najviac rozširuje skupina ľudí medzi 35 - 54 rokov a skupina ľudí vo veku 25 - 34 sa každý polrok dvojnásobne zvyšuje.	On Facebook, 35–54-year-olds are growing the fastest, and 25–34-yearolds are doubling every six months.	0.234066
Najväčšia skupina ľudí na Twitteri je vo veku 35 - 49 rokov.	The largest age group on Twitter is 35–49-year-olds.	0.273913
Príslušníci virtuálneho sveta Second Life majú v priemere 33 rokov a členovia siete LinkedIn v priemere 41 (pokiaľ hovoríme o pracovnej sieti).	Residents of the virtual world Second Life have an average age of 33, and members of LinkedIn an average age of 41—as you might expect for a more professional network.	0.782715
Samozrejme, že je na sociálnych sieťach stále veľa mladých ľudí.	There are, of course, still plenty of young people on social networks.	0.278571
Je to tzv. "digitálna generácia" ľudí, pretože sa narodili do sveta digitálnych technológií.	This generation of "digital natives” were born into a world of digital technology.	0.257746
O pár rokov to budú vaši zákazníci, klienti alebo dokonca pracovníci.	In a few years they are going to be your customers, your clients, your staff.	0.53
Niektorí už dokonca sú.	Many of them already are.	0.285714
Tí chytrejší vás už dobiehajú.	But the grown- ups are catching up.	0.266667
Mohli by to byť "digitálni imigranti", ktorí môžu mať rôzne silný vplyv na nový digitálny jazyk. ~~~ Mýtus č. 2: Je to len krátke pobláznenie.	They might be thought of as "digital immigrants, ” at varying levels of fluency in the new digital language.	-0.0164634
Myslím si, že obdobie, kedy boli sociálne médiá odsudzované ako krátke pobláznenie. ~~~ sú už dávno za nami.	Myth #2—It’s a fadI think we’re now past the point where social media can be dismissed as a fad.	-0.0123288
Môže za to spôsob. akým využívame internet a síce na socializáciu či interakciu.	It has simply become the way we use the Internet: in a social, interactive way.	0.500649
To, čo niekedy označujeme ako medzinárodná sieť. je v skutočnosti len sieť.	What is sometimes referred to as the "social web” is really just the Web.	0.280328
Tak ako už nepoužívame termín automobil, ale hovoríme len auto.	We no longer say "motor car”—we just say "car.	0.176923
Stále je to len vozidlo, ktoré je motorizované.	”It’s taken as is that our cars are motorized.	0.284615
To isté platí pre Web čiže sieť – to znamená, že používame internet na to, aby sme sa dokázali spojiť s našimi kamarátmi, vyjadriť naše názory, publikovať fotografie či pozerať videá.	So it is becoming with the Web—it is a given that we use the Internet to connect with our friends, express our opinions, publish our photos or watch a video.	0.338635
Existuje výskum, ktorý podporuje tento nový, sociálny spôsob, akým využívame internet.	There is also hard research evidence to back up this new, social way we use the Internet.	0.287838
Kanále sociálnych médií sa za posledný rok rapídne rozrástli.	Social media channels have grown rapidly over the past year.	0.288462
Podľa Nielsenovej správy z roku 2009 v Spojenom Kráľovstve sociálne siete vykazujú, že priemerný internetový užívateľ strávi každú šiestu minútu on-line.	According to a Nielsen report2 in 2009, in the UK, social sites account for one in every six minutes the average Internet user spends online.	0.259322
Facebook je celosvetovo najpopulárnejšia sociálna sieť, ktorá ma 500 miliónov aktívnych užívateľov a Twitter je najrýchlejšie sa rozvíjajúci prostriedok sociálnych médií s odhadom 75 miliónov používateľov.	Facebook is the most popular social network globally, with 500m active users, and Twitter is the fastest-growing social media tool, with an estimated 75m users at the time of writing.	0.4719
		0.3
