John prešiel davom a podarilo sa mu získať si jej pozornosť skôr, ako ju odviedla ochranka.	John, beside himself, pushed through the crowds and managed to catch her attention before she was whisked away by a police escort.	0.347899
Predstavil sa ako bývalý pilot vo Vietname a povedal, že sa cíti zodpovedný za bombardovanie dediny pred dvadsiatimi štyrmi rokmi.	He identified himself as a former pilot in Vietnam and said that he felt responsible for the bombing of her village twenty-four years before.	0.566964
Hovorí: Kim videla moju bolesť, môj žiaľ a smútok.	He says: Kim saw my grief, my pain, my sorrow…	0.560526
Načiahla ruky, aby ma objala.	She held out her arms to me and embraced me.	0.184615
Jediné, čo som dokázal povedať, bolo "prepáč, je mi to ľúto"- znova a znova.	All I could say was "I’m sorry; I’m sorry” – over and over again.	0.237736
Ona pritom hovorila: "Je to v poriadku, odpúšťam ti."	And at the same time she was saying, "It’s all right, I forgive you.”	0.228261
Podľa Johna bolo nevyhnutné stretnúť sa s Kim tvárou v tvár a povedať jej, že sa v myšlienkach roky trápil nad jej zraneniami.	John says that it was vital for him to meet face to face with Kim, and to tell her that he had agonized for years over her injuries.	0.297143
Bez možnosti vyspovedať sa z toho by si len ťažko dokázal odpustiť.	Without having had the chance to get that off his chest, he is not sure he could have ever forgiven himself.	0.131579
Ako sa ukázalo, dostal ešte viac než dúfal: Kimine odpustenie.	As it turned out, of course, he got even more than he hoped for: Kim forgave him.	0.233333
Vzhľadom na to, ako mu toto nešťastie zmenilo život, John tvrdí, že odpustenie "nie je zásluhou, ale darom".	Reflecting on the way the incident changed his life, John maintains that forgiveness is "neither earned nor even deserved, but a gift."	0.382895
Je však aj tajomstvom.	It is also a mystery.	0.266667
John stále nemôže pochopiť, ako ho taký krátky rozhovor mohol zbaviť dvadsaťštyriročnej nočnej mory.	He still can’t quite grasp how a short conversation could wipe away a twenty-four-year nightmare.	0.285714
Pat, ďalší vietnamský veterán, je nežný, tichý muž milujúci deti a kone.	Pat, another Vietnam veteran, is a gentle, quiet man who loves children and horses.	0.71799
Po siedmich rokoch od nášho prvého stretnutia som si však uvedomil, že má temnejšiu stránku, ktorá sa zameriava na jeho neschopnosť si odpustiť: na smrť myslím pomerne často.	In the seven years since I first met him, however, I have become aware that he has a darker side – one that centers on his inability to forgive himself: Death is on my mind a lot.	0.291667
Tú, ktorú som spôsobil – a chcem aj svoju vlastnú – ma v mojich myšlienkach sprevádza každý deň.	The deaths I have caused – and wanting my own death – are with me every day.	0.539891
So svojimi kolegami zvyknem žartovať.	I joke around a lot with the people I work with.	0.255882
To pre to, aby som v sebe potlačil bolesť a nemal čas na premýšľanie.	I have to, to hide the pain and to keep my mind from thinking.	0.458
Musím sa smiať, pretože vtedy smútok nemá šancu.	I need to laugh. Laughing keeps the blues away.	0.285
Avšak nedokážem milovať.	But I cannot love.	0.16875
Časť mojej duše chýba a zdá sa, že už nikdy nebude celistvá.	Part of my soul is missing, and it seems I won’t ever get it back.	0.282
Neviem, či si dokážem odpustiť všetky moje chyby.	I don’t know if I can ever forgive myself for all of my wrongs.	0.244186
Žijem zo dňa na deň, stále som však unavený – stále.	I live day to day, but I am tired all the time – tired.	0.55
Skončí sa to snáď niekedy?	Will it ever end?	0.14
Neviem ako.	I don’t see how.	0.218182
Je to už viac ako dvadsaťpäť rokov.	It’s been with me over twenty-five years now.	0.21
Na ľudí ako je Pat sa často nalieha, aby dostali odborné poradenstvo, pripojili sa k podpornej skupine, alebo sa zúčastnili skupinových stretnutí s cieľom zdeliť sa s ostatnými, ktorí majú podobné skúsenosti.	People like Pat are often urged to receive formal counseling, to join a support group, or to attend group therapy meetings so as to compare notes with others who have had similar experiences.	0.357159
Hoci to všetko robil, ešte stále nenašiel pokoj.	He has done all of this, and still not found peace.	0.3
Možno si, podobne ako John, želá stretnúť sa s rodinami tých, ktorých zabil, čo je veľmi nepravdepodobné, alebo oživiť obete a poprosiť ich o odpustenie – ešte viac nemožné.	Perhaps, like John, he wishes he could meet the families of those he killed – an unlikely opportunity – or bring the victims themselves back to life so he could ask their forgiveness – an obviously impossible one.	0.436301
Takže čo má robiť?	So what should he do?	0.2625
Rozhovor Roberta Colesa s psychoanalytičkou Annou Freudovou by mohol naznačiť odpoveď.	A conversation Robert Coles once had with the psychoanalyst Anna Freud may hint at an answer.	0.292208
Diskutujúc o staršom klientovi s dlhou duševnou minulosťou, Freudová zrazu dospela k záveru: Viete, pred tým, ako sa s touto dámou rozlúčime, by sme nemali uvažovať len nad tým, čo si myslieť – to predsa robíme stále! - ale aj nad tým, čo na tomto svete by sme pre ňu chceli.	Discussing an elderly client with a long and troubled psychological history, Freud suddenly concluded: You know, before we say good-bye to this lady, we should wonder among ourselves not only what to think – we do that all the time! – but what in the world we would want for her.	0.410075
Ach, nemyslím psychoterapiu. Tej mala viac než dosť.	Oh, I don’t mean psychotherapy; she’s had lots of that.	0.293478
Pomocou nej by to trvalo viac rokov, ako jej Boh nadelil.	It would take more years, I suspect, of psychoanalysis than the good Lord has given her…	0.1375
Nie, ona "nás" má už dosť, aj keď to ešte netuší.	No, she’s had her fill of "us, ” even if she doesn’t know it…	0.2325
Táto chudobná stará dáma nás vôbec nepotrebuje.	This poor old lady doesn’t need us at all…	0.24
Naopak, všetko, čo potrebuje, je odpustenie.	What she needs…is forgiveness.	0.171429
Potrebuje pokoj vo svojej duši, nehovoriac o mysli.	She needs to make peace with her soul, not talk about her mind.	0.253333
Musí to byť Boh, kto jej pomôže, vypočuje a uzdraví ju.	There must be a God, somewhere, to help her, to hear her, to heal her…and we certainly aren’t the ones who will be of assistance to her in that regard!	0.297826
My určite nie sme tí, ktorí jej v tomto smere budú vedieť pomôcť.	All of us yearn for the freedom to live without guilt.	0.24
Všetci túžime po živote bez pocitu viny.	At some level, every one of us longs for forgiveness.	0.214286
V istom momente každý z nás túži po odpustení.	Yet when all is said and done, we cannot acquire it.	0.269231
Teraz, keď sa už všetko povedalo a vykonalo, nemôžeme nič získať.		-0.3
Niekedy osoba, ktorej sme ublížili, nám nedokáže alebo nechce odpustiť.	Sometimes the person we have wronged is unable or unwilling to forgive us.	0.3
Inokedy sme to ale my, ktorí si nevieme prepáčiť.	Sometimes we are unable or unwilling to forgive ourselves.	0.535714
Dokonca aj najlepšia psychoanalýza, najvážnejšia spoveď, nemusí stačiť na to, aby nám zabezpečila trvalú úľavu alebo terapiu.	Even the best psychoanalysis, the most earnest confession of guilt, may not be enough to assure us of lasting relief or healing.	0.294444
Ale moc odpustenia stále existuje a ako zistil John Plummer, robí zázraky, aj keď si myslíme, že si ho nezaslúžime.	But the power of forgiveness still exists, and as John Plummer found out, it can work wonders even when we are sure that we have neither earned nor deserved it.	0.33461
Prichádza k nám ako dar, často vtedy, keď sa cítime najmenej hodní jeho prijatia.	It comes to us as a gift, often when we feel least worthy of receiving it.	0.255
A napokon ako akýkoľvek dar ho môžeme prijať alebo odmietnuť.	Finally, like any gift, it can be accepted or rejected.	0.261702
To, čo s ním urobíme, je na nás.	What we do with it is up to us.	0.275
Vždy, keď istá šťastne vydatá žena vyrazila von, uvažovala, aké by bolo vyspať sa s cudzím chlapom.	Every time the happily married woman went away she wondered how it would feel to sleep with another man.	0.289286
V ten víkend sa to rozhodla zistiť.	That weekend she was determined to find out.	0.595
Bol december a ona cítila, ako padá opona za ďalším rokom.	It was December; she felt a curtain closing on another year.	0.537755
V piatok večer sa vybrala vlakom do mesta. ~~~ Sedela vo vozni prvej triedy a čítala.	On Friday evening, she took the train into the city, sat reading in a first-class carriage.	-0.0125
Detektívka ju nezaujímala, veď koniec príbehu už dokázala vytušiť.	The crime novel didn’t hold her interest; she could already predict the ending.	0.254237
Deťom nechala na stole cestoviny so syrom a z čistiarne priniesla mužovi obleky.	She had left a dish of macaroni cheese out for the kids, brought her husbandas suits back from the cleaners.	0.422981
Keď dorazila do mesta, vzala si taxík smerom k hotelu.	When she reached the city she took a taxi to the hotel.	0.293333
Dostala malú izbu s bielymi stenami a výhľadom na Farskú cestu, jednu z najstarších ulíc v Anglicku.	They gave her a small, white room with a view of Vicar’s Close, one of the oldest streets in England, a row of stone houses with tall, granite chimneys where the clergy lived.	0.258431
Tvoril ju rad kamenných domov s vysokými žulovými komínmi. ~~~ Na tejto ulici bývali kňazi.	She sat at the hotel bar that night nursing a tequila and lime, but there was nothing doing.	-0.00197368
V ten večer sedela v hotelom bare pri poháriku a zamyslene láskala tequilu s limetkou. Nič sa tam nedialo.	Old men were reading newspapers, business was slow, but she didn’t mind; she needed a good night’s sleep.	0.457895
Podnik bol takmer poloprázdny, iba pár starých chlapov čítalo noviny, ale jej na tom nezáležalo. Potrebovala sa len dobre vyspať.	She fell into her rented bed, into a dreamless sleep, and woke to the sound of bells ringing in the cathedral.	0.234066
Len čo prišla do izby, hodila sa do postele, kde upadla do bezsenného spánku.		-0.3
Zobudilo ju až zvonenie zvonov v katedrále.	On Saturday she walked to the shopping centre.	0.284211
V sobotu sa prešla do nákupného centra. ~~~ Rodinky si tu vyšli na prechádzku a s detskými kočíkmi sa predierali húfom ľudí.	Families were out, pushing buggies through the morning crowd, a thick stream of people flowing through glass automatic doors.	0.0117647
Kúpila deťom darčeky, ktoré by asi neočakávali.		-0.3
Najstaršiemu synovi zaobstarala elektrický holiaci strojček, pretože už bol z neho takmer chlap.	She bought unusual gifts for her children, things she thought they wouldn’t predict.	0.250685
Dcére kúpila atlas a manželovi drahé zlaté hodinky s jednoduchým bielym ciferníkom.	She bought an electric razor for her eldest son – he was getting to that age – an atlas for the girl, and for her husband an expensive gold watch with a plain, white face.	0.494415
Poobede si obliekla krátke slivkovomodré šaty, obula topánky na vysokom podpätku, na pery naniesla krvavočervený rúž a vrátila sa späť do mesta.	She dressed up in the afternoon, put on a short plum-coloured dress, high heels, her darkest lipstick, and walked back into town.	0.38915
Začula hlas z jukeboxu v bare, ktorý bol bývalým väzením so zamrežovanými oknami a nízkym stropom z drevených trámov.	A jukebox song, The Ballad of Lucy Jordan, lured her into a pub, a converted prison with barred windows and a low, beamed ceiling.	0.426
Na vedľajšej stoličke sedel chlapík v koženej bunde, ktorá mala najlepšie roky za sebou.	On the next stool sat a guy in a leather jacket that looked like he should have given it to Oxfam years ago.	0.256579
Ahoj, povedal.	Hello, he said.	0.3
Ešte som ťa tu nevidel.	Haven’t seen you before.	0.27
Jeho pleť mala červenkastý nádych a hnedé vlasy farbou pripomínali blato.	He had a red complexion, a gold chain dangling inside a Hawaiian print shirt, mud-coloured hair.	0.465625
Zlatá retiazka sa mu hompáľala pod tričkom s havajským vzorom.	His glass was almost empty.	-0.075
Pohár mal takmer prázdny.	What’s that you’re drinking? she said.	0.156522
Čo piješ? opýtala sa. ~~~ Nemal obrúčku.	There were no rings on his fingers.	-0.02
Som asi najosamelejší človek na svete, povedal.	I’m the loneliest man in the world, he said.	0.259459
A čo ty?	How about you?	0.0428571
Zasmial sa.	He laughed.	0.3
Poďme si zahrať biliard.	Play pool with me.	0.1875
Neviem ho hrať.	I don’t know how.	0.278571
Nevadí, odvetil. Naučím ťa.	Doesn’t matter, he said, I’ll teach you.	0.18
Uvidíš, že osmičku dáš skôr, ako sa nazdáš.	You’ll be potting that black before you know it.	0.267568
Do otvoru vhodil mince, niečo potiahol a do čiernej priehradky dolu pod stolom sa spustila záplava gúľ.	He put coins into a slot and pulled something and a little landslide of balls knuckled down into a black hole under the table.	0.412121
Celé a polovičné, povedal, keď naniesol vrstvu kriedy na tágo.	Stripes and solids, he said, chalking up the cue.	0.214286
Môžeš mať iba jedny alebo druhé.	You’re one or the other.	0.2
Rozrazím ich.	I’ll break.	0.245455
Naučil ju, ako sa má správne nakloniť, sledovať bielu guľu, keď mieri, ale nenechal ju ani raz vyhrať.	He taught her to lean down low and sight the ball, to watch the cue ball when she took the shot, but he didn’t let her win one game.	0.233721
Oprela si čelo o chladné zrkadlo.	She leaned her forehead against the cool of the mirror.	0.113793
Nevedela si spomenúť, či bola vôbec niekedy taká sťatá.	She couldn’t remember ever being drunk like this.	0.265116
Dopili a zdvihli sa.	They finished off their drinks and went outside.	-0.1
Studený, čerstvý vzduch jej takmer vyrazil dych.	The air spiked her lungs.	0.0136364
Na oblohe do seba narážali oblaky.	Clouds smashed into each other in the sky.	0.24
Poďme sa prejsť, navrhol.	Let’s walk, he said.	0.216667
Ukážem ti okolie.	I’ll give you the tour.	0.225
Započúvaná do vŕzgavého zvuku jeho koženej bundy, kráčala vedľa neho. ~~~ Viedol ju cestičkou pozdĺž priekopy vinúcej sa okolo katedrály.	She fell into step beside him, listened to his jacket creaking as he led her down a path where the moat curved round the cathedral.	-0.0138889
Pri biskupskom paláci stál postarší pán a predával starý chlieb na kŕmenie vtákov.	An old man stood outside the Bishop’s Palace selling stale bread for the birds.	0.28209
Trochu si z neho kúpili a ako stáli na okraji vodnej priekopy, kŕmili päť mladých labutí, ktorým sa už perie menilo na biele.	They bought some and stood at the water’s edge feeding five cygnets whose feathers were turning white.	0.241379
Hnedé kačky preleteli ponad vodu a pristáli na hladine.	Brown ducks flew across the water and landed in a nice skim on the moat.	0.53125
Po chodníku sa rozbehol čierny labrador, v tom momente vzlietol kŕdeľ holubov a usadil sa na konároch stromov.	When a black Labrador came bounding down the path, a huddle of pigeons rose as one and settled magically in the trees.	0.445129
Cítim sa ako František z Assisi, ktorý sa rozprával s vtákmi.	I feel like Francis of Assisi, she laughed.	0.511712
Rozpršalo sa. ~~~ Kvapky dažďa jej padali na tvár a prebúdzali ju k životu.	Rain began to fall; she felt it falling on her face like small electric shocks.	-0.00967742
Vracali sa späť cez trh. ~~~ Stánky zoradené vedľa seba boli ukryté pod obrovitánskym šiatrom.	They backtracked through the market-place where stalls were set up in the shelter of tarpaulin.	-0.00375
Predávali tam všetko možné: od páchnucich kníh z druhej ruky cez čínsky porcelán, veľké červené vianočné ruže, cezmínové vence a mosadzné ornamenty až po čerstvé ryby s mŕtvym pohľadom, ktoré ležali na ľade.	They sold everything: smelly second-hand books and china dishes, big red poinsettias, holly wreaths, brass ornaments, fresh fish with dead eyes lying on a bed of ice.	0.332675
Poď ku mne, povedal.	Come home with me, he said.	0.216667
Navarím ti.	I’ll cook for you.	0.163636
Vážne?	You’ll cook for me?	-0.128571
Máš rada ryby?	You eat fish?	0.275
Zjem všetko, odvetila a zdalo sa, že ho tým pobavila.	I eat everything, she said, and he seemed amused.	0.278571
Poznám také, ako si ty, povedal.	I know your type, he said.	0.218182
Vybral pstruha, ktorý vyzeral, akoby bol ešte nažive.	He chose a trout that looked like it was still alive.	0.279545
Predavač mu odsekol hlavu a zabalil ho do alobalu.	The fishmonger chopped its head off and wrapped it up in foil.	0.237209
Vždy, keď prechádzali okolo stánkov, spýtal sa jej, či si niečo neprosí.	Always, as they passed the stalls, he asked her if she wanted anything.	0.29
Vo vreckách nosil kopu bankoviek skrkvaných ako staré bločky a nevyrovnal ich dokonca ani pri platení.	He was free with his money, kept it crumpled in his pockets like old receipts, didn’t smooth the notes out even when he was handing them over.	0.201136
Po ceste sa zastavili v obchode s alkoholom, kde kúpili dve fľaše červeného toskánskeho vína. ~~~ A žreb. ~~~ Naliehala, že za všetko zaplatí.	On the way home they stopped at the off-licence, bought two bottles of Chianti and a lottery ticket, all of which she insisted on paying for.	-0.132955
Ako odchádzali z obchodu, otvoril jej dvere, a keď videl, aká je z toho prekvapená, pobavene povedal: Vidíš, slušní chlapi ešte nevymreli.	Don’t hold your breath, he said, and watched her walk through the door he’d opened for her.	0.134211
Neskôr sa prechádzali po vydláždených uliciach a cestou minuli holičstvo, kde práve v kresle sedel chlapík so zaklonenou hlavou a holili ho.	They strolled down cobbled streets, past barber’s where a man was sitting with his head back, being shaved.	0.36229
Ulice sa postupne zužovali, kľukatili, až sa odrazu ocitli mimo osvetlených častí mesta.	The streets grew narrow and winding; they were outside the city lights now.	0.239062
Bývaš na predmestí? spýtala sa.	You live in suburbia? she asked.	0.3
Neodpovedal, len pokračoval v chôdzi.	He did not answer, kept walking.	0.235714
Zacítila rybacinu.	She could smell the fish.	0.233333
Keď prišli k železnej tepanej bráne, povedal jej, aby sa držala vľavo.	When they came to a wrought-iron gate he told her to hang a left.	0.260377
Prechádzali klenutou chodbou, až sa dostali na jej koniec.	They passed under an archway and came out in a dead end.	0.267391
Odomkol, pustil ju pred seba a šli až hore.	He unlocked a door to a block of flats and followed her upstairs to the top floor.	0.341667
Ešte ďalej, povedal jej, keď sa zastavila na medziposchodí.	Keep going, he said when she stopped on the landings.	0.253333
Zachichotala sa a šla ďalej, znovu sa zasmiala a zastavila sa až na najvyššom poschodí.	She giggled and climbed, giggled and climbed again, stopped at the top.	0.236066
Pánty na dverách pri zatváraní vŕzgali, zišiel by sa im olej.	The door needed oil; the hinges creaked when he pushed it back.	0.294231
Steny bytu boli biele, holé a na parapetoch sa držal prach.	The walls of his flat were plain and pale, the sills dusty.	0.293878
Špinavý hrnček osamelo stál v dreze.	One stained mug sat lonely in the sink.	0.290625
Z gauča zoskočila biela perzská mačka.	A white Persian cat jumped off a couch in the living room.	0.176471
Byt bol zanedbaný, akoby tam nejakú dobu už nikto nebýval. ~~~ Pod veľkým oknom v obývačke sa fikus naťahoval ponad koberec za pásom dopadajúceho pouličného svetla.	It was neglected, like a place where someone used to live; the rubber plant in the lounge crawled across the carpet towards a rectangular pool of streetlight under a high window.	-0.0107914
V kúpeľni stála veľká liatinová vaňa na modrých kovových nožičkách, ktoré pripomínali pazúry divej šelmy.	A big cast-iron tub stood in the bathroom on blue, steel claws.	0.0792453
Fíha! zahlásila obdivne.	Some bath, she said.	0.216667
Chceš sa okúpať? spýtal sa.	You want a bath? he said.	0.257143
No veď pokojne.	Try it out.	0.18
Napusti si ju a okúp sa.	Fill her up and dive in.	0.3
Len do toho, cíť sa ako doma.	Go ahead, be my guest.	0.221053
Napustila vaňu vodou, takou horúcou, ako len zniesla.	She filled the tub, kept the water as hot as she could stand it.	0.268085
Vošiel do kúpeľne, vyzliekol sa do pol pása a otočený chrbtom k nej sa holil pri umývadle.	He came in and stripped to the waist, and shaved at the handbasin with his back to her.	0.283099
Zavrela oči, počúvala, ako si na bradu nanáša penu, holí sa a popritom oklepkáva žiletku o umývadlo.	She closed her eyes and listened to him work the lather, tapping the razor against the sink, shaving.	0.3
Akoby to už raz zažila.	It was like they’d done it all before.	0.12
Nezdal sa jej byť nebezpečný.	She thought him the least threatening man she’d ever known.	0.0115385
Zapchala si nos, ponorila sa pod vodu. ~~~ Hučalo jej v hlave a pred očami sa jej zahmlilo.	She held her nose and slid underwater, listened to the blood pumping in her head, the rush and cloud in her brain.	-0.0405405
Keď sa vynorila, všade bola para, on si utieral zvyšky holiacej peny a usmieval sa.	When she surfaced, he was standing there in the steam, wiping traces of shaving foam off his chin, smiling.	0.214286
Bavíš sa? spýtal sa.	Having fun? he said.	0.3
Keď si poutieral tvár, vstala.	When he lathered a flannel, she got up.	0.233333
Kvapky vody jej stekali z pliec až k nohám.	Water fell off her shoulders and trickled down her legs.	0.2
Umýval ju pomalými krúživými pohybmi, začal pri nohách a postupoval stále vyššie.	He began at her feet and work upwards, washing her in strong, slow circles.	0.261905
V tlmenom svetle vyzerala dobre. ~~~ Natiahla k nemu ruky ako dieťa dožadujúce sa svojej mamy.	She looked good in the yellow shaving light, raised her feet and arms and turned like a child for him.	-0.00949367
Prinútil ju znovu sa ponoriť pod vodu, opláchol ju od peny a zabalil do uteráka.	He made her sink back down into the water and rinsed her off, wrapped her in a towel.	0.478545
Viem, čo potrebuješ, povedal.	I know what you need, he said.	0.276
Potrebuješ, aby sa o teba niekto staral.	You need looking after.	0.1
Neexistuje žena, ktorá by to nepotrebovala.	There isn’t a woman on the earth who doesn’t need looking after.	0.184615
Zostaň tu.	Stay there.	0.27
Vyšiel z kúpeľne, vrátil sa s hrebeňom a začal jej česať vlasy.	He went out and came back with a comb, began combing the knots from her hair.	0.474165
Máš blonďavé chĺpky ako broskyňa.	You’ve blond fuzz, like a peach.	0.278571
Článkom prstu jej prechádzal po krku, stavec po stavci.	His knuckle slid down the back of her neck, followed her vertebrae.	0.24375
Mal mosadznú posteľ s bielou perinou z husieho peria a čiernymi vankúšmi.	His bed was brass with a white, goose-down duvet and black pillowcases.	0.520933
Rozopla mu opasok a vytiahla ho z pútok.	She undid his belt, slid it from the loops.	0.282353
Pracka zacengala, keď dopadla na zem.	The buckle jingled when it hit the floor.	0.281818
Stiahla mu nohavice.	She loosened his trousers.	0.221053
Nahý nebol vôbec krásny, ale bolo na ňom niečo zmyselné. ~~~ Páčila sa jej jeho mužná a statná postava.	Naked, he wasn’t beautiful, yet there was something voluptuous about him, something unbreakable and sturdy in his build.	-0.0335294
Pokožku mal na dotyk horúcu.	His skin was hot.	0.1
Predstieraj, že si Amerika, povedala.	Pretend you’re America, she said.	0.26
A ja budem Krištof Kolumbus.	I’ll be Columbus.	0.13125
Pod perinou medzi vlhkými stehnami objavovala jeho nahotu.	Under the bedclothes, down between the damp of his thighs, she explored his nakedness.	0.173077
Toto telo bolo pre ňu novinkou.	His body was a novelty.	0.195
Keď sa jej do prikrývky príliš zamotali nohy, prosto ju odkopol.	When her feet became entangled in the sheets, he flung them off.	0.294444
