Na výskumnej stanici vzdialenej 11 kilometrov od mesta Cherskiy, Mathias Goeckede z nemeckého inštitútu Maxa Plancka so zameraním na biochémiu zistil, že výška snehu sa za posledných päť rokov zdvojnásobila.	At a research site 11 miles from Cherskiy, Mathias Goeckede of Germany’s Max Planck Institute for Biogeochemistry found that snow depth had doubled in five years.	1.76643
Teplota aktívnej vrstvy stúpla do apríla 2018 o 5,5 °C.	By April 2018 temperatures in the active layer had risen 10 degrees Fahrenheit.	0.438685
Tento jav sa netýka len Sibíri.	The phenomenon wasn’t limited to Siberia.	0.188889
Odborník na permafrost z Aljašskej univerzity v meste Fairbanks Vladimir Romanovsky v približne 180 výskumných oblastiach celé roky sledoval, ako aktívna vrstva v polovici januára úplne zamrzne.	Vladimir Romanovsky, a permafrost expert at the University of Alaska Fairbanks, had for years watched the active layer freeze completely by mid-January at some 180 research sites in Alaska.	1.67989
Na týchto miestach však opakovane silno snežilo, a preto začínalo mrznúť vo februári, neskôr až v marci.	But as those places also faced a recent period with heavy snow, the freezing slipped first to February, then to March.	0.432959
Osem oblastí, ktoré skúmal Romanovsky v blízkosti mesta Fairbanks a dvanásť západoaljašských oblastí na Sewardovom polostrove v roku 2018, vôbec nezamrzlo.	In 2018, eight of Romanovsky’s sites near Fairbanks and a dozen on the Seward Peninsula, in western Alaska, never fully froze at all.	0.644805
V permafroste na celom svete je uložených viac než 1 600 gigaton uhlíka.	Globally, permafrost holds up to 1,600 gigatons of carbon, nearly twice what’s in the atmosphere.	0.186885
Je to skoro dvakrát viac než v atmosfére.	No one expects all or even most of that to thaw.	0.599048
Nikto nečakal, že všetok alebo aspoň väčšina permafrostu sa roztopí.		-0.3
Až donedávna výskumníci predpokladali, že z permafrostu unikne maximálne 10 % uhlíka.	Until recently, researchers presumed permafrost would lose at most 10 percent of its carbon.	2.81846
Dokonca predpokladali, že to bude trvať 80 rokov.	Even that, it was thought, could take as much as 80 years.	3.93178
Všetko sa urýchlilo vtedy, keď aktívna vrstva prestala v zime mrznúť.	But when the active layer stops freezing in winter, things speed up.	0.289655
Zvýšená teplota umožňuje mikróbom rozmnožovať sa v pôde. ~~~ Oxid uhličitý a metán sa uvoľňujú nielen v letných mesiacoch, ale po celý rok.	The added warmth lets microbes chomp organic material in the soil—and emit carbon dioxide or methane—year-round, instead of for just a few short months each summer.	-0.0294872
Toto teplo sa v zime dostáva aj do samotného permafrostu, ktorý sa preto topí rýchlejšie.	And the winter warmth spreads down into the permafrost itself, thawing it faster.	0.274286
Mnoho našich predpovedí sa neguje, hovorí Róisín Commaneová, odborníčka na atmosférickú chémiu z Kolumbijskej univerzity, ktorá sleduje emisie uhlíka z lietadiel.	A lot of our assumptions are breaking down,” said Róisín Commane, an atmospheric chemist at Columbia University who tracks carbon emissions by airplane.	0.408883
Spolu s kolegami zistila, že množstvo CO2 v aljašskej oblasti North Slope vzrástlo od roku 1975 o 73 %.	She and her colleagues have discovered that the amount of CO2 coming off Alaska’s North Slope in early winter has increased by 73 percent since 1975.	0.763953
Snažili sme sa zistiť, čo sa na Arktíde deje a spoliehali sme sa na leto, vraví Commaneová, ale skutočný príbeh sa začína až vtedy, keď slnko zapadne.	We’ve been trying to understand what’s going on in the Arctic by relying on summer,” Commane said. But after the sun goes down—that’s when the real story begins.	0.276
Zasnežené zimy sú už minulosťou. ~~~ Počas poslednej zimy v meste Cherskiy napadlo menej snehu a pôda sa výrazne ochladila.	A few snowy winters don’t make a trend; this past winter there was less snow in Cherskiy, and the soil cooled again considerably.	0.0310811
V meste Fairbanks nasnežilo len trochu.	Fairbanks also got little snow.	0.725
Napriek tomu si niektoré aljašské oblasti, ktoré skúmal Romanovsky, zachovali dostatok tepla a nezamrzli úplne.	Yet at some of Romanovsky’s sites in Alaska, the active layer again retained enough heat to keep from completely freezing.	0.281633
Je to naozaj skvelé, tvrdí zástupca riaditeľa inštitúcie The Woods Hole Research Center v Massachusetts Max Holmes, ktorý skúma uhlíkový cyklus na Aljaške i v meste Cherskiy.	This is truly amazing,” said Max Holmes, deputy director of Massachusetts’s Woods Hole Research Center, who has studied the carbon cycle in both Alaska and Cherskiy.	0.949645
Topenie permafrostu som si predstavoval hlavne ako pomalý a stály proces, možno ako zvláštny päťročný jav.	I’ve largely imagined permafrost thaw as a slow and steady process, and maybe this is an odd five-year period.	0.47321
Čo ak to tak nie je?	But what if it’s not?	0.2625
Čo ak sa veci menia oveľa rýchlejšie?	What if things change much more quickly?”	0.2625
Čo ak tieto zmeny povedú k ďalším, ktoré ich umocnia tak, ako je to aj v prípade ľadovcov Severného ľadového oceánu?	And what if the change becomes self-reinforcing—as it already is, for example, in the case of Arctic sea ice?	0.283696
Morský ľad odráža slnečné lúče a oceán sa pod ním udržuje v chlade.	Sea ice reflects the sun’s rays, keeping the ocean below it cold.	0.294545
No pri topení morského ľadu temný oceán absorbuje teplo. ~~~ Dôsledkom je ešte väčšie množstvo topiaceho sa ľadu.	But as sea ice melts, the dark ocean absorbs that heat, which then melts more ice.	-0.0581633
Hraničné body, ktoré spôsobujú isté spätné reakcie, sa spravidla ťažko predvídajú.	As a rule, the tipping points at which such feedback loops kick in are tricky to predict.	0.29589
Existujú hranice, ktoré nechceme prekročiť, tvrdí Chris Field, riaditeľ inštitútu pre životné prostredie Univerzity v Standforde Woods Institute for the Environment.	We know there are thresholds we don’t want to cross,” said Chris Field, director of Stanford University’s Woods Institute for the Environment.	1.19553
Ale nevieme, kde tieto hranice sú, dodáva.	But we don’t know precisely where they are.	0.3
O permafroste veľa vecí nevieme.	With permafrost, there’s just too much we can’t see.	0.134483
Permafrost zaberá územie skoro dvakrát väčšie, než je rozloha Spojených štátov. ~~~ Obýva ho taký počet ľudí ako približne polovica populácie mesta New York, a to na najmenej prístupných terénoch na svete.	It covers an area more than twice the size of the United States, inhabited by half as many people as New York City, in some of the world’s least accessible terrain.	0.0248266
Iba malú časť z toho sledujú vedci priamo.	Little of it is monitored directly.	0.251613
Namiesto toho skúmajú neveľké územia, ďalšie iba pozorujú na diaľku a o iných sa snažia vyvodiť závery. ~~~ Naopak, ľadovce Severného ľadového oceánu je možné zmerať satelitom ako jeden celok.	Scientists instead study small plots, track others remotely, and draw inferences about the rest—unlike Arctic sea ice, which can be measured in its entirety by satellite.	-0.0174658
Na internete môžete sledovať, čo sa presne stalo s morským ľadom, hovorí odborník na permafrost z Univerzity v severnej Arizone Ted Schuur, s permafrostom je to ťažšie.	You can go online and track exactly what happened to sea ice,” said permafrost expert Ted Schuur of Northern Arizona University. ~~~ With permafrost, we’re barely looking.	0.157756
Naše nástroje ledva dokážu zmerať, čo sa práve deje.	We barely have the tools to measure what’s happening.	0.293333
Výskumníkov obzvlášť znepokojuje jeden typ permafrostu – 20 % toho, ktorý obsahuje obrovské množstvo usadenín pevného ľadu.	One type of permafrost has researchers particularly concerned: the 20 percent or so that contains immense deposits of solid ice.	2.12778
Časť ľadu sa vytvorila vtedy, keď pôda presiakla vodou a zamrzla pri styku s permafrostom. ~~~ Iná časť vznikla pred tisíckami rokov počas arktických zím, keď sa zem zmrštila, popraskala a vytvorila tak polygonálne tvary.	Some of that ice formed when water percolated down through soils and froze as it hit permafrost; some was created over thousands of years during Arctic winters, when the ground contracted and cracked into polygonal patterns.	-0.00240642
Na jar roztopená voda tieto štrbiny naplnila a neskôr opätovne zamrzla.	In spring, meltwater filled those crevices, which later refroze.	0.273684
Po čase podpovrchový ľad prerástol do mohutných klinov obklopených permafrostovou pôdou.	Over time the buried ice grew into massive wedges enveloped by permafrost soil.	0.251471
Útes Duvanny Yar je nimi preplnený.	Duvanny Yar is shot through with them.	1.13779
Takáto štruktúra sa môže rýchlo rozpadnúť.	Such a structure can unravel swiftly.	0.254545
Keď sa permafrost rozpadá, topí sa aj podpovrchový ľad.	When permafrost disintegrates, buried ice melts too.	0.668617
Pri odtoku vody sa prenáša teplo, ktoré podporuje topenie, a zanecháva za sebou tunely a vzduchové vrecká.	As water drains, it transports heat that spreads the thawing, and it leaves behind tunnels and air pockets.	0.3
Zem sa prepadá a tieto dutiny vypĺňa. ~~~ Tak vytvára povrchové priehlbiny, ktoré sa napĺňajú dažďovou a roztopenou vodou.	The ground sinks to fill those cavities, creating surface depressions that fill with rain and meltwater.	-0.0233333
Voda prehlbuje mláky a prehrýza sa cez ich zľadovatené brehy, až kým sa z mlák nevytvoria rybníky a z rybníkov sa nestanú jazerá.	The water deepens the pools and chews through their icy banks, until puddles grow to ponds and ponds become lakes.	0.2625
To spôsobí, že sa zohrieva a roztápa ešte viac pôdy.	That causes more ground to warm and more ice to melt.	0.3
Náhle topenie, ako vedci nazývajú tento proces, mení celú krajinu.	Abrupt thaw,” as scientists call this process, changes the whole landscape.	0.258621
Spôsobuje zosuvy pôdy.	It triggers landslides.	0.285714
Od roku 1984 do roku 2013 zaznamenali vedci na Banksovom ostrove v Kanade 60-násobný nárast prepadov pevnej pôdy.	On Banks Island in Canada, scientists documented a 60-fold increase in massive ground slumps from 1984 to 2013.	0.451579
Vedie to k prepadávaniu lesov.	It topples forests.	0.15
Ekologička Marrit Turetská v spolupráci s kanadskou Univerzitou v meste Guelph počas posledných 15 rokov sleduje náhle topenie v smrekových lesoch blízko mesta Fairbanks.	Merritt Turetsky, an ecologist with Canada’s University of Guelph, has tracked abrupt thaw in a black spruce forest near Fairbanks for the past 15 years.	1.57846
Zistila, že tamojšie záplavy narúšajú korene a kmene stromov.	Flooding there, she has found, is destabilizing tree roots and trunks.	0.261111
Turetská sa domnieva, že všetky stromy v jej opitom lese sa čoskoro prevrátia a pohltí ich mokraď.	Turetsky suspects all the trees in her drunken forest” will tip over soon and get swallowed by new wetlands.	0.271084
Stále sú tam miesta s pevnou pôdou, ale aby ste sa k nim dostali, musíte sa prebrodiť mokrými časťami, hovorí.	There are still little pockets of land, but you have to wade through some pretty wet spots to reach them,” she said.	0.286957
Topenie permafrostu spôsobuje vznik emisií skleníkových plynov.	All permafrost thaw leads to greenhouse gas emissions.	0.2375
Stojatá voda však túto hrozbu urýchľuje.	But standing water accelerates the threat.	0.283333
Plyn, ktorý pochádza z bezkyslíkového blata spod rybníkov a jazier, neobsahuje len oxid uhličitý, ale aj metán. Je to 25-krát nebezpečnejší skleníkový plyn než oxid uhličitý.	The gas that bubbles from the oxygen-deprived mud under ponds and lakes is not only carbon dioxide but also methane, which is 25 times as potent a greenhouse gas as CO2.	0.389683
Ekologička Katey Walter Anthonyová z Univerzity vo Fairbanks na Aljaške meria metán vychádzajúci z arktických jazier už 2 desaťročia.	Ecologist Katey Walter Anthony of the University of Alaska Fairbanks has been measuring the methane coming from Arctic lakes for two decades.	0.737069
Jej posledné merania zverejnené v roku 2018 ukazujú, že nové jazerá vytvorené náhlym topením môžu až strojnásobiť emisie skleníkových plynov spôsobené permafrostom.	Her latest calculations, published in 2018, suggest that new lakes created by abrupt thaw could nearly triple the greenhouse gas emissions expected from permafrost.	0.295775
Nie je známe, nakoľko táto správa ovplyvnila politiku.	It’s not clear how much of this message has reached policymakers.	0.25
V októbri minulého roku zverejnila inštitúcia IPCC novú správu.	Last October the IPCC unveiled a new report on the more ambitious of two temperature goals adopted at the 2015 Paris conference.	0.321429
Tá sa týka cieľa obmedziť rast globálnej teploty o maximálne 2 °C ako bolo stanovené na parížskej konferencii v roku 2015.	The planet already has warmed by about one degree Celsius (1. 8 degrees Fahrenheit) since the 19th century.	0.26044
Od 19. storočia sa planéta oteplila asi o 1 °C. ~~~ V správe sa uvádza, že znížením globálneho otepľovania z 2 °C na 1,5 °C bude o 420 miliónov ľudí menej vystavených častým extrémnym vlnám horúčav. ~~~ Takisto sa počet rastlín a živočíchov, ktorých biotopy môžu zaniknúť, zníži na polovicu.	Capping global warming at 1. 5 degrees Celsius rather than two degrees, the report said, would expose 420 million fewer people to frequent extreme heat waves, and it would halve the number of plants and animals facing habitat loss.	-0.103608
Pravdepodobne sa zachránia aj koralové útesy a necelé 2 milióny kilometrov štvorcových permafrostu.	It also might save some coral reefs—and as much as 770,000 square miles of permafrost.	0.238356
Aby sa podarilo otepľovanie obmedziť na 1,5 °C, IPCC tvrdí, že emisie oxidu uhličitého by sa do roku 2030 museli znížiť o 45 % a do roku 2050 úplne odstrániť. ~~~ Ďalej by sa mali vyvinúť technológie na odsávanie obrovského množstva oxidu uhličitého z atmosféry.	But to achieve the 1.5- degree goal, according to the IPCC, the world would have to cut greenhouse gas emissions 45 percent by 2030, eliminate them completely by 2050, and develop technologies to suck huge quantities back out of the atmosphere.	0.087262
Výzva môže byť ešte väčšia.	The challenge may be even starker.	0.225
IPCC pri správe o znížení na 1,5 °C po prvý raz zohľadnil aj emisie súvisiace s permafrostom, no nezahŕňal však emisie spôsobené rýchlym topením.	The 1.5-degree report was the first time the IPCC had taken permafrost emissions into account—but it didn’t include emissions from abrupt thaw.	0.430435
Klimatické modely ešte nie sú dosť sofistikované na to, aby zachytili tento druh rýchlych zmien krajiny.	Climate models aren’t yet sophisticated enough to capture that kind of rapid landscape change.	0.270732
Na žiadosť spoločnosti National Geographic Katey Walter Anthonyová a modelár z Národného laboratória Lawrenca Berkeleyho Charles Koven vypočítali približné hodnoty emisií spôsobené rýchlym topením.	But at National Geographic’s request, Katey Walter Anthony and Charles Koven, a modeler at the Lawrence Berkeley National Laboratory, made rough calculations that do add in emissions from abrupt thaw.	0.894767
Odhadujú, že na zastavenie nárastu teploty na 1,5 °C by sme museli naše emisie fosílnych palív úplne obmedziť najneskôr do roku 2044, teda o 6 rokov skôr, než predpokladal časový harmonogram IPCC.	To halt temperature rise at 1.5 degrees, they estimate, we’d have to zero out our own fossil fuel emissions at least 20 percent sooner—no later than 2044, six years ahead of the IPCC timetable.	0.381592
Transformácia globálneho energetického systému by tak trvala štvrť storočia.	That would give us just a quarter century to completely transform the global energy system.	0.26087
Stojíme pred neznámou budúcnosťou a nemáme dostatočné nástroje, povedal Koven.	We’re facing this unknown future with an incomplete set of tools,” Koven said.	0.286567
Neistotu nepociťujeme len my.	The uncertainty isn’t all on our side.	0.233333
Je veľa možností, ako by sa veci mohli zhoršiť. ~~~ Napríklad, existuje viac spôsobov vzniku nových jazier.	There are a lot of ways things could turn out worse. There’s more than one way to make new lakes, for example.	-0.00166667
Niekoľko týždňov po odchode zo Sibíri sme s Orlinskou a s ekológom Kenom Tapeom – kolegom Waltera Anthonyho z Aljašskej univerzity, absolvovali raftový výlet v aljašskom národnom parku Gates of the Arctic.	A few weeks after leaving Siberia, Orlinsky and I took a raft trip through Alaska’s Gates of the Arctic National Park with ecologist Ken Tape, a colleague of Walter Anthony’s at the University of Alaska.	0.654813
Plavákové lietadlo nás spolu so sprievodcom riekami Michaelom Waldom vysadilo pri jazere Gaedeke v centrálnej časti pohoria Brooks Range.	A floatplane dropped us and river guide Michael Wald at Gaedeke Lake, in the central Brooks Range.	0.666265
Odtiaľ sme sa vydali južne od rieky Alatna.	From there we made our way south down the Alatna River.	0.227027
Lúče septembrového slnka tancovali na vode.	September sun danced on the water.	0.21
Asi po kilometri a pol sme našli pri brehu rozhryzené konáriky.	Within a mile or so we found chewed sticks along the bank.	0.5125
Po týždni na rieke sme dorazili k jazeru s rozlohou 153 780 metrov štvorcových, ktoré tam predtým nebolo.	We’d been on the river a week when we arrived at a 38-acre lake that hadn’t been there before.	0.253247
V jeho strede bola obrovská bobria hrádza.	At its center was an enormous beaver lodge.	0.3
Tape už roky využíva letecké a satelitné fotografie na sledovanie zmien rastlín či divej zveri na Aljaške a vplyvu na permafrost.	Tape has been using aerial and satellite photographs for years to track how plants and wildlife are changing in Alaska—and how that might affect permafrost.	0.51
Keď sa permafrost topí a vegetačné obdobie sa predlžuje, Arktída zelenie. ~~~ Napríklad počet kríkov pri aljašských nížinách riek sa takmer zdvojnásobil.	As permafrost thaws and the growing seasons lengthen, the Arctic is greening: Shrubs in Alaska river plains, for example, have nearly doubled in size.	-0.0046875
(Aj keď na rast vegetácie je potrebné viac uhlíka, odborníci v prieskume z roku 2016 dospeli k záveru, že arktická ekologizácia nebude dostatočnou kompenzáciou pre rozmŕzajúci sa permafrost.)	(While vegetation growth will take up more carbon, a 2016 survey of experts concluded that Arctic greening won’t be nearly enough to offset permafrost thaw. )	1.45282
Z dôvodu vegetácie sa zvieratá sťahujú na sever.	The vegetation is drawing animals north.	0.25
Vďaka vŕbam, ktoré sú teraz také vysoké, že vytŕčajú zo snehu, môžu zajace meňavé nájsť jedlo na zimu a úkryty až v oblasti Severného ľadového oceánu.	With willows now tall enough to poke through snow, snowshoe hares can find winter food and hiding spots all the way to the Arctic Ocean.	0.265487
Pôvodní obyvatelia lesov teraz osídlili oblasť North Slope vzdialenú stovky kilometrov od skutočných lesov.	Typically forest dwellers, they’ve now colonized Alaska’s North Slope, hundreds of miles from any real forest.	0.496842
Rys, ktorý sa živí zajacmi, ich zrejme nasledoval.	Lynx, which prey on hares, appear to have followed.	0.3
Obe skupiny živočíchov pravdepodobne postupujú po stopách losov, ktoré sa živia aj vŕbami a ktorých počet v okolí rieky Colville, kde sa predtým nevyskytovali, je dnes okolo 1 600.	Both are probably traveling a trail blazed by moose, which also eat willows and now number roughly 1,600 along the Colville River, where they were absent before.	0.369643
Tieto objavy viedli Tapa k hľadaniu fotografií s ďalšími obyvateľmi tundry.	Those discoveries led Tape to search photographs for other tundra newcomers.	0.295455
Len čo som si spomenul na bobry, pustil som sa do toho, povedal.	As soon as I thought about beavers, I seized on it,” he said.	0.282
Veľmi málo druhov zvierat zanecháva stopu viditeľnú až z vesmíru.	Very few species leave a mark so visible that you can see it from space.	0.289474
Na snímkach z rokov 1999 až 2014, ktoré zachytávali iba tri rozvodia, spozoroval 56 nových komplexov bobrích rybníkov. ~~~ Tie tam v 80. rokoch neboli.	In images from 1999 to 2014, covering just three watersheds, he spotted 56 new beaver pond complexes that hadn’t been there in the 1980s.	1.0072
Zvieratá skutočne prichádzajú na severnú Aljašku a za rok prejdú zhruba 8 kilometrov.	The animals are colonizing northern Alaska in earnest, moving at about five miles per year.	0.283784
Tape verí, že na arktickej Aljaške je v súčasnosti až 800 komplexov bobrích rybníkov, vrátane spomínanej bobrej hrádze na rieke Alatna.	Tape believes there are now up to 800 beaver pond complexes in Arctic Alaska, including the one with the massive lodge on the Alatna.	2.05921
Tape ju pomenoval Lodge Mahal.	Tape dubbed it Lodge Mahal.	1.7625
Bol to celkom zaujímavý pohľad – asi 243 centimetrov vysoká a meter široká kopa konárov a stromčekov bola pokrytá bahnom a machom.	It was quite a sight: a mound of branches and saplings, about eight feet high by 35 feet across, plastered with mud and moss and sitting in a waist-high lake surrounded by marsh.	0.590395
Nachádzala sa v jazere, ktoré človeku siaha asi po pás, v jazere obklopenom močiarom.	The water had been diverted from the river by a series of dams.	0.178846
Vodu z rieky odvádzali priehrady.	That entire swamp around Lodge Mahal is new,” Tape said.	0.12
Celý močiar okolo Lodge Mahal je nový, povedal Tape, keby ste tu boli pred 50 rokmi, nenašli by ste tu žiadneho bobra.	If you went back 50 years, there’d be zero beavers here.	2.72447
Tape a Wald chceli preskúmať Alatnu, pretože sprievodca, ktorý pracuje pre Walda, už predtým našiel pozdĺž rieky Nigu drevo obhryzené bobrami.	Tape and Wald had wanted to explore the Alatna in part because a guide who works for Wald had earlier found beaver-chewed wood along the Nigu River.	0.845455
Rieka Nigu pramení na opačnej strane kontinentálneho rozvodia, neďaleko horného toku Alatny pri jazere Gaedeke. ~~~ Ďalej tečie na sever, vlieva sa do rieky Colville a Severného ľadového oceánu.	The Nigu starts near Gaedeke Lake, the Alatna headwaters, but on the other side of the Continental Divide—and so it flows north into the Colville River and the Arctic Ocean.	0.0720259
Pozdĺž rieky Alatna nad tzv. Lodge Mahal sme našli ďalšie rybníky a opustené priehrady.	Along the Alatna, above Lodge Mahal, we found other ponds and abandoned dams.	0.473377
Tape si teraz myslí, že bobry sú na ceste k oblasti North Slope a že Alatnou prechádzajú cez pohorie Brooks Range.	Tape now thinks that beavers are on their way to the North Slope, and that they’re using the Alatna as a route through the Brooks Range.	0.928134
Túto expanziu sledujeme akoby v priamom prenose, uviedol.	We’re seeing this expansion in real time,” he said.	0.252273
Nevie dokázať, že takéto zmeny spôsobuje zmena podnebia. ~~~ Výskyt bobrov ovplyvnil aj koniec obchodu s kožušinou pred 150 rokmi.	He can’t prove that climate change is driving it; the beaver population also has been rebounding since the end of the fur trade, a century and a half ago.	-0.0216216
V každom prípade, títo zubatí stavitelia by mohli výrazne zmeniť ráz permafrostu.	But in any case, the bucktoothed engineers could significantly remake permafrost landscapes.	0.253521
Predstavte si, že by ste boli vývojárom a povedali by ste si, že chcete povolenie na vybudovanie troch priehrad na každý druhý prúd v arktickej tundre, povedal Tape.	Imagine if you were a developer and you said, I’d like permission to put three dams on every other stream in the Arctic tundra,” Tape said.	0.348502
Takto nejako to môže byť.	That’s what this could be like.	0.231818
Tape videl malú ukážku.	Tape has seen a preview.	0.9
Fotografie prítoku rieky Serpentine, ktorá sa nachádza juhovýchodne od mesta Shishmaref na aljašskom Sewardovom polostrove, nepoukazujú v období od roku 1950 a 1985 na žiadne zmeny.	Southeast of Shishmaref, on Alaska’s Seward Peninsula, photos of a tributary of the Serpentine River show no change at all between 1950 and 1985.	0.457073
Do roku 2002 sa sem nasťahovali bobry a krajina sa zaplavila.	By 2002 beavers had moved in and flooded the landscape.	3.26809
Do roku 2012 sa časť pôdy zrútila a zmenila sa na mokrade.	By 2012 some ground had collapsed and become wetlands.	3.59362
Permafrost sa strácal.	Permafrost was on its way out.	0.978571
Niekoľko stoviek bobrov nezrekonštruuje Arktídu.	A few hundred beavers won’t reengineer the Arctic.	0.293182
Zvieratá však môžu smerovať aj na sever do Kanady a na Sibír. ~~~ Rýchlo sa rozmnožujú.	But the animals may be heading north in Canada and Siberia too, and they reproduce quickly.	-0.0104167
Experiment z Argentíny je poučný. V roku 1946 na juh úmyselne doviezli 20 bobrov na podporu kožušinového obchodu.	Argentina’s experience is instructive: Twenty beavers were deliberately introduced in the south in 1946 in order to foster a fur trade.	0.399132
Dnes sa ich počet pohybuje okolo 100 000.	Today that population hovers around 100, 000.	0.632143
V predstavách Zimovcov o minulosti i budúcnosti arktického permafrostu hrajú dôležitú úlohu aj divé zvieratá. ~~~ Avšak tieto živočíchy sú väčšie ako bobry a ich vplyv na permafrost je dôležitejší.	In the Zimovs’ vision of the past and future of Arctic permafrost, wild animals also play a central role—but the beasts are bigger than beavers, and their effect on permafrost more benevolent.	0.00774648
Sergej Zimov už dlho tvrdí, že stáda bizónov, mamutov, koní a sobov, ktoré sa tiahli stepami v období pleistocénu, boli zodpovedné za udržiavanie stepí.	The herds of bison, mammoths, horses, and reindeer that lumbered across the Pleistocene steppes, Sergey Zimov has long argued, did more than just eat the grass. They maintained it.	0.366923
Okrem toho, že jedli trávu, hnojili ich svojimi výkalmi, pošľapávali machy i kríky a vytrhávali stromčeky.	They fertilized it with their waste and packed it down, trampling mosses and shrubs and ripping out tree saplings.	0.283696
Od poslednej doby ľadovej nahradila tieto trávnaté pláne na východe Sibíri vlhká tundra. ~~~ Na jej severe dominujú machy a na juhu lesy.	Since the last ice age, those dry, rich grasslands have been replaced in eastern Siberia by damp tundra, dominated by mosses in the north and forests farther south.	-0.03
Podľa Zimova boli jedným z hlavných činiteľov tejto zmeny lovci, ktorí zhruba pred 10 000 rokmi zničili stáda pasúcich sa zvierat.	One key driver of that change, according to Zimov, was human hunters who decimated the herds of large grazers, by about 10, 000 years ago.	0.425553
Bez týchto zvierat, ktoré hnojili pôdu, tráva vyschla. ~~~ Bez trávy, ktorá sala vodu, sa pôda premáčala.	Without grazers to fertilize the soil, grasses withered; without grasses to soak up water, the soil got wetter.	-0.0101124
Ujali sa machy a stromy.	Mosses and trees took over.	0.257143
Keby však ľudia pred tisíckami rokov netlačili ekosystém za hranice, stále by sa na Sibíri pásli mamuty.	But if humans hadn’t pushed the ecosystem beyond a tipping point thousands of years ago, there would still be mammoths grazing in Siberia.	0.205618
Zimov pred takmer 25 rokmi vytvoril názorný projekt s rozlohou 145 kilometrov štvorcových tzv. Pleistocénny park, nachádzajúci sa v nížinách neďaleko mesta Cherskiy.	Almost 25 years ago, on lowlands near Cherskiy, Zimov created a 56-square-mile demonstration project called Pleistocene Park.	0.540606
Chcel dostať veľké pasúce sa zvieratá späť a zistiť, či dokážu obnoviť trávnaté pláne.	His idea was to bring large grazers back and see whether they would bring back the grasslands.	0.27973
Zimov spolu s Nikitom nakoniec odchytili divoké kone a neskôr z Bajkalského jazera priviezli jaky a ovce.	He and, eventually, Nikita fenced in wild horses and later trucked in yaks and sheep from Lake Baikal.	0.286047
Na jar minulého roku Nikita priviezol 12 bizónov z Dánska, prešiel pritom vyše 14 000 kilometrov nákladným autom a člnom cez Rusko.	This past spring Nikita hauled in 12 bison from Denmark, traveling 9, 000 miles across Russia by truck and barge.	0.678045
V roku 2018 sa Zimovci spojili s genetikom z Harvardovej univerzity Georgom Churchom, ktorý si myslí, že dokáže naklonovať mamuta.	In 2018 the Zimovs joined forces with Harvard University geneticist George Church, who thinks he essentially can clone a mammoth.	1.86873
Dúfame, že jedného dňa budú tieto vyhynuté zvieratá dupať okolo Pleistocénneho parku a v antropocéne sa im bude dariť.	The hope is that one day those now extinct beasts will be stomping around Pleistocene Park, thriving in the Anthropocene.	0.294059
Pleistocénny park jasne potvrdzuje hypotézu Sergeya Zimova. ~~~ Dúfa, že je aj preventívnym opatrením proti klimatickým zmenám.	The park is the ultimate test of Sergey Zimov’s hypothesis—and, he hopes, a hedge against future climate change.	0.0708333
Trávnaté pláne, najmä keď sú pokryté snehom, odrážajú viac slnečného žiarenia ako tmavý les.	Grasslands, especially when snow covered, reflect more sunlight than does dark forest.	0.284211
Pasúce sa zvieratá udupávajú sneh, a tak umožňujú únik tepla z pôdy.	Grazing animals tamp down deep snow, allowing heat to escape the soil.	0.289655
Oba tieto faktory ochladzujú zem.	Both things cool the land.	0.208696
Keby divoká zver dokázala obnoviť trávnaté pláne, spomalilo by to topenie permafrostu, a tým aj zmenu podnebia.	If wildlife could restore grasslands, it would slow permafrost thaw and thus climate change.	0.24
Aby ste však dosiahli skutočnú zmenu, museli by ste vypustiť tisíce zvierat zo zoologických záhrad na obrovské územia Arktídy.	To make a real difference, though, you’d need to unleash thousands of zoos’ worth of animals across millions of acres of the Arctic.	0.294495
Podľa Zimovcov sú dôkazy z ich parku sľubné.	The Zimovs say the evidence from their 36, 000-acre park is promising.	0.126316
Aj keď je tam približne iba 100 zvierat, trávnaté porasty parku zostávajú podstatne chladnejšie ako zem v okolí.	Even with only about a hundred animals, the park’s grasslands stay substantially cooler than the ground in the surrounding area.	0.25625
Rozdiel medzi ambíciami Zimovcov a skutočnou podobou parku je nepochybne veľký.	The gap between the Zimovs’ ambitions and the reality of the park is unquestionably large.	0.27
Raz poobede sme s Orlinskou vyšli na rozmočené trávnaté plochy, ktoré pripomínali močiar, sledovať kone.	During a tour one afternoon, Orlinsky and I hiked soggy grasses to a stretch of marsh to watch the horses.	0.289773
V diaľke sa skryl osamelý bizón.	A lone bison hid in the distance.	0.3
Nikita nás naložil do osemkolesového mini tanku a viedol cez padnuté vŕby.	Nikita loaded us onto an eight-wheel mini-tank and took us crashing through the willows.	0.474519
Po prudkom stúpaní sme prešli cez niekoľko štíhlych smrekovcov.	After a steep climb we plowed over some skinny larches.	0.242553
Preto potrebuje obrovských bylinožravcov. ~~~ Momentálne nemám žiadne zvieratá, ktoré by sa týchto stromov zbavili, vraví Nikita.	This is why he needs giant herbivores, Nikita said: At the moment I don’t have any animals which can kill those trees.”	-0.0212121
Veľa času trávi získavaním finančných prostriedkov. ~~~ Naposledy bol v Kalifornii, kde sa skamarátil s bývalým guvernérom Jerrym Brownom, aby tento plán pokračoval ďalej.	He spends a lot of time raising funds, most recently in California, hobnobbing with the likes of former Governor Jerry Brown, just to keep this proof of concept going.	-0.00857143
Tento nápad sa stretáva i s kritikou.	The concept has its critics.	0.216
Niektorí vedci popierajú odhady Zimovcov o tom, koľko veľkých zvierat sa potulovalo po Sibíri v období pleistocénu. ~~~ Tvrdia tiež, že ich teória o ekologických zmenách, minulých aj súčasných, je príliš zjednodušená.	Some scientists dispute the Zimovs’ estimates of how many large animals were roaming around Siberia in the Pleistocene, or insist that their theory of ecological change, both past and present, is too simplistic.	-0.005
Väčšina kritiky poukazuje predovšetkým na trúfalosť Zimovcov.	Above all, most criticism seems leveled at the Zimovs’ audacity.	0.3
Max Holmes z inštitúcie Woods Hole, ktorý ich dobre pozná, vidí v ich tvorbe geniálnu iskru.	Max Holmes of Woods Hole, who knows them well, sees a spark of genius in their work.	0.966752
Holmes povedal: Zimovci síce nie sú v centre pozornosti, ale práve mimo nej často vznikajú skvelé nápady a zmeny.	The Zimovs are at the fringe,” Holmes said, but that’s often where big ideas and big changes originate.	0.42686
Moderný svet mimo Pleistocénneho parku reagoval na otepľujúcu sa Arktídu nezáujmom.	Outside Pleistocene Park, the modern world has responded to the warming Arctic with complacency.	0.259459
Celé desaťročia sme ignorovali dôkazy o klimatických zmenách a dúfali sme, že sa situácia príliš nezhorší.	We’ve spent decades ignoring the evidence of climate change and hoping that things won’t get too bad.	0.27907
Spoliehame sa na pokrokovú techniku, ktorá sa zdá byť nedosiahnuteľná.	We count on technological advances that seem always just out of reach.	0.29
Konáme tak aj napriek radám vedcov zaoberajúcich sa klímou, najmä odborníkov na permafrost, ktorí tvrdia, že všetko poukazuje na potrebu naliehavých až odvážnych opatrení.	And we do this in spite of the fact that climate scientists—permafrost experts in particular—say all signs point to the need for urgent and even audacious action.	0.273723
Zimovci sú iní. ~~~ Svoj život strávili bojom v nemilosrdnej krajine, ktorá sa nechce poddať.	The Zimovs are different: They’ve spent their lives battling an unforgiving landscape that rewards bullheadedness.	-0.0417722
Pýtajú sa, či je záchrana permafrostu obnovením arktickej stepi naozaj šialenejšia predstava než očakávanie, že ľudia rýchlo zmenia energetický systém sveta.	Is trying to save permafrost by restoring the Arctic steppe, they ask, really so much crazier than counting on humans to quickly retool the world’s energy system?	0.29781
Možno naozaj potrebujeme trochu šialenstva.	Maybe we need a little craziness.	0.186207
Boj proti klimatickým zmenám si vyžaduje viac krokov z rôznych strán. ~~~ Ak ich skombinujeme, budúcnosť nemusí byť celkom mizerná, uviedol Nikita.	Fighting climate change needs multiple actions from multiple different fronts,” Only if we combine them all can we make the future not entirely miserable Nikita said.	-0.0190476
Dnešné ráno som zišla dole a zistila, že Šibalka je fuč. ~~~ Podľa oficiálnych núdzových opatrení som to mala telefonicky nahlásiť Úradu pre zmiznutia.	When I went downstairs this morning and found Cookie missing, I knew that official emergency procedure called for me to phone all the information in to the Bureau of Disappearances.	-0.0214904
Hlas by následne podal krátky parametrický popis mačky a ak by sedel na moju chýbajúcu položku, mohla by som stlačiť mriežku a nahrať pätnásťsekundový opis.	The woman's voice would then give a short parametric definition of a cat, and if this definition matched my missing item, I could press the pound sign to record a fifteen-second description.	0.469867
Trojtónová melódia by mi potom oznámila, že systém zaregistroval moju žiadosť. ~~~ Ľubozvučný hlások by napokon k prípadu priradil číslo a k tomu dodal aj zopár inštrukcií, ako postupovať pri nahlasovaní nových informácií alebo zrušení žiadosti.	A three-note melody would let me know that my claim had been filed, and then that lovely prerecorded voice would read out my assigned case number, along with some instructions on how to update or cancel my claim.	-0.0289773
Namiesto toho som však zdvihla telefón a vyťukala tvoje číslo.	Instead, I picked up the phone and pushed your number into it.	0.288462
Vždy som ti hovorievala o problémoch, ktoré si nemohol vyriešiť, akoby som násobením nešťastia bola schopná zriediť ho.	I was always telling you about problems you couldn't fix, as though multiplying badness could dilute it.	0.252809
Šibalka je preč, povedala som a čakala na tvoju odpoveď.	Cookie's gone, I said, and waited for your response.	0.28
··· Na druhom konci linky bolo chvíľu ticho.	··· There was a pause on the other end of the line.	0.609649
Nahlásila si to? spýtal si sa.	Have you phoned it in? you asked.	0.276923
Tvoj hlas znel nenútene, akoby šlo o zvieratko niekoho úplne cudzieho, o akési zviera z ďalekých krajín, ktoré vlastnia ľudia, ktorých sme nikdy predtým nestretli.	Your voice was casual like it was someone else's pet entirely, a pet from a faraway land owned by people we'd never meet.	0.18
Nie, odvetila som.	I didn't, I said.	0.26
Potom som ešte dodala: Mám tak trochu depku.	I'm kind of depressed, I added.	0.177778
Často som mávala depresiu, ale v poslednom čase sme na ňu mali všetci dobrý dôvod.	I was often depressed, but now we all had better reasons to be.	0.201923
Je mi to ľúto, znela tvoja odpoveď.	I'm sorry, you said back.	0.190909
Šibalka rada žula káble, skonštatovala som.	Cookie loved to chew on wires, I said.	0.234375
Viem, povedal si.	I know, you said.	0.28
Nepovedal si však, že by si teraz chcel byť so mnou.	You didn't say you wished you could be here.	0.251351
Ani ja som to nepovedala.	I didn't say it either.	0.27
Nič viac sa nedalo dodať.	There was nothing more to say.	0.245455
Zložila som telefón.	I hung up the phone.	0.264706
Niekedy som ti hneď spätne zavolala, len aby som počula, ako zdvihneš, a vedela, že práve v tú chvíľu máš ruky na kuse plastu, ktorý si skrze stovky kilometrov káblov a drôtov nežne vinie cestu ku mne.	Sometimes I dialed you back right away just to hear you pick up and know that your hands were, at that very moment, resting on a chunk of plastic that threaded its way delicately to me over hundreds of miles of wire and cord.	0.348224
Vedela by som, že si ešte stále nezmizol, hoci tvoj hlas áno.	To know that even though your voice had disappeared, you had not yet.	0.258824
V poslednej dobe som si však už nedovolila spätne vyvolávať.	But recently I hadn't been allowing myself any callbacks.	0.288
Začala som sa obávať dňa, keď by si mi nezdvihol.	I was getting more afraid of the day when you wouldn't pick up.	0.219512
Apokalypsa bola tichá.	The apocalypse was quiet.	0.271429
Mala niečo do seba, istý šarm.	It had a way about it, a certain charm.	0.230769
Skoro by som ju nazvala vznešenou.	It could be called graceful.	0.24
A dávala si poriadne načas.	It was taking a long time.	0.272727
··· Ľudia sa chystali na apokalypsu, pri ktorej sa mohli chopiť zbrane a ukryť.	··· People prepared for an apocalypse that they could take up arrns against, bunker down with.	0.441791
Nahromadili filtrovanú vodu, konzervovanú kukuricu, sušené mlieko, batérie.	People hoarded filtered water, canned corn, dry milk, batteries.	0.236842
Vyšli knihy, ako sa zariadiť v novom postsvete, ktorý si ľudia predstavovali celkom ako ten náš, akurát s jednou či s dvomi kľúčovými vecami, ktoré by chýbali.	They published books on how to get things done in the new postworld, a world that they always imagined as being much like our own, only missing one or two key things.	0.295522
Nazdávali sa napríklad, že preživší sa vynoria na povrch planéty, kde bude chýbať akákoľvek vegetácia.	They might imagine, for example, that survivors would reemerge onto a planet stripped of all vegetable and plant life.	0.259551
Zvieratá by najprv zdiveli a potom pokapali od hladu.	First, the animals would grow vicious and then starve.	0.293478
Bolo by ich treba enormne veľa nazhŕňať, naložiť do soli a skryť do zásoby.	It would be important to hoard as many of these animals as possible, pack them in salt and hide them away to keep.	0.157143
Asi by to chcelo aj rezervu núdzových semienok, ktoré by mohli rásť na zabezpečenom mieste trebárs zo sterilizovanej zeme, ktorú ste si vopred naznášali.	You'd want to have a supply of emergency seed to grow in a secure location, maybe using sterilized soil that you had already hoarded.	0.365946
Nasledovala by povinnosť zhromaždiť skupinu.	Then you'd want to gather a crew.	0.160714
Obsahovala by siláka so zlatým srdcom, vedátora, technika, dieťa a niekoho, o kom ste si mysleli, že by ste ho mohli milovať v prípade, že by ste prežili dostatočne dlhý čas.	One muscleman with a heart of gold, a scientist type, an engineer, a child, and somebody that you thought maybe you could love, if you survived long enough to love them.	0.383036
Nikomu ani na um nezišlo, že apokalypsa bude taká uhladená a bizarná.	Nobody thought the apocalypse would be so polite and quirky.	0.259615
Veci sa z ničoho nič vyparili, akoby samé na seba úplne zabudli.	Things just popped out of exist- ence, like they had forgotten all about themselves.	0.2
Ak ste v tomto svete nevedeli nájsť kľúče, už ste ich nehľadali.	Now when you misplaced your keys, you didn't go looking for them.	0.294444
Možno ste zaklopali domácemu a vypýtali si náhradné, zašli si dať do kľúčovej služby vyrobiť nové, a tento raz rovno dvoje, pre prípad, že to zmiznutie nebola jednorázovka, ale začiatok trendu.	Maybe you went to your landlord and asked for the spare set, took them to the hardware store and made two copies this time, an extra in case the disappearing wasn't a one-off but part of a trend.	0.571816
Prípadne ste to zobrali ako znamenie a odsťahovali sa. ~~~ Vyšli ste do sveta bez akéhokoľvek smeru, aby ste našli vlastný bod miznutia, čo znamenalo odsťahovať sa k bratovi do Chicaga, ktorý stále mal kľúče od domu, plus jeden náhradný zväzok pre vás.	Or maybe you took this as a sign and decided to leave instead, walked out directionless into the world to find your own vanishing point, which meant moving to Chicago to stay with your brother, who still had the keys to his house and a spare set to give to you.	-0.00142857
··· Rozkošná apokalypsa – jedna vec vyšumela, za ňou nasledovala ďalšia.	··· It was cute the way this apocalypse zapped things out of existence, one by one.	0.521429
Apokalypsa bez výhrad, jednoduchá ako zatvorenie okna internetového prehliadača jediným kliknutím.	It was so clean and easy, like clicking on a little box to close an Internet browser window.	0.248684
Mala aj zmysel pre humor. Tučný chlap vykračujúci si ulicou lemovanou opustenými obchodíkmi sa pozrie dolu a zistí, že mu zmizli gate a odhalili tým verejnosti jeho neaktuálne halloweenske spodky.	It had a sense of humor: a fat man walking down the street lined with small abandoned shops would look down and find that his trousers had vanished, baring his out-of-season Halloween boxers to the public.	0.488191
Taký druh humoru.	That kind of humor.	0.28125
Na internete sa podobné videá objavovali každú chvíľu, ale potom sa pominul aj internet.	Videos of things like this used to show up all the time on the Internet, until the Internet went.	0.284211
Chcela som zájsť na mólo a pozrieť sa na ruské koleso ešte predtým, než zmizne.	I thought I would visit the Ferris wheel at the pier before it vanished.	0.27
Nevedela som, kedy sa to stane.	I didn't know when it would go.	0.288462
Napadlo mi, že by som sa pokúsila byť posledným človekom, ktorý ho navštíviť. ~~~ Vyžadovalo by si to však veľa práce, vyčkávania a sledovania a ja som mala čo robiť aj v čase posledných vecí.	I had the idea that I could try to be the last person ever to visit it, but that would require a lot of work, a lot of waiting around and watching, and there were things to do even in the time of last things.	0.0825674
Vložila som si dve jablká do plastového vrecúška a vyšla von z dverí, ktoré som nezamykala, hoci by som poľahky mohla.	I put two apples in a plastic bag and headed out the door, which I didn't lock even though it would have been easy to do.	0.430178
Výťahom som sa zviezla na prízemie a vydala sa po East Jackson Drive. ~~~ Kráčala som až po breh a potom som pokračovala pozdĺž hlavnej pridŕ- žajúc sa zábradlia rukou v rukavici.	I took the elevator down to the first floor and walked on East Jackson Drive to the edge of the water, then up along the highway, holding onto the handrail with one gloved hand.	-0.00310345
Minul ma sedan s tínedžermi a jeden z nich na mňa zakričal čosi nezrozumiteľné, čo mi znelo ako voľakedajší posmešok.	A sedan full of teenagers drove by, and one of them shouted a blurry word at me that sounded like it had once been a taunt.	0.585714
Vonku nebolo veľmi chladno, hoci bola zima.	It was winter, but it wasn't so cold.	0.232258
Aj počasia bolo pomenej, tak ako všetkého.	There was less weather, the same way there was less of everything.	0.145946
Tento deň sa podobal na ten predošlý: ospalý vzduch a pobledlá modrá obloha, žiadne oblaky, iba vágna hmlistá bieloba, ktorá pokojne mohla byť stenčujúcou sa atmosférou.	This day resembled the day before: sleepy air and wan blue sky, no clouds but a vague foggy white that might just have been a thinning of the atmosphere.	0.365873
Na móle som videla čajky, ktoré sa k sebe na promenáde tiesnili, pritláčali si na seba svoje špinavé biele telá.	At the pier I saw the seagulls huddling together on the boardwalk, pressing their dirty white bodies up against each other.	0.268085
Zdalo sa, že môžu jesť hocičo – kôrky, šupky, servítky.	They seemed able to eat anything—crusts, rinds, paper napkins.	0.248936
Boli stvorené prežiť aj v miznúcom svete, ktorý si sám seba odmyslieval rýchlejšie, než sme ho boli schopní s našimi odpadkami opäť zaplniť.	They were made to survive, even in a fading world that was unthinking itself faster than we could fill it back up with our trash.	0.263208
Jedna čajka sa snažila prehltnúť hračkárskeho levíka z plastu a na- prázdno po ňom s tupou trpezlivosťou chniapala zobákom.	One seagull worked to swallow a little plastic toy lion, snap- ping its beak down on it with blunt patience.	0.396667
Ruské koleso sa v diaľke na konci móla mohutne týčilo, hoci nebolo zas až také veľké, ako sa mi zdalo prvý raz, čo som ho uvidela.	The Ferris wheel loomed up big behind them at the end of the pier, though it wasn't as big as it had seemed the first time I saw it.	0.297143
Chýbalo mu zopár spíc a červených kabín na sedenie.		-0.3
Vyzeralo ako ústa človeka, ktorému niekto päsťou opakovane vrážal do tváre.	The wheel was missing spokes at random, and some of the red seating cars had gone.	0.290909
Podišla som k nemu cez voľné priestranstvo, no nebol tam nik, kto by ma uvidel.	It looked like the mouth of someone who had been punched over and over again in the face.	0.268182
Ovládací panel naspodku kolesa bol zamknutý.	I walked over to it, right out in the open, but nobody saw me.	0.225
Rôzna rýchlosť sa nastavovala veľkou bláznivou pákou ako vystrihnutou z animáku.	When I reached the base the controls were all locked up.	0.146809
Podliezla som reťaz a vhupla do najnižšej kabínky prichystanej na jazdu.	It had a big goofy lever that you could set to different speeds, like in a cartoon.	0.52619
Knísala som sa z jednej strany na druhú v snahe rozhojdať ju, ale rýchlo ma to prestalo baviť.	I ducked the chain and climbed into the ground-level car, the one in starting posi- tion, and staggered from one side of the car to the other to try to make it swing, but it wasn't any fun.	0.169433
Potom som si sadla, aby som videla na vodu, a sklopila som kovovú zábranu.	Then I sat facing the water and put down the guardrail.	0.195652
Jazero olizovalo breh tak ako vždy.	The lake licked at the shore the way it used to.	0.222581
Keď zmizne kus vody, ihneď sa tam nahrnie ďalšia, aby si uzurpovala jej miesto, takže nikdy nie je vidno nejakú dieru alebo rozstup.	When water disappears, other water rushes in right away to take its place, you never see any kind of hole or gap.	0.241935
Keď som sa potom načiahla do plastového vrecúška, mala som už iba jedno jablko.	Then when I reached into my plastic bag, I only had one apple.	0.205882
··· Apokalypsa tohto druhu postráca nielen predmety, ale zhltne aj spomienky.	··· This apocalypse disappears object of all kinds, and it swallows memories whole too.	0.519118
Nechcela som byť v tvojej blízkosti, keď na mňa zabudneš.	I didn't want to be around you when you forgot me.	0.241463
Nechcela som sa dívať, ako sa ti z hlavy zľahka vytra- tím, dúfala som, že na teba zabudnem prvá.	I didn't want to watch it fall out of head so easily, I was hoping to forget you first.	0.257143
Niekedy som si však svojím rozhodnutím nebola taká istá.	But sometimes I second-guessed that.	0.154545
Potom som ti volala a snažila sa hnevať, ako keby si to bol ty, kto sa tak strachoval, že na neho zabudnú, až sa musel odsťahovať z bytu, z jedného mesta do iného. ~~~ Niekam, kde dôverné nebolo nič alebo takým nemohlo prestať byť.	Then I called you and tried to be angry, as though you were the one who had been so afraid of being forgotten that you needed to move out of the apartment, out of the city, and into another city where nothing had any familiarity to start with, or any familiarity to lose.	-0.0255319
Dúfala som, že by si mohol zabudnúť, kto komu čo spravil, no zatiaľ som na to čakala márne.	I thought you might have forgotten who did what to whom, but you haven't yet.	0.435937
Vytrácanie sa vecí na začiatku pôsobilo vtipne ako chybička v kontinuite pri zlom filme.	When the first things began to disappear, it had looked funny, like a continuity slip-up in a bad movie.	0.256579
Ty a ja sme dopĺňali zvukové efekty a kričali puf!, keď sa niektoré kvety odbleskli do ničoty.	You and I would make sound effects for them, shouting Poof! or Boink! as some flowers blinked themselves out of existence.	0.208861
Tak sme jeden druhého rozosmievali.	This was how we'd make each other laugh.	0.28125
Hoci sa v tom čase svet rýchlo vyprázdňoval, nám pripadal stále plný.	In those days the world still looked full, even though it was emptying fast.	0.274576
Napokon sa stratilo príliš mnoho vecí, aby sme mohli naďalej robiť zvuky: pochopili sme, aké je smutné, že všetko na svete odišlo a už sa nemôže vrátiť.	Then too many things vanished to keep making the sounds: we saw it was sad that anything in the world had gone and could not return.	0.247222
Žartoval si, že bude menej povinností doma, naše životy si raz pre zmenu za sebou samy upracú, ale aj tak si stále umýval riad, vysával miestečká okolo nábytku a pod ním, každý deň si si vzal čistú košeľu a ustlal posteľ.	You joked around, saying there'd be fewer chores, our lives would clean up after them- selves for a change, but still you went on doing the dishes vacuuming the little spaces around and under the furniture, putting on a fresh shirt every day, making the bed.	0.39011
Keď zmizli sklenené poháre, poskladal si nám nové z papiera, aby sme mali z čoho piť. ~~~ Keď zmizol papier, použil si elegantné látkové obrúsky, ktoré však veľmi nefungovali.	You folded cups out of paper for us to drink from when the glasses went away, and when the paper went you used the cloth napkins, which worked badly.	-0.0307377
Ty si bol typ, ktorý pokračoval. ~~~ Ja ten druhý.	You were the sort of person that keeps it all going, and I was the other kind.	-0.0804878
Potvrdilo sa to dva týždne po prvým zmiznutiach, keď spravodajské stanice prišli s pomenovaním Stratokalypsa.	This became clear two weeks after the first vanishings when the news stations named it The Disappocalypse.	0.283516
V deň, keď ju nazvali nezvratnou, som odišla z kancelárie tesne pred obedom.	On the day they called it irreversible, I walked out of the office just before lunch.	0.272308
Nikomu som nepovedala, kam idem, neodpovedala som ani na e-maily, v ktorých sa ma vypytovali, či chceme zrušiť zdravotné poistenie a vyplatiť dôchodkové sporenie.	I didn't tell anyone where I was going, I didn't reply to the e-mails asking whether we wanted to cancel our health insurance and cash out retirement plans.	0.276923
Vedela som, že sa nevrátim.	I knew I wouldn't be coming back.	0.25
Metro bolo zavreté, tak som sa vybrala do nášho bytu na Myrtle Avenue peši, kráčala som cez Brooklynský most až na predĺženú Flatbush Avenue.	The subway was shut down so I walked all the way to our apartment on Myrtle Avenue, across the Brooklyn Bridge to the Flatbush Extension.	0.526842
V ten deň sa mi svet stále zdal zaplnený.	On that day the world still felt crowded.	0.291176
Obloha nad hlavou bola nezriedene čisto modrastá a dostatočne hrubá, aby za- maskovala, koľko prázdnoty za ňou a atmosférou leží.	The sky above was pure undiluted blue, thick enough to mask how much emptiness lay behind it, out past the atmosphere.	0.263636
Nárazník na nárazníku sa mostom vinuli vozidlá.	Cars were lined up on the bridge, bumper to bumper.	0.292857
Vodiči bez akejkoľvek agresie sporadicky vytrubovali, pripomínali tým migrujúce husi.	Drivers honked sporadically, without aggression, like migrating geese.	0.239063
Keď som sa vrátila domov, bolo neskoro popoludní a ty si mal byť doma o pol siedmej.	When I got home, it was late afternoon and you'd be back by six thirty.	0.243103
Pokúsila som sa čítať noviny. ~~~ O miznutí som prečítala všetko, čo sa dalo zniesť, a ostatné rubriky novín sa stenčovali, niektoré mali biele políčka, ktoré sa nikto neobťažoval zaplniť, farba tak z druhej strany presvitala jemne nasivo.	I tried reading the news-paper, but I'd read all I could stand about the vanishing, and the other sections had been thinning out, some with blank patches nobody bothered to fill where the color of the paper showed through grayish and soft.	-0.00226131
Osem preč a teba nikde.	Then it was seven thirty, and eight, and still you weren't around.	-0.24
Šibalke som nasypala granule a vymenila jej vodu.	I gave Cookie her dry food and refilled her water.	0.292857
Rozplakala som sa, potom prestala a znovu som si namaľovala linky, aby som vyzerala ako predtým.	I started crying and stopped again and then dragged eyeliner back over my lids so that I looked the way I had before.	0.24878
Bolo takmer deväť, keď si sa objavil, a voňal si normálne: žiadny pot, cigarety alebo alkohol.	When you showed up, it was close to nine, and you smelled normal: no sweat, no cigarettes, no liquor.	0.285
Kde si bol?	Where had you been?	0.09
Dlho v práci.	You had been working late.	0.025
Počul si o tom?	Hadn't you heard?	0.230769
Povedali nezvratné, bezprostredne hroziace, koniec sveta.	They said irreversible, imminent, end of days. ”	0.221429
Naozaj použili tieto slová.	They used those words.	0.225
Držal si ma a ja som ti odtlačila do košele dve mokré škvrny.	I put wet marks into your shirt as you held me.	0.205263
Keď som sa odtiahla, tvoja hruď sa na mňa dívala párom rozmazaných očí.	Then when I pulled away your chest looked back at me with two blurry eyes.	0.295
Prečo si to urobil? spýtala som sa ťa.	Why did you do that? I asked.	0.2
Prečo si bol tak dlho preč?	Why were you away so long?	0.286364
Pracoval som, odpovedal si.	I was working, you said.	0.242857
Veľa ľudí odišlo, veď to vieš.	A lot of people have left, you know that.	0.207692
Toby, Marianne a všetci stážisti.	Toby and Marianne and all of the interns.	0.75
Nemáme dosť ľudí.	We're understaffed.	0.24375
Robím na dvoch nových stavebných projektoch.	I'm on two new building projects.!	0.2
Pod rukami ma hrialo teplo a ozajstnosť tvojho chrbta.	Your back was warm and real under my hands.	0.208333
Niet čo stavať, povedala som.	There's nothing to build, I said.	0.265385
Už je po svete.	The world is going.	0.207692
Viem, ohradil si sa.	I know that, you replied.	0.233333
Ale s tým nič nenarobíme.	But there isn't anything we can do about it.	0.0954545
Veď o tom hovorím, oponovala som.	That's what I'm saying, I said.	0.277778
Opätovala som ti pohľad.	I looked at you looking at me.	0.259091
Počula som, že hovoríme to isté, ale nechápala som, ako to môžeme myslieť tak odlišne.	I heard that we were saying the same thing, though I didn't under- stand how it was possible for us to mean it so differently.	0.364212
Neskôr v noci som ťa požiadala, aby si prestal chodiť do práce a počas dňa zostal so mnou doma.	Later that night I asked you to quit your job too, stay home with me during the days.	0.26087
Nahodili by sme režim prežitia a prenajali si byt, ku ktorému by bola aj záhradka.	We could get survival-ready, rent a garden- level apartment with barricadable windows.	0.500334
Okná by sme zabarikádovali a celý deň sa túlali, spoznávali veci, ktoré by už zanedlho neboli.	We could walk around all day getting to know the things that wouldn't be there for much longer.	0.296203
Ale odmietol si to.	But you wouldn't.	0.28125
Páčilo sa ti byť architektom.	You liked being an architect.	0.3
Povedal si, že si šťastný, ak môžeš svetu, ktorý smeruje k úplnej subtrakcii, pridať ešte aspoň jednu vec.	You said it would make you happy to have added even one thing to a world now headed for total subtraction.	0.289655
Cestička pozdĺž diaľnice viedla popod most.	The walking path next to the highway passed under a bridge.	0.215385
Chladnú tmu pod ním obývala lavička otočená k prázdnemu priestoru zaplnenému rozbitým sklom z fliaš, ktoré ľudia len tak vyhodili.	In the cool dark beneath was a bench facing onto empty lot full of broken glass from bottles that people had thrown just because.	0.285981
Keď slnečné svetlo dopadlo na rozbité kúsky, zem sa rozsvietila ako luster a hrala farbami.	When sunlight hit the broken pieces, the ground lit up like a reverse chandelier, a glittering patch of green and white.	0.399038
Ubúdalo ich však zakaždým, keď som tade prechádzala.	Now there was less each time I walked by.	0.194118
Teraz už chýbala aj lavička.	Also, no bench.	0.0642857
Stála som otočená ku sklu a jedla svoje posledné jablko.	I stood there facing the glass, eating my last apple.	0.28
Boli chvíle, keď som si myslela, že by som s tebou mohla byť tak dlho, až by sa to dalo zaokrúhliť na celý život.	There had been times when I thought I might be with you indefinitely, something approaching an entire life.	0.3
No keď sa čas náhle ohraničil a my sme tú hranicu boli zrazu schopní uvidieť, prestala som si byť taká istá.	But then when there was only a finite amount of time, a thing we could see the limit of, I wasn't so sure.	0.422246
Nevedela som, ako naložiť s jednotkou času, ktorá sa zdala dlhšia, než doba šachovej partie alebo filmu, ale oveľa kratšia, než sme si predstavovali.	I didn't know how to use a unit of time like this, too long for a game of chess or a movie but so much shorter than we had imagined.	0.233654
Pripomínalo mi to jeden z tých dní, keď sme sa prebudili príliš neskoro na raňajky a ležali v posteli, až bolo príliš neskoro aj na obed.	It felt like one of those days when we woke up too late for breakfast and lay in bed until it was too late for lunch.	0.235484
Bývala som vtedy nervózna.	Those days made me nervous.	0.3
Zvykli sme sa hádať, ako využiť náš čas.	On those days we fought about how to use our time.	0.238235
Nechcel si žiť svoj život pod tlakom, akoby nám došiel čas a nastali posledné dni.	You didn't want to live your life under pressure, as though we'd run out, as though it were the last days.	0.221739
Povedal si, že nie si chorý.	I'm not ill, you said.	0.221053
Existujú dva typy ľudí a jeden z nich sa vzdá prvý.	There are two kinds of people, and one of them will give up first.	0.214286
··· Keď sme sa hádali, tak si sa nad situáciu dokázal povzniesť prvý.	··· When we fought, you got over it first.	0.402857
Z kuchyne som sa na teba zvykla dívať cez obdĺžnikový priestor v stene, sledovala som, ako si študoval noviny a skláňal hlavu nad fotografiami, z ktorých si lúštil detaily.	I'd watch you from the kitchen, through a rectangular space cut into the wall I could see you studying the newspaper, ducking your head down to read small details in the photographs.	0.385517
Pozorovala som, ako si sa vždy nenútene vrátil k článku, ktorý si predtým čítal.	I saw how gracefully you fell back into whatever article you had been reading before.	0.282353
Už vtedy som vedela, že rana, ktorú by som ti svojím odchodom spôsobila, by sa rýchlo scelila ako diera ponorená do náhliacej sa vody.	Even then I knew: whatever hollow I made in you if I left would heal up like a hole sunk into water, quick as water rushing to fill some passing wound.	0.273214
Od móla som bola ďaleko, ale stále som počula, ako sa čajky doťahujú o zvyšky a kruto pri tom škriekajú.	This far from the pier I could still hear the seagulls fighting over scraps, crying out with their harsh voices.	0.272093
V dnešných dňoch sa zvuk prenášal do väčšej vzdialenosti, pretínal tenký vzduch ako kameň, ktorý ste z celej sily hodili do mora.	Sounds carried farther these days, tearing through the thin air like a stone thrown as hard as you can toward the sea.	0.266327
Ohryzok jablka mi navlhčil pravú rukavicu, zatiaľ čo druhou rukou som si stískala koreň nosa.	The bitten-down apple core wet my right-hand glove, while with the other hand I pressed on the bridge of my nose.	0.2475
Existujú dva typy ľudí: jeden bude plakať iba vtedy, ak jestvuje šanca, nech sa už zdá akokoľvek nepatrná, že ho niekto začuje.	There are two kinds of people: one will only weep when the possibility exists, however remote, that someone will hear them.	0.291346
Ohryzok som položila na zem a zadívala som sa naň.	I put the core of the apple down on the ground and looked at it.	0.235714
Puf, povedala som.	Poof, I said.	0.175
Čakala som, že sa niečo stane.	I waited for something to happen.	0.265385
