Dôvodom, prečo ešte stále existujú je, že žraloky najlepšie vedia ako byť žralokmi.	And the reason there are still sharks around is that sharks are better at being sharks than anything else is.	0.220833
Fyzické knihy sú tvrdé, ťažko zničiteľné, vhodné do kúpeľa, aj na slnko a je príjemné ich držať v ruke.	Physical books are tough, hard to destroy, bathresistant, solar-operated, feel good in your hand: they are good at being books, and there will always be a place for them.	0.251163
Vedia, ako byť knihami a vždy budú mať svoje opodstatnenie. Sú súčasťou knižníc tak, ako sú knižnice miestom pre e-knihy, audioknihy, DVD nosiče a web.	They belong in libraries, just as libraries have already become places you can go to get access to ebooks, and audiobooks and DVDs and web content.	0.287805
Knižnica je úložiskom informácií a každému obyvateľovi ponúka rovnaký prístup.	A library is a place that is a repository of information and gives every citizen equal access to it.	0.517013
Je miestom pre spoločnosť.	It’s a community space.	0.257143
Je to bezpečné miesto, útočisko pred svetom.	It’s a place of safety, a haven from the world.	0.3
Má knihovníkov.	It’s a place with librarians in it.	0
Už teraz by sme mali mať predstavu, ako budú vyzerať knižnice v budúcnosti.	What the libraries of the future will be like is something we should be imagining now.	0.2625
V dnešnom svete správ, emailov a písaných informácií je gramotnosť dôležitejšia než kedykoľvek predtým.	Literacy is more important than ever it was, in this world of text and email, a world of written information.	0.5
Potrebujeme čítať a písať, potrebujeme ľudí, ktorí dokážu dobre čítať, chápu prečítané, chápu zmysel a aj oni sú pochopení.	We need to read and write, we need global citizens who can read comfortably, comprehend what they are reading, understand nuance, and make themselves understood.	0.209434
Knižnice sú naozaj bránami do budúcnosti.	Libraries really are the gates to the future.	0.283784
Preto je smutné, že po celom svete sa prizeráme tomu, ako ich orgány miestnej správy zatvárajú, len aby ušetrili peniaze. ~~~ Neuvedomujú si, že okrádajú budúcnosť, aby zaplatili za dnešok.	So it is unfortunate that, round the world, we observe local authorities seizing the opportunity to close libraries as an easy way to save money, without realising that they are stealing from the future to pay for today.	-0.0225
Zatvárajú brány, ktoré by mali zostať otvorené.	They are closing the gates that should be open.	0.285
Podľa nedávneho výskumu Organizácie pre hospodársku spoluprácu a rozvoj je Anglicko jedinou krajinou, v ktorej má najstaršia veková skupina väčšiu znalosť v literárnej a numerickej gramotnosti ako najmladšia skupina, hneď po ostatných faktoroch akými sú pohlavie, sociálno-ekonomické pozadie a typ povolania.	According to a recent study by the Organisation for Economic Cooperation and Development, England is the only country where the oldest age group has higher proficiency in both literacy and numeracy than the youngest group, after other factors, such as gender, socio-economic backgrounds and type of occupations are taken into account”.	0.352469
Zjednodušene: naše deti a vnúčatá sú menej gramotné a menej zdatné v počtoch ako my.	Or to put it another way, our children and our grandchildren are less literate and less numerate than we are.	0.215493
Sú menej schopné riadiť svet a rozumieť mu pri riešení problémov.	They are less able to navigate the world, to understand it to solve problems.	0.251786
Dajú sa ľahšie oklamať, či pomýliť a budú menej schopné zmeniť svet, v ktorom sa nachádzajú.	They can be more easily lied to and misled, will be less able to change the world in which they find themselves, be less employable.	0.180769
Horšie sa zamestnajú.	All of these things.	0.266667
Anglicko ako krajina bude zaostávať za ostatnými rozvinutými národmi, pretože jej bude chýbať skúsená pracovná sila.	And as a country, England will fall behind other developed nations because it will lack a skilled workforce.	0.267391
Knihy sú nástrojom komunikácie s tými, ktorí nás predišli.	Books are the way that we communicate with the dead.	0.252273
Spôsobom, akým sa učíme od tých, ktorí už nie sú medzi nami; spôsobom, ktorý si ľudstvo postavilo sám na sebe, posúvalo ho dopredu. ~~~ Vedomosť sa stala skôr doplnkovou namiesto toho, aby sme sa ju museli učiť znovu a znovu.	The way that we learn lessons from those who are no longer with us, that humanity has built on itself, progressed, made knowledge incremental rather than something that has to be relearned, over and over.	-0.0131579
Existujú príbehy staršie ako väčšina krajín. ~~~ Príbehy, ktoré dávno prežili kultúry a budovy, v ktorých boli prvýkrát vypovedané.	There are tales that are older than most countries, tales that have long outlasted the cultures and the buildings in which they were first told.	-0.0106195
Voči budúcnosti máme podľa mňa určité povinnosti.	I think we have responsibilities to the future.	0.278049
Povinnosti a záväzky voči deťom a dospelým, ktorými raz tieto deti budú, voči svetu, v ktorom budú bývať.	Responsibilities and obligations to children, to the adults those children will become, to the world they will find themselves inhabiting.	0.195506
Každý z nás - čitateľ, spisovateľ a obyvateľ - má záväzky.	All of us - as readers, as writers, as citizens - have obligations.	0.757143
Rozhodol som sa, že vám o niektorých záväzkoch poviem viac.	I thought I’d try and spell out some of these obligations here.	0.288235
Verím, že máme čítať pre potešenie v súkromí i na verejných miestach.	I believe we have an obligation to read for pleasure, in private and in public places.	0.233898
Mali by sme podporovať knižnice.	We have an obligation to support libraries.	0.206897
Navštevovať ich, povzbudzovať iných k ich návšteve, protestovať proti ich zatváraniu.	To use libraries, to encourage others to use libraries, to protest the closure of libraries.	0.288158
Ak si nevážime knižnice, potom si nevážime ani informáciu, kultúru či múdrosť.	If you do not value libraries then you do not value information or culture or wisdom.	0.286765
Utlmujeme hlasy minulosti a poškodzujeme budúcnosť.	You are silencing the voices of the past and you are damaging the future.	0.210638
Mali by sme našim deťom čítať nahlas.	We have an obligation to read aloud to our children.	0.1875
Napodobňovať hlasy, spestrovať príbeh a neprestať im čítať len preto, že sa naučia čítať samy.	To do the voices, to make it interesting, and not to stop reading to them just because they learn to read to themselves.	0.233333
Využime tento čas na zbližovanie sa, na čas, keď nekontrolujeme telefóny, keď je rozptýlenie sveta odsunuté na druhú koľaj.	Use reading-aloud time as bonding time, as time when no phones are being checked, when the distractions of the world are put aside.	0.288679
Máme používať jazyk.	We have an obligation to use the language.	0.0315789
Prekonávať sa, zistiť, čo znamenajú slová, ako ich rozvinúť, ako jednoznačne komunikovať a povedať, čo si myslíme.	To push ourselves: to find out what words mean and how to deploy them, to communicate clearly, to say what we mean.	0.287368
Nemôžeme sa pokúšať zmraziť jazyk alebo predstierať, že je mŕtvy a musí byť uctievaný. ~~~ Mali by sme ho používať ako živý organizmus, ktorý prúdi, požičiava si slová, dovoľuje, aby sa významy a výslovnosť menili spolu s časom.	We must not to attempt to freeze language, or to pretend it is a dead thing that must be revered, but we should use it as a living thing, that flows, that borrows words, that allows meanings and pronunciations to change with time.	0.0609127
My ako autori - hlavne autori detských kníh, ale aj ostatní - máme povinnosť voči našim čitateľom. ~~~ Je to povinnosť písať pravdivé veci, ktorá je dôležitá najmä vtedy, keď vytvárame príbehy ľudí, ktorí neexistujú, na miestach, na ktorých čitatelia nikdy neboli, aby porozumeli, že pravda nie je o tom, čo sa stane, ale v tom, čo nám hovorí, o tom, kým sme.	We writers - and especially writers for children, but all writers - have an obligation to our readers: it’s the obligation to write true things, especially important when we are creating tales of people who do not exist in places that never were - to understand that truth is not in what happens but what it tells us about who we are.	0.0200175
Fikcia je vlastne klamstvo, ktoré hovorí pravdu.	Fiction is the lie that tells the truth, after all.	0.3
Nemali by sme nudiť našich čitateľov, ale donútiť ich otáčať strany.	We have an obligation not to bore our readers, but to make them need to turn the pages.	0.238983
Jedným z najlepších liekov na nepoddajného čitateľa je predsa príbeh, ktorý nemôže prestať čítať.	One of the best cures for a reluctant reader, after all, is a tale they cannot stop themselves from reading.	0.282353
Aj keď musíme našim čitateľom hovoriť pravdivé veci, dávať im zbrane a brnenie, posunúť im akúkoľvek múdrosť, ktorú sme sa naučili počas nášho krátkeho pobytu na tomto zelenom svete, nemali by sme im kázať, poučovať ich a tlačiť im dole krkom predžuté mravy a odkazy, ako keď vtáky kŕmia svoje mláďatá predžutými červami. ~~~ Nikdy by sme nemali písať pre deti niečo, čo by sme ani my nechceli čítať.	And while we must tell our readers true things and give them weapons and give them armour and pass on whatever wisdom we have gleaned from our short stay on this green world, we have an obligation not to preach, not to lecture, not to force predigested morals and messages down our readers’ throats like adult birds feeding their babies pre- masticated maggots; and we have an obligation never, ever, under any circumstances, to write anything for children that we would not want to read ourselves.	-0.0370482
Usilujme sa porozumieť a uznať, že ako autori robíme dôležitú prácu, pretože ak ju pokazíme a napíšeme pre deti nudné knihy, ktoré ich odvrátia od čítania a kníh, tak sme poškodili našu budúcnosť a oslabili tú ich.	We have an obligation to understand and to acknowledge that as writers for children we are doing important work, because if we mess it up and write dull books that turn children away from reading and from books, we ‘ve lessened our own future and diminished theirs.	0.231285
Je ľahké predstierať, že nikto nemôže nič zmeniť, že žijeme vo svete, v ktorom je spoločnosť obrovská a jednotlivec je menej ako nič: atóm v stene, zrnko ryže na ryžovej plantáži.	It is easy to pretend that nobody can change anything, that we are in a world in which society is huge and the individual is less than nothing: an atom in a wall, a grain of rice in a rice field.	0.38175
Pravdou je, že jednotlivci neustále menia svoj svet, vytvárajú budúcnosť tým, že si predstavujú veci, ktoré môžu byť odlišné.	But the truth is, individuals change their world over and over, individuals make the future, and they do it by imagining that things can be different.	0.25
Pozrite sa okolo seba.	Look around you: I mean it.	0.255
Myslím to vážne.		-0.3
Na chvíľu sa zastavte a pozrite sa po miestnosti, v ktorej sa nachádzate.	Pause, for a moment and look around the room that you are in.	0.442286
Ukážem vám niečo také očividné, na čo sa zvykne zabúdať.	I’m going to point out something so obvious that it tends to be forgotten.	0.2125
A síce: všetko, čo vidíte okolo seba, vrátane stien, bolo niekedy tiež len predstavou.	It’s this: that everything you can see, including the walls, was, at some point, imagined.	0.287838
Niekto sa rozhodol, že je jednoduchšie sedieť na stoličke ako na zemi a predstavil si stoličku.	Someone decided it was easier to sit on a chair than on the ground and imagined the chair.	0.448092
Niekto si musel predstaviť spôsob, akým sa s vami môžem práve teraz v Londýne rozprávať bez toho, aby na nás pršalo.	Someone had to imagine a way that I could talk to you in London right now without us all getting rained on.	0.265517
Táto miestnosť, veci v nej a všetky ostatné veci v tejto budove, v tomto meste existujú preto, že ľudia si znovu a stále dookola predstavovali veci.	This room and the things in it, and all the other things in this building, this city, exist because, over and over and over, people imagined things.	0.297561
Našou povinnosťou je spraviť veci krajšími.	We have an obligation to make things beautiful.	0.284615
Nenechať svet škaredší ako sme ho našli my, nevyprázdniť oceány, nenechať naše problémy budúcej generácii.	Not to leave the world uglier than we found it, not to empty the oceans, not to leave our problems for the next generation.	0.274194
Upratať si po sebe a nezanechať deťom svet, ktorý sme krátkozrako zničili, podviedli a zmrzačili.	We have an obligation to clean up after ourselves, and not leave our children with a world we’ve shortsightedly messed up, shortchanged, and crippled.	0.330357
Mali by sme povedať našim politikom, čo chceme. ~~~ Nevoliť politikov z hociktorej strany, ktorí nerozumejú úlohe čítania pri formovaní užitočných obyvateľov a nechcú uchovať a ochrániť vedomosť, či podporovať gramotnosť.	We have an obligation to tell our politicians what we want, to vote against politicians of whatever party who do not understand the value of reading in creating worthwhile citizens, who do not want to act to preserve and protect knowledge and encourage literacy.	-0.0227749
Toto nie je záležitosťou straníckej politiky.	This is not a matter of party politics.	0.227273
Je to záležitosťou bežného ľudstva.	This is a matter of common humanity.	0.290323
Alberta Einsteina sa raz opýtali, ako by mohli byť naše deti inteligentnými.	Albert Einstein was asked once how we could make our children intelligent.	0.290625
Jeho odpoveď bola jednoduchá aj múdra.	His reply was both simple and wise.	0.26
Ak chcete mať múdre deti, čítajte im rozprávky.	If you want your children to be intelligent,” he said, read them fairy tales.	0.12439
Ak chcete mať ešte múdrejšie deti, čítajte im viac rozprávok.	If you want them to be more intelligent, read them more fairy tales.”	0.271698
Rozumel hodnote čítania a predstavivosti.	He understood the value of reading, and of imagining.	0.236842
Verím, že našim deťom môžeme dať svet, v ktorom budú čítať a budú čítaní, v ktorom si budú predstavovať a ktorému budú rozumieť.	I hope we can give our children a world in which they will read, and be read to, and imagine, and understand.	0.369761
Prvá kapitola	Chapter One	0.245455
Pozvánka do Výšin	Invitation to the High Places	0.1125
Jej priatelia a spolupracovníci Zmilovanie a Mier s ňou žili v malej bielej pokojnej chalúpke v dedine Veľké Chvenie.	She lived with her friends and fellow workers Mercy and Peace in a tranquil little white cottage in the village of Much-Trembling.	0.42
Svoju prácu milovala a uprene túžila potešiť najvyššieho Pastiera. ~~~ Bola zväčša šťastná, avšak bola si vedomá viacerých vecí, ktoré jej prekážali v práci a tajne jej spôsobovali veľké utrpenie a hanbu.	She loved her work and desired intensely to please the Chief Shepherd, but happy as she was in most ways, she was conscious of several things which hindered her in her work and caused her much secret distress and shame.	-0.00693642
V prvom rade bola mrzáčka. Nohy mala také krivé, že popri práci často krívala či zakopla.	In the first place she was a cripple, with feet so crooked that they often caused her to limp and stumble as she went about her work.	0.168
Ďalšou veľmi nepeknou chybou boli jej krivé ústa, ktoré značne znetvorili oboje – jej výraz tváre aj reč. ~~~ Bohužiaľ, bola si vedomá, že tieto ohavné kazy musia vzbudzovať údiv a pohoršenie mnohých, ktorí vedeli, že je v službách najvyššieho Pastiera.	She had also the very unsightly blemish of a crooked mouth which greatly disfigured both expression and speech and was sadly conscious that these ugly blemishes must be a cause of astonishment and offense to many who knew that she was in the service of the great Shepherd.	-0.00915493
Najviac si želela, aby sa zbavila týchto nedokonalostí a bola krásnou, vľúdnou a silnou tak, ako bolo veľa iných Pastierových pracovníkov, a predovšetkým, chcela byť taká ako bol sám najvyšší Pastier.	Most earnestly she longed to be completely delivered from these shortcomings and to be made beautiful, gracious, and strong as were so many of the Shepherd's other workers, and above all to be made like the Chief Shepherd himself.	0.261404
Obávala sa ale, že z týchto dvoch ochromujúcich znetvorení nemôže byť žiadne vyslobodenie a musia aj naďalej stále ničiť jej prácu.	But she feared that there could be no deliverance from these two crippling disfigurements and that they must continue to mar her service always.	0.273214
V jej živote bol však aj ďalší a ešte väčší problém.	There was, however, another and even greater trouble in her life.	0.209302
Bola súčasťou rodiny Obáv a jej príbuzní boli rozptýlení po celom údolí, takže od nich nemohla nikdy naozaj utiecť.	She was a member of the Family of Fearings, and her relatives were scattered all over the valley, so that she could never really escape from them.	0.379592
Bola sirotou, a preto vyrastala v dome jej tety, úbohej pani Žalostnej Predtuchy, spolu so svojimi dvoma sesternicami Skľúčenosťou a Zlomyseľnosťou a ich bratom Zbabelým Strachom, veľkým násilníkom, ktorý ju zvyčajne veľmi trápil a hrozným spôsobom obťažoval.	An orphan, she had been brought up in the home of her aunt, poor Mrs. Dismal Forebodings, with her two cousins Gloomy and Spiteful and their brother Craven Fear, a great bully who habitually tormented and persecuted her in a really dreadful way.	0.428483
Rovnako ako väčšina ostatných rodín, ktoré žili v Údolí poníženia, všetci z rodu Obáv nenávideli najvyššieho Pastiera. ~~~ Snažili sa bojkotovať jeho služobníkov a samozrejme bolo veľkou urážkou, že niekto z ich vlastnej rodiny mal vstúpiť do jeho služieb.	Like most of the other families who lived in the Valley of Humiliation, all the Fearings hated the Chief Shepherd and tried to boycott his servants, and naturally it was a great offense to them that one of their own family should have entered his service.	-0.0049763
Robili preto všetko, čo mohli, aby ju z jeho služieb dostali – vyhrážky aj presviedčania. ~~~ Jedného desivého dňa pred ňu položili rodinné vyhlásenie, že sa musí okamžite vziať so svojím bratrancom Zbabelým Strachom a slušne sa usadiť medzi svojimi ľuďmi.	Consequently they did all they could both by threats and persuasions to get her out of his employment, and one dreadful day they laid before her the family dictum that she must immediately marry her cousin Craven Fear and settle down respectably among her own people.	-0.00486111
Ak by to odmietla urobiť zo slobodnej vôle, vyhrážali sa, že použijú násilie a donútia ju.	If she refused to do this of her own free will, they threatened to use force and compel her.	0.472471
Úbohej Bojazlivosti sa zmocnilo zdesenie nad týmto nápadom. ~~~ Jej príbuzní ju ale vždy desili a nikdy sa nenaučila odolávať im alebo ignorovať ich vyhrážky. ~~~ Preto pred nimi len skrčene sedela a znova a znova dokola opakovala, že nič by ju nepresvedčilo vydať sa za Zbabelý Strach. ~~~ Nebola ale schopná utiecť ich prítomnosti.	Poor Much-Afraid was, of course, overwhelmed with horror at the mere idea, but her relatives always terrified her, and she had never learned to resist or ignore their threats, so she simply sat cowering before them, repeating again and again that nothing would induce her to marry Craven Fear, but she was quite unable to escape from their presence.	-0.194022
Tento nešťastný rozhovor trval nekonečne dlho a keď ju končene na chvíľu nechali, pod už podvečer.	The unhappy interview therefore lasted a long time, and when finally they did leave her for a while, it was already early evening.	0.387185
S návalom úľavy si Bojazlivosť spomenula, že najvyšší Pastier bude práve viezť svoje stáda ku ich obvyklému napájadlu vedľa krásnych kaskád a jazierka na okraji dediny.	With a surge of relief, Much-Afraid remembered that the Chief Shepherd would then be leading his flocks to their accustomed watering place beside a lovely cascade and pool on the outskirts of the village.	0.352778
Mala vo zvyku chodiť na toto miesto každé ráno aby ho stretla a dozvedela sa jeho priania a rozkazy na nasledujúci deň a potom opäť každý večer aby jej podal správu o dennej práci.	To this place she was in the habit of going very early every morning to meet him and learn his wishes and commands for the day, and again in the evenings to give her report on the day's work.	0.287838
Práve teraz bol čas, aby sa s ním stretla vedľa jazierka. ~~~ Bola si istá, že jej pomôže a nedovolí jej príbuzným aby ju uniesli a prinútili aby odišla z jeho služieb kvôli strašnému otroctvu v manželstve so Zbabelým Strachom.	It was now time to meet him there beside the pool, and she felt sure he would help her and not permit her relatives to kidnap her and force her to leave his service for the dreadful slavery of marriage with Craven Fear.	-0.00842697
Bojazlivosť zavrela dvere chalúpky a vybrala sa ku kaskáde a jazierku. ~~~ Stále sa triasla strachom a nezastavila ani aby si utrela slzy z tváre.	Still shaking with fear and without pausing to wash the tears from her face, Much-Afraid shut the door of the cottage and started off for the cascade and the pool.	-0.0159836
Tiché večerné svetlo zalievalo Údolie poníženia zlatou žiarou práve keď odchádzala z dediny a prechádzala cez polia.	The quiet evening light was filling the Valley of Humiliation with a golden glow as she left the village and started to cross the fields.	0.428053
Hory na druhej strane rieky, ktoré ohraničovali východnú stranu Údolia ako týčiace sa hradby, už boli zafarbené na ružovo a ich hlboké rokliny boli plné krásnych a tajomných tieňov.	Beyond the river, the mountains which bounded the eastern side of the Valley like towering ramparts were already tinged with pink, and their deep gorges were filled with lovely and mysterious shadows.	0.268831
V tento tichý a pokojný večer prišla úbohá vystrašená Bojazlivosť ku jazierku. ~~~ Tam už na ňu čakal Pastier aby mu rozpovedala o svojej hroznej situácii.	Through the quiet and peace of this tranquil evening, poor, terrified Much-Afraid came to the pool where the Shepherd was waiting for her and told him of her dreadful plight.	-0.0184615
Čo mám robiť? rozplakala sa, keď ukončila svoje rozprávanie.	What shall I do? she cried as she ended the recital.	0.230233
Ako môžem utiecť?	How can I escape?	0.28
Nemôžu ma skutočne prinútiť vziať sa s mojím bratrancom Strachom, však?	They can't really force me to marry my cousin Craven, can they?	0.249057
Ach! plakala a znovu bola ochromená už pri pomyslení na takúto možnosť. ~~~ Je dosť strašné byť Bojazlivosť ale myslieť na to, že by som mala byť ženou Zbabelého Strachu do konca života a nikdy nebyť schopná utiecť z jeho trýznenia je viac ako znesiem.	Oh! cried she, overwhelmed again at the very thought of such a prospect, it is dreadful enough to be Much-Afraid, but to think of having to be Mrs. Craven Fear for the rest of my life and never able to escape from the torment of it is more than I can bear.	0.0439982
Neboj sa, povedal Pastier jemne.	Don't be afraid, said the Shepherd gently.	0.217241
Si v mojich službách a ak mi budeš dôverovať, nebudú ťa môcť prinútiť proti tvojej vôli do nijakého rodinného spojenectva.	You are in my service, and if you will trust me they will not be able to force you against your will into any family alliance.	0.294118
Ale nikdy by si nemala do svojej chalúpky pustiť svojich príbuzných z rodiny Obáv, pretože sú nepriateľmi Kráľa, ktorý ťa vzal do svojich služieb.	But you ought never to have let your Fearing relatives into your cottage, because they are enemies of the King who has taken you into his employment.	0.3
Sú všade a teraz, keď si zaumienili sa ma znova zmocniť, sa už neodvážim ísť sama mimo svojej chalupy zo strachu, že by ma niekto uniesol.	They are everywhere and now that they are determined to get me into their power again I shall never dare venture outside my cottage alone for fear of being kidnapped.	0.236842
Keď rozprávala, zdvihla oči a hľadela cez Údolie a rieku na nádherné vrcholy hôr, na ktoré žiarilo zapadajúce slnko, a potom v zúfalej túžbe zvolala: Ach, keby som tak mohla z tohto Údolia poníženia utiecť a ísť do Výšin, úplne mimo dosahu všetkých Obáv a mojich ďalších príbuzných!	As she spoke she lifted her eyes and looked across the Valley and the river to the lovely sunset-lighted peaks of the mountains, then cried out in desperate longing, Oh, if only I could escape from this Valley of Humiliation altogether and go to the High Places, completely out of reach of all the Fearings and my other relatives!	0.252966
Sotva tieto slová vyriekla, keď na jej počudovanie jej Pastier odpovedal: Dlho som čakal, aby som počul tento návrh, Bojazlivosť.	No sooner were these words uttered when to her complete astonishment the Shepherd answered, I have waited a long time to hear you make that suggestion, Much- Afraid.	0.224324
Určite by bolo pre teba najlepšie opustiť Údolie poníženia a odísť do Výšin a ja ťa tam veľmi rád sám zavediem.	It would indeed be best for you to leave the Valley for the High Places, and I will very willingly take you there myself.	0.277174
Dolné svahy tých hôr na druhej strane rieky sú pohraničím Ríše lásky, čo je kráľovstvo môjho Otca.	The lower slopes of those mountains on the other side of the river are the borderland of my Father's Kingdom, the Realm of Love.	0.216867
Žiadne Obavy by tam neprežili, pretože dokonalá láska vyháňa strach a všetko čo nás trápi.	No Fears of any kind are able to live there because 'perfect love casteth out fear and everything that torments. '	0.22987
Bojazlivosť naňho s úžasom hľadela.	Much-Afraid stared at him in amazement.	0.271875
Ísť do Výšin, zvolala, a žiť tam?	Go to the High Places, she exclaimed, and live there?	0.117857
Ach, kiežby som mohla!	Oh, if only I could!	0.247059
Po tom túžim celé mesiace.	For months past the longing has never left me.	0.0913043
Myslím na to vo dne v noci, ale je to nemožné.	I think of it day and night, but it is not possible.	0.259459
Nikdy by som sa tam nemohla dostať, som príliš chromá.	I could never get there, I am too lame.	0.16875
Pozrela sa na svoje znetvorené nohy počas toho ako hovorila a oči jej opäť zaliali slzy zúfalstva a sebaľútosti.	She looked down at her malformed feet as she spoke, and her eyes again filled with tears and despair and self-pity.	0.296842
Tie hory sú ale strmé a nebezpečné.	These mountains are so steep and dangerous.	0.22
Vždy mi vraveli, že sa po nich dokážu bezpečne pohybovať iba lane a jelene.	I have been told that only the hinds and the deer can move on them safely.	0.285
Je pravda, že cesta do Výšin je náročná a nebezpečná, povedal Pastier.	It is quite true that the way up to the High Places is both difficult and dangerous, said the Shepherd.	0.175
Musí to tak byť, aby sa tam nedostalo nič, čo je nepriateľom lásky a nevtrhlo do Kráľovstva.	It has to be, so that nothing which is an enemy of Love can make the ascent and invade the Kingdom.	0.454978
Nesmie tam byť nič čo je chybné alebo nejakým spôsobom nedokonalé a obyvatelia Výšin naozaj potrebujú mať nohy ako jelenica.	Nothing blemished or in any way imperfect is allowed there, and the inhabitants of the High Places do need 'hinds' feet'.	0.288235
Aj ja sám ich mám, poznamenal s úsmevom, a ako mladý jeleň alebo srnec môžem s ohromnou ľahkosťou a potešením skákať po horách a hopsať po kopcoch.	I have them myself, he added with a smile, and like a young hart or a roebuck I can go leaping on the mountains and skipping on the hills with the greatest ease and pleasure.	0.574707
Avšak, Bojazlivosť, môžem aj tvoje nohy urobiť ako nohy jeleníc a dať ti kráčať vo výšinách.	But, Much-Afraid, I could make yours like hinds' feet also, and set you upon the High Places.	0.3
Potom by si mi mohla slúžiť oveľa lepšie a byť mimo dosahu všetkých svojich nepriateľov.	You could serve me then much more fully and be out of reach of all your enemies.	0.253846
Rád počujem, že sa tam túžiš dostať, a ako som už povedal, čakal som kým to navrhneš.	I am delighted to hear that you have been longing to go there, for, as I said before, I have been waiting for you to make that suggestion.	0.286667
Potom by si už nikdy viac nemusela stretnúť Zbabelý Strach, poznamenal s ďalším úsmevom.	Then, he added, with another smile, you would never have to meet Craven Fear again.	0.274286
Bojazlivosť na neho zmätene hľadela.	Much-Afraid stared at him in bewilderment.	0.254545
Urobiť moje nohy ako nohy jelenice, opakovala, Ako je to možné?	Make my feet like hinds' feet, she repeated, How is that possible?	0.288889
A čo by povedali obyvatelia Kráľovstva lásky na prítomnosť úbohej mrzáčky so škaredou tvárou a skrútenými ústami, ak tam nemôže žiť nič chybné a nedokonalé?	And what would the inhabitants of the Kingdom of Love say to the presence of a wretched little cripple with an ugly face and a twisted mouth, if nothing blemished and imperfect may dwell there?	0.469867
Je pravda, povedal Pastier, že by si sa musela zmeniť predtým, ako by si mohla žiť vo Výšinách. ~~~ Ak si však ochotná ísť so mnou, sľubujem ti, že ti pomôžem získať nohy ako jelenica.	It is true, said the Shepherd, that you would have to be changed before you could live on the High Places, but if you are willing to go with me, I promise to help you develop hinds' feet.	-0.001
Na vrchole hôr, keď sa priblížiš k skutočným Výšinám, je vzduch čerstvý a povzbudzujúci.	Up there on the mountains, as you get near the real High Places, the air is fresh and invigorating.	0.276316
Posilňuje celé telo a sú tam pramene s úžasnými liečivými vlastnosťami, takže tým, ktorí sa v nich vykúpu, zmiznú všetky chyby a znetvorenia. ~~~ Ale musím ti povedať ešte jednu vec.	It strengthens the whole body and there are streams with wonderful healing properties, so that those who bathe in them find all their blemishes and disfigurements washed away, But there is another thing I must tell you.	-0.0315789
Nielenže by som musel urobiť tvoje nohy ako nohy jelenice, ale musela by si dostať aj iné meno, pretože je nemožné aby Bojazlivosť alebo hocikto iný z rodu Obáv, vstúpil do Kráľovstva lásky.	Not only would I have to make your feet like hinds' feet, but you would have to receive another name, for it would be as impossible for a Much-Afraid to enter the Kingdom of Love as for any other member of the Fearing family.	0.254717
Si teda ochotná, Bojazlivosť, úplne sa zmeniť a stať sa takou, aké bude tvoje meno, ktoré prijmeš ak sa staneš obyvateľkou Kráľovstva lásky?	Are you willing to be changed completely, Much-Afraid, and to be made like the new name which you will receive if you become a citizen in the Kingdom of Love?	0.397269
Prikývla hlavou a potom veľmi vážne povedala: Áno, som.	She nodded her head and then said very earnestly, Yes, I am.	0.2875
Znova sa usmial, ale vážne dodal: Je tu ešte jedna vec, najdôležitejšia zo všetkých. ~~~ Nikto nesmie žiť v Kráľovstve lásky, pokiaľ mu v srdci ešte nekvitne kvet Lásky.	Again he smiled, but added gravely, There is still one thing more, the most important of all No one is allowed to dwell in the Kingdom of Love, unless they have the flower of Love already blooming in their hearts.	-0.0361702
Bola Láska zasiata do tvojho srdca, Bojazlivosť?	Has Love been planted in your heart, Much- Afraid?	0.3
Ako to Pastier povedal, uprene na ňu hľadel a ona si uvedomila, že jeho oči pátrajú do hĺbky jej srdca a všetko, čo tam bolo, vedeli lepšie ako ona sama.	As the Shepherd said this he looked at her very steadily and she realized that his eyes were searching into the very depths of her heart and knew all that was there far better than she did herself.	0.2136
Dlho neodpovedala, pretože si nebola istá, čo má povedať, ale vyhýbavo sa pozrela do očí, ktoré na ňu tak prenikavo hľadeli, a uvedomila si, že majú moc odrážať to, na čo sa pozerajú.	She did not answer for a long time, because she was not sure what to say, but she looked rather flinchingly into the eyes which were gazing at her so penetratingly and became aware that they had the power of reflecting what they looked upon.	0.297446
Mohla teda skutočne vidieť svoje srdce tak, ako ho videl on a po dlhšej pauze odpovedala: Myslím si, že to, čo tam rastie, je veľká túžba zažiť radosť z bezprostrednej, ľudskej lásky a naučiť sa nanajvýš milovať jednu osobu, ktorá ma na oplátku bude milovať tiež.	She could thus really see her own heart as he saw it, so after a long pause she answered, I think that what is growing there is a great longing to experience the joy of natural, human love and to learn to love supremely one person who will love me in return.	0.411794
Ale možno táto túžba, tak prirodzená a správna ako sa zdá, nie je Láska, o ktorej hovoríš?	But perhaps that desire, natural and right as it seems, is not the Love of which you are speaking?	0.276
Na chvíľu stíchla a potom úprimne a takmer trasúco dodala: Vidím, ako mi v srdci rastie túžba byť milovaná a obdivovaná, Pastier, ale nemyslím si, že vidím ten druh Lásky, o ktorej hovoríš ty, alebo aspoň nie ten druh lásky, ktorý vidím v tebe.	She paused and then added honestly and almost tremblingly, I see the longing to be loved and admired growing in my heart, Shepherd, but I don't think I see the kind of Love that you are talking about, at least, nothing like the love which I see in you.	0.295545
Dovolíš mi teda zasadiť semienko skutočnej Lásky teraz? spýtal sa Pastier.	Then will you let me plant the seed of true Love there now? asked the Shepherd.	0.3
Nejaký čas ti potrvá, kým nadobudneš nohy ako jelenica a dostaneš sa do Výšin, a ak ti teraz vložím semienko do srdca, bude pripravené kvitnúť práve keď sa tam dostaneš.	It will take you some time to develop hinds' feet and to climb to the High Places, and if I put the seed in your heart now it will be ready to bloom by the time you get there.	0.293478
Bojazlivosť sa odtiahla.	Much-Afraid shrank back.	0.3
Bojím sa, povedala.	I am afraid, she said.	0.283333
Povedali mi, že ak niekoho skutočne miluješ, dávaš tomu milovanému človeku moc ublížiť ti a zraniť ťa tak, ako to nedokáže nič iné.	I have been told that if you really love someone you give that loved one the power to hurt and pain you in a way nothing else can.	0.532692
To je pravda, súhlasil Pastier.	That is true, agreed the Shepherd.	0.278571
Milovať znamená podriadiť sa moci milovaného človeka a stať sa veľmi zraniteľným voči bolesti, a ty sa bolesti veľmi bojíš, však Bojazlivosť?	To love does mean to put yourself into the power of the loved one and to become very vulnerable to pain, and you are very Much- Afraid of pain, are you not?	0.287603
Skľúčene prikývla a potom zahanbene povedala: Áno, veľmi sa jej bojím.	She nodded miserably and then said shamefacedly, Yes, very much afraid of it.	0.27541
Ale je takým šťastím môcť milovať, povedal Pastier potichu.		-0.3
Je šťastím milovať, aj keď ty na oplátku nie si milovaná.	But it is so happy to love, said the Shepherd quietly.	0.28
Rozhodne to prináša aj bolesť, ale Láska nie je myslená tak značne.	It is happy to love even if you are not loved in return.	0.450769
Bojazlivosť si náhle uvedomila, že Pastier má tie najtrpezlivejšie oči, aké kedy videla.	There is pain too, certainly, but Love does not think that very significant.	0.244615
Zároveň v nich ale bolo niečo, čo ju ranilo pri srdci, hoci nevedela povedať prečo.	Much-Afraid thought suddenly that he had the most patient eyes she had ever seen.	0.295652
Aj tak sa stále od strachu uhýbala a povedala (vyriekla tieto slová veľmi rýchlo, pretože sa ich nejak hanbila povedať), Nikdy by som sa neodvážila milovať, pokiaľ by som si nebola istá, že budem tiež milovaná.	At the same time there was something in them that hurt her to the heart, though she could not have said why, but she still shrank back in fear and said (bringing the words out very quickly because somehow she was ashamed to say them), I would never dare to love unless I were sure of being loved in return.	0.177273
Ak ti dovolím zasiať semienko Lásky do môjho srdca, dáš mi sľub, že ma budeš tiež ľúbiť?	If I let you plant the seed of Love in my heart will you give me the promise that I shall be loved in return?	0.246575
Inak by som to nezniesla.	I couldn’t bear it otherwise.”	0.231818
Úsmev, ktorý na ňu vtedy obrátil, bol ten najjemnejší a najláskavejší, aký kedy videla, avšak znova, z rovnakého nevysvetliteľného dôvodu, jej zaťal do živého.	The smile he turned on her then was the gentlest and kindest she had ever seen, yet once again, and for the same indefinable reason as before, it cut her to the quick.	0.297794
Áno, povedal bez váhania: sľubujem ti, Bojazlivosť, že keď bude kvet Lásky v tvojom srdci pripravený kvitnúť a keď ty budeš pripravená zmeniť svoje meno, vtedy budeš tiež milovaná.	Yes, he said, without hesitation, l promise you, Much-Afraid, that when the plant of Love is ready to bloom in your heart and when you are ready to change your name, then you will be loved in return.	0.280392
Radosť ju rozochvela od hlavy až po päty.	A thrill of joy went through her from head to foot.	0.24
Znelo to príliš užasne aby sa tomu dalo vôbec veriť, avšak tento sľub jej dal sám Pastier a v jednej veci si bola celkom istá.	It seemed too wonderful to be believed, but the Shepherd himself was making the promise, and of one thing she was quite sure.	0.422087
On nemohol klamať.	He could not lie.	0.26
Prosím, zasaď do môjho srdca Lásku hneď teraz, povedala sotva badateľne.	Please plant Love in my heart now,'' she said faintly.	0.18913
Úbohá Bojazlivosť, bola stále bojazlivá, aj keď jej bola sľúbená tá najúžasnejšia vec na svete.	Poor little soul, she was still Much-Afraid even when promised the greatest thing in the world.	0.296296
Pastier vložil ruku do svojho lona, niečo vytiahol a položil to na dlaň.	The Shepherd put his hand in his bosom, drew something forth, and laid it in the palm of his hand.	0.206557
Potom natiahol ruku smerom k Bojazlivosti.	Then he held his hand out toward Much-Afraid.	0.292105
Tu je semienko Lásky, povedal.	Here is the seed of Love, he said.	0.288889
Predklonila sa, aby sa pozrela a potom vystrašene zaplakala a odtiahla sa.	She bent forward to look, then gave a startled little cry and drew back.	0.510769
