Byť či nebyť Shakespearom? Skeptikov ešte stále znepokojuje otázka autorstva Shakespearových hier, no nová výstava vzbudzuje pochybnosti aj o hodnovernosti jeho podobizní.	To Be or Not to Be Shakespeare While skeptics continue to question the authorship of his plays, a new exhibition raises doubts about the authenticity of his portraits.	0.278723
Autor: Doug Stewart Časopis Smithsonian September 2006	By Doug Stewart Smithsonian magazine September 2006	5.90543
Zrejme vám ani nenapadne navštíviť Britské múzeum alebo Britskú knižnicu bez toho, aby ste si nepozreli rukopisy Williama Shakespeara.	Even if you’re a regular visitor to London, it’s probably never occurred to you to stop in to see William Shakespeare’s original manuscripts at the British Museum or Library.	0.223077
Je to tak.	That’s just as well.	0
Nezachoval sa totižto jediný pôvodný rukopis.	There are no original manuscripts.	0.203226
Ba ani len dvojveršie, ktoré by napísal sám Shakespeare.	Not so much as a couplet written in Shakespeare’s own hand has been proven to exist.	0.171429
V skutočnosti neexistuje nijaký nezvratný dôkaz o tom, že by Will Shakespeare (1564- 1616) z mestečka Stratford upon Avon (Stratford nad Avonou), považovaný za najvýznamnejšieho spisovateľa anglickej literatúry, vedel napísať aspoň jednu vetu.	In fact, there’s no hard evidence that Will Shakespeare of Stratford-upon-Avon (1564-1616), revered as the greatest author in the English language, could even write a complete sentence.	0.416786
Niet sa vôbec čomu čudovať, veď svet zaplavili ostré výmeny názorov o autorstve 154 sonetov a 37 hier, ktoré sa pripisujú práve jemu.	Is it any wonder that controversy swirls around the authorship of the 154 sonnets and some 37 plays credited to him?	1.88997
Skeptici už dávno odmietajú predstavu, že by sa malomestský chlapec s nízkym vzdelaním presťahoval do Londýna, aby pracoval ako herec, a odrazu píše majstrovské diela tak očarujúce a dôkladne premyslené, že sa im zatiaľ žiadne iné nevyrovnalo.	Skeptics have long belittled the notion of a barely educated small-town boy who moves to London to work as an actor and is suddenly writing masterpieces of unrivaled beauty and sophistication.	0.310928
V roku 1903 Henry James napísal priateľovi, že má podozrenie, že božský William bol najväčší a najúspešnejší podvodník, aký sa kedy ponevieral po našom tolerantnom svete.	Henry James wrote to a friend in 1903 that he was haunted by the conviction that the divine William is the biggest and most successful fraud ever practised on a patient world.”	1.96667
Medzi pochybujúcimi boli aj mená Mark Twain, Walt Whitman, Sigmund Freud, Orson Welles a sir John Gielgud.	Other doubters have included Mark Twain, Walt Whitman, Sigmund Freud, Orson Welles and Sir John Gielgud.	2.06137
Diskusie o Shakespearovi nepramenia len z chýbajúcich písomností.	At heart, the Shakespeare debate is about more than missing records.	0.3
Podnetom je predovšetkým neutíchajúca potreba prehľadávať jeho verše s cieľom nájsť v nich ich skutočného autora, nech už ním bol ktokoľvek.	It’s driven by an unquenchable need to slip past Shakespeare’s verses and locate the real-life artist behind them, whoever he or she might be.	0.2975
Aj o Dantem či Chaucerovi vieme málo, no nerobíme si z toho ťažkú hlavu.	Little is known about Dante or Chaucer either, but somehow that isn’t as nettlesome.	0.24
Ak by sme si Shakespeara nepredstavovali ako nejakého boha, nikto by sa nenamáhal riešiť autorstvo jeho diel, tvrdí Jonathan Bate, odborník na Shakespeara z Warwickskej univerzity neďaleko Stratfordu.	If Shakespeare hadn’t been metamorphosed into a god, nobody would think it was worth having an authorship controversy about him,” says Jonathan Bate, a Shakespeare expert at the University of Warwick, not far from Stratford.	0.477586
Postavy ako Falstaff, Lear alebo Hamlet sa vyznačujú skutočnými a výrazne ľudskými charakteristickými vlastnosťami. Na druhej strane, ich autor akoby sám pripomínal neuchopiteľný a prchavý javiskový dym.	It’s certainly curious that the creator of such vivid, recognizably human characters as Falstaff, Lear and Hamlet should himself remain as insubstantial as stage smoke.	0.577878
Azda najpodrobnejší opis niekým, kto ho aj naozaj poznal, predstavuje nie veľmi výstižný výrok jeho priateľa a konkurenta, dramatika Bena Jonsona: Bol to skutočne poctivý muž, mal otvorenú a slobodymilovnú povahu.	The most detailed description of the man left to us by someone who actually knew him, it seems, is a less-than-incisive sentence from his friend and rival, the playwright Ben Jonson: He was, indeed, honest, and of an open and free nature.	0.464674
To nám ale veľa nenapovie.	That covers a lot of ground.	0.286957
Pokiaľ ide o Shakespearov zovňajšok, ani jeden z jeho súčasníkov sa neobťažoval s opisom.	As for Shakespeare’s appearance, none of his contemporaries bothered to describe it.	0.287838
Bol vysoký alebo nízky?	Tall or short?	0.115385
Štíhly alebo bucľatý?	Thin or chubby?	0.171429
Nikto nevie.	It’s anyone’s guess.	0.125
Pátranie po vizáži Williama Shakespeara, teda doslova túžba uvidieť jeho tvár sa stala skutočnosťou 17. septembra 2006 na výstave v Yalovom centre britského umenia v New Haven v americkom štáte Connecticut.	An exhibition about the visual side of this quest – the desire to see William Shakespeare’s face, literally – is on view through September 17 at the Yale Center for British Art in New Haven, Connecticut.	0.473299
Výstava pod názvom Pátranie po Shakespearovi predstavila popri vzácnych divadelných artefaktoch a dokumentoch aj osem básnikových podobizní (šesť malieb, jednu rytinu a jednu bustu), ale pravdepodobne iba jedna z nich bola zhotovená podľa živého modelu.	Searching for Shakespeare” brings together eight images of the Bard (six paintings, one engraving and one sculpted bust) – only one of which was likely done from life – along with rare theatrical artifacts and documents.	0.245161
Každá zo šiestich malieb od dávno zabudnutých autorov sa objavila až po dramatikovej smrti, v niektorých prípadoch dokonca aj o pár storočí neskôr.	Rendered by long-forgotten artists, each of the six painted portraits surfaced after the playwright’s death, in some cases centuries later.	0.287603
Medzi Shakespearom a veľkými životnými otázkami ako napríklad Kto sme?, Odkiaľ pramenia naše city a pocity, láska, žiarlivosť, vášeň? sa vytvorila akási spojitosť, vysvetľuje kurátorka výstavy portrétov Tarnya Cooperová, ktorá túto výstavu otvorila v londýnskej Národnej portrétnej galérii v marci roku 2005.	There’s something about Shakespeare that connects with those big human issues – who we are, why we feel the way we do, love, jealousy, passion, ” says Tarnya Cooper, who curated the exhibition at London’s National Portrait Gallery, where the portraits’ exhibit opened last March.	0.329089
Popri snahe nájsť Shakespearovu podobizeň zároveň chceme vidieť náznak vášne, s ktorou písal.	In looking for a portrait of Shakespeare, we want to see traces of those passions in the portrait’s face.	0.278049
Bohužiaľ, William Shakespeare zo Stratfordu, človek z mäsa a kostí, i naďalej ostáva nedosiahnuteľným.	Unfortunately, as a flesh-and-blood human being Will Shakespeare of Stratford remains stubbornly out of reach.	0.676667
Narodil sa do rodinu pravdepodobne negramotného rukavičkára a jeho manželky počas vlády Alžbety I.	He was born to an apparently illiterate glove maker and his wife early in the reign of Queen Elizabeth I.	0.496512
Ako osemnásťročný si vzal za manželku - o osem rokov staršiu tehotnú Anne Hathawayovú.	At 18, he married the pregnant Anne Hathaway, who was eight years his senior.	0.458462
Keď dovŕšil dvadsaťjeden rokov, bol už otcom troch detí.	By 21, he had fathered three children.	0.154545
Až o sedem rokov neskôr sa jeho meno objavuje v písomných záznamoch v súvislosti s Londýnom, kam sa uchyľuje zrejme bez svojej rodiny.	He turns up in the documentary record next at age 28 in London – apparently without his family – working as an actor.	0.246875
Na živobytie si zarába herectvom a onedlho sa stáva členom poprednej divadelnej spoločnosti pod názvom Spoločnosť lorda komorníka (Lord Chamberlain’s Men), neskôr aj spoločnosti nazvanej Kráľova spoločnosť (King’s Men).	He’s later listed as a member of a prominent acting troupe, the Lord Chamberlain’s Men, and later, the King’s Men.	0.285714
Shakespeare nemal ešte ani štyridsať rokov, keď sa jeho meno objavilo na titulných stranách hier, ktoré pre záujem širokej verejnosti vychádzali už aj v tlačenej podobe.	His name appears on the title pages of plays printed for popular consumption beginning in his mid-30s.	0.1
Podľa záznamov sa v roku 1613 utiahol do úzadia a presťahoval sa naspäť do Stratfordu, kde o tri roky neskôr zomiera ako pomerne neznámy päťdesiatdvaročný muž.	Records show he retired around 1613 and moved back to Stratford, where he died in relative obscurity three years later at 52.	1.64907
A to je asi tak všetko.	And that’s about it.	0.283333
Ani nejasnosti v písomných záznamoch zo Shakespearovho života nie sú pre vydavateľstvá dôvodom, aby prestali zaplavovať predajne životopisnými dielami, ktoré sú plné slovných spojení vyjadrujúce len určitú možnosť, ako napríklad pravdepodobne, zdá sa, je možné, a pod.	The sketchy paper trail from Shakespeare’s life hasn’t stopped the publishing industry from issuing a stream of biographies filled with phrases like may have” and could have”.	0.241143
V roku 2005 sa Rachel Donadiová, redaktorka novín New York Times v časti o knihách pri písaní recenzie na biografiu o bardovi zamýšľala, či tento bestseller pod názvom William Shakespeare: Veľký príbeh neznámeho muža od Stephena Greenblatta má zaradiť do zoznamu beletrie alebo literatúry faktu.	Last year in the New York Times Book Review, editor Rachel Donadio mused whether Stephen Greenblatt’s 2005 biography of the Bard, Will in the World, should be on the fiction or the nonfiction bestseller list.	1.50133
O živote Williama Shakespeara existujú dokumenty, ktoré sa zaoberajú jeho kariérou herca, riaditeľa divadla. V rukách však nemáme dôkazy, ktoré by hovorili o prepojení s literárnou tvorbou, tvrdí Mark Andreson, autor publikácie Shakespeare pod iným menom, ktorá skúma autorstvo jeho hier.	There are documents from William Shakespeare’s life that concern his career as an actor and theater manager and so on, but there’s nothing that suggests a literary life,” says Mark Anderson, author of Shakespeare” by Another Name, an examination of the plays’ authorship.	0.418075
Preto sú písomné záznamy také presvedčivé.	That’s what’s so damning about the documentary record.	0.221053
Ide o najväčšie pátranie po autorovi v dejinách literatúry a vedci neodhalili nijaké autorské rukopisy ani listy, ba dokonca ani denníky.	The greatest manhunt in literary history has turned up no manuscripts, no letters, no diaries.	0.162963
Jediné ukážky Shakespearovho rukopisu predstavuje šestica podpisov na úradných dokumentoch.	The only definitive examples of Shakespeare’s handwriting are six signatures, all on legal documents.	0.278313
Z tohto obdobia sa však vo všeobecnosti zachovalo len veľmi málo listov a denníkov, ktoré patrili bežným smrteľníkom.	Of course, few letters or diaries of commoners from that time have survived.	0.133846
V priebehu niekoľkých rokov skeptici uvažovali nad šesťdesiatimi rozličnými osobami, ktoré mohli byť skutočným Shakespearom.	Doubters over the years have proposed some 60 candidates as the real Shakespeare, among them Sir Walter Raleigh, Christopher Marlowe and Queen Elizabeth herself.	0.224324
Medzi nimi boli aj sir Walter Raleigh, Christopher Marlowe či samotná kráľovná Alžbeta I. V 19. storočí a začiatkom 20. storočia sa prívlastkom obľúbenca pýšil filozof a spisovateľ Francis Bacon.	The popular favorite among skeptics of the 19th and early 20th centuries was Francis Bacon, philosopher and writer.	0.251834
Niektorí tzv. baconiáni zastávali názor, že Shakespearove hry niekedy v sebe skrývajú tajné kódy, ktoré odkazujú na skutočného autora týchto veľdiel.	Some Baconians maintained that secret codes sprinkled throughout Shakespeare’s plays pointed to the works’ true author.	0.228571
(Napríklad rozdiel medzi celkovým počtom slov z dvoch častí v 1. časti dvojdielnej hry Henrich IV. a jeho následné vynásobenie počtom rozdelených slov na konci riadka nám napovie, o koľko veršov sa máme posúvať smerom hore alebo prípadne dole pozdĺž inej strany. Takýmto spôsobom môžeme z hier vyčítať aj skryté odkazy, ako napríklad vtedy už zosnulý dvoran kráľa Henricha VIII. alebo jezuitský tajný spolok. Mnohí považovali príbeh o Stratfordčanovi za veľmi neuspokojivý, o čom svedčí aj šírenie podobných domnienok.	(For example, by counting the difference in total words in two passages from Henry IV, Part 1, multiplying that by the number of hyphenations, then using the result to move up or maybe down a page somewhere else, you can begin to extract hidden messages in the plays, such as fetched – a long-dead member of Henry VIII’s court; a cabal of Jesuits – but the very proliferation of theories demonstrated how deeply unsatisfying many people found the Stratford story to be.	0.297397
Za posledné desaťročia sa spor do značnej miery zameral na dva proti sebe stojace tábory stúpencov.	In recent decades, the debate has largely settled down to a dispute between two opposing camps.	0.285185
Na jednej strane stoja zástancovia status quo, tzv. stratfordiáni, pričom oproti nim sú antistratfordiáni, ktorých myšlienkový smer podporujú aj knižné publikácie, webové stránky a spoločné zasadania. Svoju pozornosť prevažne upriamujú na jednu osobu, Edwarda de Vere, 17. grófa z Oxfordu (1550-1604).	On one side are the mainstream defenders of the status quo, known as Stratfordians. The anti-Stratfordian movement, meanwhile, backed by books, Web sites and conferences, has coalesced mainly around a single candidate: Edward de Vere, the 17th Earl of Oxford (1550-1604).	0.689778
Grófovi prívrženci známi ako oxfordiáni považujú Williama Shakespeara len za podstrčenú figúrku a argumentujú, že atramentom zašpinený gróf používal jeho meno ako pseudonym.	Oxfordians, as they are known, dismiss Will of Stratford as a frontman for the ink-stained earl who used his name as a pseudonym.	0.427778
(Presnejšie povedané iba do určitej miery, lebo Williamovo priezvisko malo často podobu Shakspere, inokedy zase Shaxspere, Shagspere alebo Shaxberd, ale v tých časoch boli obmeny mien bežnou súčasťou života. )	(More or less. Will’s surname was often Shakspere, but sometimes Shaxspere, Shagspere or Shaxberd, though variants on the spelling of names were hardly uncommon at the time.)	0.664142
Shakespeare – spisovateľ, nech už ním bol ktokoľvek, sa do anglickej literatúry zapísal ako autor s veľkým množstvom vedomostí, hovorí zarytý oxfordián Anderson.	Shakespeare the writer, whoever he was, was one of the most broadly educated authors in English literature,” says Anderson, an avowed Oxfordian.	0.391725
Tento básnik a dramatik sa úplne ponoril do antickej literatúry a jeho zdrojom boli ešte nepreložené texty.	The poet-playwright was steeped in the classics and drew on source texts that hadn’t yet been translated into English.	0.270652
Shakespearovu aktívnu slovnú zásobu tvorilo 17 000 slov (vrátane 3 200 novovytvorených výrazov), čo je v porovnaní s Johnom Miltonom dvojnásobok. Tieto údaje pochádzajú z 19. storočia, keď sa skúmala slovná zásoba oboch velikánov.	His working vocabulary of more than 17, 000 words – twice that of John Milton’s according to lexicons compiled for both men in the 19th century – includes nearly 3, 200 original coinages.	0.395701
Andersona preto zaujíma, či Angličan so stredoškolským vzdelaním naozaj mohol byť erudovaný až do takejto miery.	Could such erudition, Anderson asks, really come from a man with, at most, an English grammar-school education?	0.29375
Proti Stradfordčanovi, ako oxfordiáni povýšenecky nazývajú Shakespeara, existuje aj nepriamy dôkaz.	There is other circumstantial evidence against the Stratford man, ” as Oxfordians condescendingly call Shakespeare.	0.26
Vyzerá to tak, že ani jeho manželka s dcérou Judith neboli dostatočne vzdelané na to, aby sa vedeli podpísať.	Neither his wife nor his daughter Judith, it appears, were sufficiently literate to write their own names.	0.46337
Ba ani o otcovi rodiny sa nevie, že by cestoval až za južné hranice Anglicka. Aj napriek tomu jeho hry svedčia o tom, že všetky poznatky o Európe, predovšetkým o Taliansku, pochádzajú z prvej ruky.	The man himself is not known to have traveled beyond southern England, yet his plays suggest a firsthand knowledge of the Continent – Italy especially.	0.215625
V Stratforde ho ľud poznal ako obchodníka a majiteľa, ktorý inklinoval k divadelníctvu, nie však ako spisovateľa.	In Stratford he was known as a businessman and property owner with some connection to the theater, not as a writer.	0.460417
Jeho smrti nikto v Londýne nevenoval pozornosť a pochovaný je v Stratforde pod neoznačeným náhrobným kameňom.	His death attracted no notice in London, and he was buried – beneath a marker that bore no name – in Stratford.	0.463284
Niekoľko zachovaných úradných dokumentov zo Shakespearovho života nám ponúka len letmý pohľad na jeho osobnosť. Predsa len sa tieto časti skladačky nezhodujú s bežne rozšírenou predstavou o ušľachtilom básnikovi s nezvyčajnými vedomosťami a vznešenou mysľou.	The glimpses of Shakespeare’s character afforded by the few surviving legal documents from his life, moreover, don’t square with the current popular notion of a wise and lofty- minded poet.	0.27752
Podľa všetkého bol zažalovaný za podlžnosti v hodnote iba dva šilingy.	He apparently sued over debts as small as two shillings.	0.21875
Istý Londýnčan žiadal zatknutie niekoľkých mužov vrátane Shakespeara, lebo sa bál, že mu ide o život.	A London acquaintance once sought his arrest, along with that of some other men, for fear of death.	0.285542
V roku 1598 ho počas hladomoru v Stratforde rozzúrený sused obvinil zo zhromažďovania obilia a dokonca žiadal, aby spolu so svojimi priekupníkmi odvisol priamo pred vlastnými dverami.	”And in 1598, he was accused of hoarding grain in Stratford during a famine, prompting a furious neighbor to demand that he and his fellow profiteers be hanged on gibbets at their own doors.”	0.405244
Zlatým klincom výstavy v Yalovom centre britského umenia je jeho závet, podľa ktorého manželke odkázal svoju druhú najlepšiu posteľ.	Then there is his will (a centerpiece of the Yale exhibition), in which he bequeathed to his wife his second best bed.	0.247959
Básnik a esejista Ralph Waldo Emerson v roku 1850 napísal: Mnoho obdivuhodných umelcov žilo v akomsi súlade so svojou životnou filozofiou, ale v jeho prípade sa prejavuje výrazný kontrast.	As poet and essayist Ralph Waldo Emerson wrote in 1850, Other admirable men have led lives in some sort of keeping with their thought, but this man in wide contrast.”	0.55
K šíreniu pochybností pravdepodobne prispievajú aj dve Shakespearove podobizne, všeobecne považované za hodnoverné.	The two portraits of Shakespeare that have been widely accepted as authentic have probably contributed to the doubts.	0.291089
Najznámejšiu a okamžite rozpoznateľnú predstavuje rytina zhotovená až posmrtne neveľmi talentovaným holandským výtvarníkom zo začiatku 17. storočia Martinom Droeshoutom.	The best-known – an image instantly recognizable today – is a posthumous engraving made by Martin Droeshout, a none-too-talented Dutch artist of the early 1600s.	0.419565
Objavila sa na titulnej strane Prvého fólia, obrovskej zbierky hier Williama Shakespeara vydanej bardovými dlhoročnými priateľmi a spoluúčinkujúcimi hercami Johnom Hemingesom a Henrym Condellom v roku 1623, sedem rokov po jeho smrti (pozri Fólio, kde len si?).	It appeared on the title page of the First Folio, the massive compilation of plays by Mr. William Shakespeare published by John Heminges and Henry Condell, fellow actors and longtime friends of the Bard, in 1623, seven years after his death (see Folio, Where Art Thou?”).	0.376281
Droeshout pravdepodobne vychádzal z už neexistujúceho portrétu, ale jeho anatomicky nesprávne vyobrazená osoba vyzerá odmerane a trochu nesvoja, akoby vôbec nechcela pred výtvarníkom pózovať.	In Droeshout’s anatomically awkward rendering, which he likely copied from a life portrait that no longer exists, the subject looks distant and slightly uncomfortable, as though he’d rather not be posing at all.	0.400473
Druhú všeobecne uznávanú podobizeň, zhotovenú taktiež po smrti, predstavuje pamätná busta v kostole Svätej Trojice v Stratforde, avšak mnohých znepokojuje ešte viac ako Droeshoutova rytina.	The second generally accepted portrait, also posthumous, is a memorial bust in Stratford’s Trinity Church, which many find even more disconcerting than Droeshout’s engraving.	0.272368
Kritik J. Dover Wilson prirovnal tohto vykŕmeného muža s prázdnym pohľadom k namyslenému mäsiarovi.	Critic J. Dover Wilson likened the well-fed, vacant-looking man in the carving to a self-satisfied pork-butcher.	0.862069
Vo svojom životopisnom diele Skutočný Shakespeare z roku 1932 Wilson napísal, že v oboch prípadoch ide o tak očividne chybnú podobizeň najvýznamnejšieho básnika všetkých čias, že sa celý svet od nich s nechuťou odvracia.	”The two portraits, Wilson wrote in his 1932 biography The Essential Shakespeare, are so obviously false images of the greatest poet of all time that the world turns from them in disgust.	1.33167
Wilson však zrejme veci dramatizoval, keďže Shakespearovi priatelia aj rodina evidentne považovali obe podobizne za prijateľné.	Wilson seems to have been overstating matters, for evidently both likenesses were acceptable to Shakespeare’s own friends and family.	0.468506
Spomínané prvé dva pokusy o vyobrazenie Shakespeara spôsobili, že v nasledujúcich rokoch sa mnohí začali venovať domáckemu portrétovaniu poeta.	In the years following these two early efforts at depicting him, Shakespearean portraiture became something of a cottage industry.	0.265487
Dosť často sa objavujú nové portréty, opisuje kurátorka Tarnya Cooperová.	New portraits turn up quite often,” says curator Tarnya Cooper in London.	0.563203
Len za posledné tri mesiace som sa stretla s tromi.	In the last three months, I’ve had three.”	0.241667
Zatiaľ vo všetkých prípadoch sa odborníci zhodli v tom, že ide o falzifikáty alebo portréty niekoho iného.	So far, all have been deemed fabrications or portraits of someone else.	0.152459
Jednu z najdôvernejších podobizní dramatika, tzv. Flowerov portrét, ktorý vlastní Kráľovská shakespearovská spoločnosť, v roku 2005 preskúmali odborníci. Dovtedy si mysleli, že vznikol ešte v dobe, keď básnik žil a možno bol východiskom pre Droeshoutovu rytinu. Prieskum však odhalil, že v skutočnosti pochádzal z 19. storočia a bol len výplodom autorovej fantázie.	Last year, a scientific examination revealed that one of the most familiar likenesses of the playwright, the Royal Shakespeare Company’s so-called Flower portrait – once thought to have been done in the Bard’s lifetime and to have perhaps been the source of the Droeshout engraving – was actually concocted in the 19th century.	0.314212
V roku 1988 sa predmetom záujmu odborníkov stalo ďalšie umelecké stvárnenie, tento raz majetok Folgerovej Shakespearovskej knižnice. Vyšlo najavo, že vysoké čelo osoby na tzv. Janssenovom portréte s vpísaným rokom 1610 zakrýva prirodzenú pokrývku hlavy, ktorá bola premaľovaná v 17. alebo 18. storočí.	In 1988, the subject of another rendering, the Folger Shakespeare Library’s Janssen portrait, inscribed with the date 1610, proved to be hiding a full head of hair; the subject’s domelike forehead was a paint-over added in the 17th or 18th century.	0.226794
Cooperová nevie potvrdiť, či niektorú z podobizní na výstave Pátranie po Shakespearovi výtvarníci naozaj namaľovali podľa živého modelu. Existuje však jedna možnosť, ktorú považuje za vysoko pravdepodobnú. Možnosť, že skutočný William Shakespeare z mäsa a kostí pózoval pre tzv. Chandosov portrét patriaci Národnej portrétnej galérii. Portrét dokonca aj nazýva našou Monou Lízou.	Though Cooper can’t affirm that any of the Searching for Shakespeare” portraits were painted from life, she labels as pretty high” the odds that a living, breathing William Shakespeare posed for the National Portrait Gallery’s own Chandos portrait, which she calls our Mona Lisa.”	0.385294
Autorstvo tejto maľby bez dátumu vzniku pripisujeme menej známemu anglickému výtvarníkovi a možno aj hercovi s menšou úlohou Johnovi Taylorovi, ktorý pôsobil počas Shakespearovho života.	The undated painting is attributed to an obscure English artist and possible bit actor of Shakespeare’s day named John Taylor.	0.147222
Už od polovice 17. storočia ho jednotliví vlastníci pokladali za pôvodný Shakespearov portrét a po založení galérie v Londýne v roku 1856 si toto umelecké dielo zaobstarala ako prvé.	A succession of owners since the mid-1600s have deemed it an authentic portrait of Shakespeare, and it was the first work the gallery acquired at its founding in London in 1856.	0.285811
Niektorí z prvých obdivovateľov barda tvrdia, že osoba s tmavšou pokožkou a tak trošku trúchlivým výrazom v tvári nevyzerá dosť anglicky.	The portrait’s swarthy, somewhat lugubrious subject didn’t look sufficiently English” to a few of the Bard’s early admirers, however.	0.444828
Náš výtvarník ho vyobrazil ako Žida, alebo lepšie povedané ako kominára so žltačkou, posťažoval sa George Steevens, vydavateľ z 18. storočia.	Our author exhibits the complexion of a Jew, or rather of a chimney- sweeper in the jaundice,” complained an 18th-century editor named George Steevens.	0.419151
Pátranie po hodnovernom vyobrazení Shakespeara ako aj pokusy o odhalenie detailov z jeho života sčasti podnecuje nádej, že by sme mohli nájsť niečo jedinečné. Možno koketoval s kráľovnou Alžbetou – je to však nepravdepodobné.	The search for an authentic image of Shakespeare, like the search for revelations about his life, is guided in part by what we hope to find: we hope he flirted with Queen th, but he probably didn’t.	0.416214
Možno nezhromažďoval obilie, ale opak je pravdou.	We hope he didn’t hoard grain, but he probably did.	0.293023
Vysvetľovalo by to popularitu dvoch z ôsmich podobizní na výstave.	This may explain the popularity of two of the eight highlighted portraits in the exhibition.	0.191379
Nielen Graftonov portrét z roku 1588, ale aj Sandersov portrét z roku 1603 zvečňuje zmyselného mladíka, ale ani jedného nemôže označiť za Shakespeara.	Both the Grafton portrait (1588) and the Sanders portrait (1603) depict sensuous young men, neither of whom has any substantial claim to being Shakespeare.	0.290698
J. Dover Wilson si pre frontispice svojho diela Skutočný Shakespeare zvolil Graftonov portrét s priznaním, že si vrúcne želá, aby záhadná vitalita v tých nádherných očiach a oválna shelleyovská tvár zachytávali skutočného mladého poeta.	For the frontispiece of The Essential Shakespeare, J. Dover Wilson chose the Grafton, confessing that he couldn’t help but wish that the unknown youth of the wonderful eyes and the oval Shelley-like face” was in fact the young poet.	0.543297
Literárny kritik Harold Bloom v americkom časopise Vanity Fair v roku 2001 vyhlásil, že uprednostňuje veselší Sandersov portrét pred tými tradičnými.	And literary critic Harold Bloom announced in Vanity Fair in 2001 that he preferred the livelier” Sanders to traditional portraits.	2.39772
Výstava Pátranie po Shakespearovi disponuje jednou podobizňou, o ktorej niet pochýb. Ide o portrét Edwarda de Vere, 17. grófa z Oxfordu.	But Searching for Shakespeare” includes one portrait about which there is no doubt whatsoever: it is of Edward de Vere, the 17th Earl of Oxford.	0.562471
Hoci pôsobí elegantnejšie a sebavedomejšie ako vystavení Shakespeari, jeho zovňajšok ešte nie je dôvodom na to, aby ho oxfordiáni považovali za hodnovernejšieho Shakespeara. Aj keď ani týmto veľa škody nenarobí.	That he appears a more dashing and self-assured figure than any of the Shakespeares on display is not, of course, why Oxfordians find him the more plausible candidate – though it probably doesn’t hurt.	0.371922
Gróf z Oxfordu bol o štrnásť rokov starší ako náš dramatik, no okrem toho bol aj kultivovaným a scestovaným polyglotom a elegánom s dobrým vzdelaním a vplyvnými príbuznými.	Fourteen years Shakespeare’s senior, Oxford was an urbane, multilingual dandy, well educated, well traveled and well connected.	0.208929
Otec mu zomrel, keď mal dvanásť rokov. Domov mu poskytol William Cecil, neskôr lord z Burghley, ktorý viac než štyridsať rokov pôsobil ako najspoľahlivejší poradca kráľovnej Alžbety.	At 12, when his father died, he was taken in by William Cecil, later Lord Burghley, who for more than 40 years was Queen Elizabeth’s most trusted adviser.	0.55346
Keď mal dvadsaťjeden rokov, oženil sa s lordovou dcérou Anne Cecilovou, čím sa stal jeho zaťom.	He became Oxford’s father-in-law when Oxford, at 21, married Burghley’s daughter, Anne Cecil.	0.510582
Tento módne oblečený švihák a miláčik žien si na kráľovskom dvore získal pozornosť ako víťaz v boji s kopijou.	At court, he won attention as a jousting champion, clotheshorse and ladies’ man.	0.409938
Jej kráľovské Veličenstvo má väčšiu radosť z jeho prítomnosti, tancovania a chrabrosti než ostatní prítomní, napísal o 21-ročnom grófovi mladý šľachtic a budúci gróf zo Shrewsbury.	The Queen’s Majesty delighteth more in his personage and his dancing and his valiantness than any other,” another young aristocrat, the future Earl of Shrewsbury, wrote of the 21-year-old earl.	0.282692
Mnohí nepriatelia grófa z Oxfordu mu však pripisovali vlastnosti prchkého surovca chodiaceho za prostitútkami, nemravného márnotratníka a nafúkaného pederasta.	Oxford’s many enemies, however, described him variously as a whoring, hot-tempered bully, a dissolute spendthrift and a flatulent pederast.	0.40082
Keď mal sedemnásť (údajne v sebaobrane) vlastnou šabľou zabil pomocnú silu v kuchyni u lorda z Burghley.	At 17, he used his sword to kill an under-cook in Burghley’s household (supposedly in self-defense).	0.289535
Ako 24-ročný na viac ako rok opustil manželku, pretože odišiel na Kontinent.	And at 24, he abandoned his wife for the Continent for more than a year.	0.264407
Oxfordov životopisec a emeritný profesor angličtiny na Kalifornskej univerzite v Berkeley a stratfordián Alan H. Nelson hodnotí jeho poéziu ako priemernú až úplne príšernú.	As for his poetry, Oxford biographer Alan H. Nelson, emeritus professor of English at the University of California at Berkeley and a Stratfordian, ranks it from absolutely dreadful to middling.	0.75
Oxfordova poézia si za jeho čias vyslúžila pochvalu, takisto ako aj jeho zručnosť v písaní divadelných hier, hoci ani jedna z jeho drám sa nezachovala.	In his own time, at least, Oxford’s poetry won praise. So did his skill as a playwright, though none of his dramas survive.	0.223529
Alžbetínske verejné divadlo sa vyznačovalo nevšednou obľubou, ale niekedy aj výtržníctvom. Niektorí jeho súčasní stúpenci preto tvrdia, že pre takého vysokopostaveného šľachtica by bolo nevhodné, ak by písal otvorene.	Some modern-day advocates claim that it would have been unseemly for a high-ranking nobleman to write plays openly for the hugely popular, sometimes rowdy Elizabethan public theater.	0.236943
Okrem toho sa hovorí, že dramatici, ktorí až príliš očividne zosmiešňovali vládnucu vrstvu, sa mohli ocitnúť vo väzení.	And, they say, playwrights who satirized the powerful too obviously could find themselves jailed or worse.	0.26413
Richard Whalen, autor knižnej publikácie Kto vlastne bol Shakespeare? (jednoznačnou odpoveďou na otázku v názve je gróf z Oxfordu) pripúšťa, že určití ľudia z divadelného sveta vrátane úslužného Willa museli vedieť, že skutočným Shakespearom je gróf.	Richard Whalen, author of Shakespeare – Who Was He? (which answers its title’s question as, unquestionably, the Earl of Oxford), allows that the earl’s identity as the real Shakespeare had to have been known to a number of theater-world insiders, among them an accommodating Will.	0.432995
Napriek tomu je Whalen presvedčený, že nie je potrebné vytvárať nejakú impozantnú konšpiračnú teóriu a zatajovať ňou Oxfordovu úlohu.	Nonetheless, Whalen argues, one needn’t posit the existence of a grand conspiracy that concealed Oxford’s role.	0.594178
Jeho autorstvo bolo pravdepodobne verejným tajomstvom, tvrdí Whalen, pričom podobne ako spomínaný oxfordián Mark Anderson nespolupracuje s nijakou univerzitou.	His authorship was probably an open secret,” says Whalen, who, like his fellow Oxfordian Mark Anderson, is unaffiliated with a university.	0.542017
Kráľovská vrchnosť možno zatvárala oči pred šľachticom, ktorý sa znížil k písaniu frašky, ba dokonca až kritizovaniu konkrétnych predstaviteľov šľachty.	The powers that be could pretend they didn’t know a nobleman was stooping to farce and, worse, critiquing his peers.	0.189796
Na druhej strane sa široká verejnosť zase až tak nezaujímala o to, kto písal všetky tie hry.	As for the general public, he says, They weren’t all that interested in who wrote the plays they went to.	0.261039
Spojitosť medzi Oxfordom a Shakespearom je ľahko rozpoznateľná.	Links between Oxford and Shakespeare are not hard to find.	0.258
Oxford ponúkol tretiemu grófovi zo Southamptonu na vydaj najstaršiu zo svojich troch dcér, no ten odmietol. Shakespeare zase grófovi venoval svoje dve dlhé básnické skladby Venuša a Adonis a Znásilnenie Lukrécie.	The oldest of Oxford’s three daughters was once offered in marriage to the 3rd Earl of Southampton, to whom Shakespeare dedicated his two long narrative poems, Venus and Adonis” and The Rape of Lucrece. ” He declined.	0.392102
Ďalšia dcéra si vzala za muža jedného z grófov, ktorým bolo venované Prvé fólio.	Another daughter was married to one of the two earls to whom the First Folio was dedicated.	0.264706
Zástancovia grófa z Oxfordu odkryli dôkazy v samotných hrách.	Oxford supporters find other evidence in the plays themselves.	0.294444
Napríklad v Hamletovi a Kráľovi Learovi im v ušiach znie skôr hlas šľachtica a nie prostého občana.	In Hamlet and King Lear, for example, they hear the voice of an aristocrat, not a commoner.	0.435088
Jeho hry názorne poukazujú na to, ako prenikavo a dokonalo vystihol spôsob myslenia a fungovanie kráľovského dvora či vládnej byrokracie, poznamenal Whalen.	The plays demonstrate a keen, intimate knowledge of how people in a royal court or a government bureaucracy think and operate,” says Whalen.	0.648447
Pravdaže, majstrovské písanie je vždy výsledkom tvorivého procesu, ale veľkolepé diela predstavujú plody autorovej vlastnej skúsenosti.	Yes, great writing is always a creative process, but a writer’s best works are products of their own experiences.	0.221875
Len si zoberte Tolstoja. Písal o tom, čo poznal najdôvernejšie, teda o rodine, Rusku, vojne.	Think of Tolstoy, who wrote about what he knew best: his family, Russia, war.	0.235385
Vychádzajúc zo životopisných poznatkov o grófovi z Oxfordu by som preto argumentoval, že jeho osobnosť zodpovedá portrétu niekoho, o kom by ste predpokladali, že napísal diela, ktoré prisudzujeme Shakespearovi.	I would argue the Earl of Oxford’s life fits the profile of someone you would expect to have written the works of Shakespeare.”	0.0820755
Oxfordián Mark Anderson nachádza ďalšie záchytné body v prostredí, dejových líniách a postavách zo Shakespearových hier.	Oxfordian Mark Anderson finds other clues in Shakespeare’s settings, plots and characters.	0.664038
Napríklad v Hamletovi zachytil obrazy z Oxfordovho života.	He discerns in Hamlet, for instance, elements drawn from Oxford’s life.	0.242308
Polonius je karikatúrou grófovho svokra lorda z Burghley, ktorý sa vyznačoval pomerne dobrou výrečnosťou a suchopárnosťou, opisuje.	Polonius is a caricature of Oxford’s father-in-law, Lord Burghley, who was known to be rather prolix and tedious,” he says.	0.768571
Nielen Polonius, ale aj Burghley raz poslal špehov, aby ho informovali o jeho synovi.	Burghley, like Polonius, once sent spies to check up on his own son.	0.430075
Ofélia predstavuje Burghleyovu dcéru, ktorej Oxford/Hamlet dvorí a podobne.	Ophelia is Burghley’s daughter, whom Oxford/Hamlet woos, and so on.	0.554237
Napriek všetkým presvedčivým argumentom aj tí najzanietenejší oxfordiáni musia uznať, že neexistuje ani ten najmenší skutočný dôkaz o priamej spojitosti medzi ich obľúbencom a Shakespearovou tvorbou.	As persuasive as their case may be, even the most ardent Oxfordians must admit there isn’t a scrap of real evidence tying their man to Shakespeare’s work.	0.304134
Veď ako by sme potom vysvetlili slová chvály Ó žiť, tvoje srdce bude biť, / A môžeme tvoje umenie zažiť, a preň ťa velebiť.	And how to explain Ben And art alive still, while thy Booke doth live, /And we have wits to read, and praise to give.	0.281053
Skupina ortodoxných stratfordiánov, kam patrí aj veľká väčšina historikov a profesorov angličtiny, ktorí sa zaujímajú o Shakespeara, pokladá zástancov grófa z Oxfordu len za rojkov, ktorí vôbec neberú do úvahy historické skutočnosti, alebo si ich nesprávne vysvetľujú.	By and large, orthodox Stratfordians – a group that includes the vast majority of historians and English professors with an interest in Shakespeare – dismiss Oxford’s champions as wishful thinkers who ignore or misread historical evidence.	0.340105
Podľa odborníkov je prirodzené, že túžime objaviť stopy, ktoré zanechal náš najuctievanejší spisovateľ. Nech je to len sonet o láske na pergamene s vlastnoručným podpisom alebo prvá verzia Macbetha.	It’s natural, they say, that we yearn for traces of our most revered writer – a signed love sonnet on parchment, at least, if not a complete first draft of Macbeth.	0.22
Ak majú podozrenia ohľadom ich neprítomnosti, v skutočnosti to odhaľuje len ich mylné chápanie spôsobu života v období anglickej renesancie.	But finding their absence suspicious, they say, reveals basic misunderstandings about life during the English Renaissance.	0.261111
V Shakespearovej dobe ho ľudia nevnímali ako žánrovo všestranného velikána, vysvetľuje Marjorie Garberová, profesorka angličtiny a vizuálnych štúdií na Harvardovej univerzite a autorka niekoľkých kníh o Shakespearovi vrátane publikácie A predsa Shakespeare (2004).	In his own time, Shakespeare wasn’t thought of as a universal genius,” says Marjorie Garber, professor of English and visual studies at Harvard University and the author of several books on Shakespeare, including Shakespeare After All (2004).	0.61526
Vtedy nikomu nenapadlo odložiť si jeho siahodlhý zoznam a potom predať cez eBay.	Nobody was about to save a laundry list he wrote so they could sell it on eBay.	0.705134
Pre tú kultúru to nebolo príznačné.	It wasn’t that kind of culture.	0.255556
Papier sa typicky ručne vyrábal vo Francúzsku, bol vzácny a drahý. Keď už viac nebol potrebný, znovu ho použili na niečo iné, možno na vystlanie misky na pečenie alebo na spevnenie obalu knihy.	Paper, typically handmade in France, was scarce and expensive; when it was no longer needed, it was reused – to line a baking dish, perhaps, or stiffen a book cover.	0.34203
Písanie listov a denníkov bolo dosť neobvyklé, hlavne v prípade prostých ľudí.	Letter- writing and diary-keeping were unusual, especially for commoners.	0.290909
Pokiaľ ide o autorské rukopisy Garberová tvrdí, že po ich vytlačení už nikto nemal dôvod si ich uschovať.	As for play manuscripts, Garber says, Once they were set in type, there was certainly no reason to save them.	0.293258
Dokonca ani verejnosť ich nepovažovala za literárne diela.	Even in print, plays were considered something less than literature.	0.253846
Taktiež zdôrazňuje, že keď Thomas Bodley v čase Shakespeara založil na Oxfordskej univerzite knižnicu Bodleian, odmietol zaradiť pôvodné hry do katalógu.	When Thomas Bodley set up the Bodleian library at Oxford University in Shakespeare’s time, she points out, he refused to include play texts.	0.534912
Vnímali ich ako odpad, ako brakovú literatúru.	These were considered trash, like pulp fiction.”	0.285366
Bežní odborníci postupne zavrhujú jednotlivé predmety diskusií oxfordiánov.	One by one, mainstream scholars knock down the Oxfordians’ debating points.	0.286364
Nie, Stratford nepatril medzi nekultivované zastrčené miesta. Pochádzal odtiaľ aj londýnsky starosta a arcibiskup z Canterbury.	No, Stratford wasn’t an uncultured backwater; a lord mayor of London and an archbishop of Canterbury had both come from there.	0.636119
Nie, absolvent stratfordského gymnázia nenadobudol vzdelanie ako žiak, ktorý by školu nechal po siedmom ročníku.	No, a Stratford grammar-school graduate wasn’t akin to a seventh-grade dropout of today.	0.214286
Antická literatúra bola v školách bežným predmetom, a tak sa jej prvky odrážajú v hrách.	The Greek and Latin classics echoed in the plays were a standard part of the grammar-school curriculum.	0.4355
Shakespeare možno nikdy nenavštívil Taliansko, ale ani nikto z obdobia renesancie nezažil staroveké Grécko či Rím na vlastnej koži. A predsa táto skutočnosť nezabránila tomu, aby sa antický svet stal obľúbeným prostredím pre realizáciu deja básnickej tvorby a divadelných hier.	Shakespeare may never have visited Italy, but neither he nor anyone else during the Renaissance ever set foot in ancient Greece or Rome either, and that did not rule out the Classical world as a popular setting for poetry and drama.	0.374839
A nemuseli ste byť šľachticom, aby ste písali o kráľoch a kráľovnách.	And no, you didn’t have to be a nobleman to write about kings and queens.	0.525684
Všetci spisovatelia o nich písali, lebo presne to alžbetínska verejnosť od nich vyžadovala.	Writers of every stripe did so – it’s what the Elizabethan public demanded.	0.225
To, čo nakoniec odlišuje Shakespeara od jeho súčasníkov, je rôznorodosť jeho literárnych štýlov a tematiky, vysvetľuje Jonathan Bate z Warwickskej univerzity.	In the end, what sets Shakespeare apart from his contemporaries is the sheer range of his style and his subject matter, says the University of Warwick’s Jonathan Bate.	0.432047
Písal vynikajúce komédie, tragédie aj historické hry.	He was great in comedy and tragedy and history.	0.24
Vedel písať o kráľovskom dvore a tiež o prostých ľuďoch.	He could write about the court, and he could write about ordinary people.	0.2125
Bate tvrdí, že hra nemusí byť autobiografická, tak ako ani sonet nemusí byť výlučne o vyznaní lásky.	A play doesn’t have to be autobiographical, Bate suggests, any more than a sonnet has to be confessional.	0.452549
Shakespeare si vždy nechal na tvári masku.	Shakespeare always kept himself well disguised.	0.679923
Nesnažil sa do diel vniesť vlastné názory a odkláňal sa od tematických rozporov danej doby.	He didn’t insert his own opinions, and he steered away from the topical controversies of the day.	0.284615
Práve toto uľahčilo súčasným režisérom a filmárom prácu pri spracovaní jeho hier.	That’s why it’s so easy for directors and filmmakers today to make his plays contemporary.	0.274648
V tom tkvie aj jeho nadčasovosť.	It’s the key to his endurance.	0.276923
Bate tiež poznamenal, že Shakespeare samozrejme nezačal písať veľdiela hneď ako siahol po brku.	Nor, Bate adds, is it necessary to believe that Shakespeare began writing masterpieces as soon as he picked up a quill.	0.638554
Existuje vierohodný dôkaz, že spočiatku prepisoval práce iných dramatikov.	There is good evidence that he started by rewriting the works of other dramatists.	0.286567
Mnohé z jeho prvých hier vznikli buď v spolupráci s uznávanejšími autormi, s ktorými spolupracoval, alebo prepracovaním starších hier.	Lots of his early plays are either collaborative works, where he’s a kind of junior partner working with more established dramatists, or they’re reworkings of older plays.	0.225641
Dokonca aj dejové línie hĺbavejších a uváženejších diel, akými sú Hamlet či Kráľ Lear, čerpal z už existujúcich prác.	”Even the mature plays like Hamlet and King Lear, Bate says, drew on existing works for their plots.	0.558647
Bate vysvetľuje: V tých dňoch sa originálnosť nijako výnimočne necenila.	In his time, originality wasn’t especially valued.	0.173333
Ako sa dalo predpokladať, Anglicko jeho smrť neoplakávalo.	As for England not mourning his death, that’s not surprising either.	0.259615
Do roku 1616 bol Shakespeare predsa len dôchodca pochádzajúci zo strednej triedy, ktorý žil ďaleko od Londýna a jeho hry už nepredstavovali najvyhľadávanejšie umelecké diela.	By 1616, Shakespeare was, after all, a middle-class retiree living far from London, and his plays were no longer the latest fashion.	0.456405
Počas celého života a ešte nejaký čas potom ľudia nepochybne Shakespeara uznávali a vážili si ho, ale nepovažovali ho za stelesnenie jedinečnosti, hovorí Bate.	In his own lifetime and for some time after, Shakespeare is certainly admired and respected, but he’s not thought of as unique,” says Bate.	0.368718
Preto sa mnohí spisovatelia domnievali, že majú právo skvalitniť jeho tvorbu.	Which is why later writers felt justified in improving” on him.	0.222222
Britský dvorný básnik John Dryden koncom 17. storočia skrátil Troila a Kressidu, ako sám povedal, odstránením tej hromady táranín, ktoré úplne zasypali toľko vznešených myšlienok.	British poet laureate John Dryden shortened Troilus and Cressida in the late 1600s by excising what he called that heap of Rubbish, under which so many excellent Thoughts lay wholly bury’d.”	0.521154
Nemenovaný kritik v nasledujúcom storočí Shakespearovi vyčítal, že odignoroval staroveké národy, nedodržiaval spoločenské konvencie, lebo sa uchýlil k tragikomédii a písaniu o nadprirodzených bytostiach, používal slovné hračky a blankvers.	An unnamed critic in the following century scolded Shakespeare for ignoring the ancients, for violating decorum by resorting to tragicomedy and supernatural characters, and for using puns and blank verse.	0.238636
V porovnaní so Shakespearovými súčasníkmi dosahovala jeho genialita oveľa vyššiu úroveň. Táto predstava sa však začína šíriť až v polovici 18. storočia vďaka rozkvetu Britského impéria a zvýšeniu gramotnosti, vraví Bate.	The idea that he was a completely different order of genius from all his contemporaries only begins in the mid-18th century, with the British Empire taking off and literacy growing,” says Bate.	0.435966
K zidealizovaniu Shakespeara oficiálne prišlo v roku 1769, keď herec David Garrick usporiadal v Stratforde honosnú oslavu výročia bardovho narodenia.	The apotheosis became official with actor David Garrick’s lavish Shakespeare Jubilee, held in Stratford in 1769.	0.37545
V očiach súčasnej verejnosti je Shakespeare takým literárnym géniom, akým je Mozart v oblasti hudby či da Vinci v maliarstve.	For today’s public, of course, Shakespeare is to literary genius what Mozart is to music and Leonardo to painting.	0.569072
Bate preto vysvetľuje, že diskusie o autorstve sú prirodzeným výsledkom uctievania Shakespeara, ktoré je už hlboko zakorenené v našej kultúre.	The authorship debate, says Bate, is a natural consequence of a cult of Shakespeare now deeply rooted in our culture.	0.224242
Marjorie Garberová z Harvardovej univerzity zaujala k tomuto dlhotrvajúcemu sporu mimoriadne zhovievavé stanovisko.	Harvard’s Marjorie Garber takes an unusually tolerant view of the long-running dispute.	0.425574
Tvrdí, že mnohí ľudia, ale predovšetkým spisovatelia, majú radšej záhadu ako jej vyriešenie.	A lot of people, especially writers, prefer the mystery to an answer,” she says.	0.242647
Nech už je odpoveď na hádanku akákoľvek, aj tak to bola jednoducho osoba z konkrétneho obdobia a miesta.	Any answer is going to be simply a human of a particular time and place.	0.527542
Domnieva sa, že v súčasnosti hľadíme na Shakespeara očami jeho priateľa Bena Jonsona, keď mu vzdával hold v Prvom fóliu: Nepatril len do jednej éry, je večný!	We regard Shakespeare today, she believes, the way his friend Ben Jonson did in his First Folio tribute – He was not of an age, but for all time! ”– and asks whether we really want to see him reduced to an ordinary mortal.	0.193985
Tiež sa pýta, či ho naozaj chceme vidieť iba ako obyčajného smrteľníka a podotýka, že mnohí sa radšej držia predstavy transcendentálneho, univerzálneho Shakespeara.	Many people prefer to keep the idea of a transcendent, universal Shakespeare,” she says.	0.235526
Garberová sa rada odvoláva na poznámku, ktorú v roku 1847 Charles Dickens napísal svojmu priateľovi: Shakespearov život je jedna veľká záhada a ja sa každý deň trasiem, aby niečo nevyšlo na povrch.	Garber likes to cite a remark Charles Dickens made to a friend in 1847: The life of Shakespeare is a fine mystery, and I tremble every day lest something should turn up.”	0.51487
		0.3
