Tak veľmi som ich chcel, že som počas telesnej výchovy úmyselne zaostal a premiestnil som ich z jeho batohu do môjho.	I wanted them so badly that I stayed back during gym class and transferred the sheet out of the classmate's backpack into mine.	0.27551
Keď sa spolužiaci vrátili, búšilo mi srdce.	When the students returned, my heart was racing.	0.268421
V panike, že ma odhalia, som si vymyslel preventívnu lož.	Panicking that I would be found out, I thought up a preemptive lie.	0.257143
Učiteľovi som povedal, že sa zjavili dvaja tínedžeri na motorke, vošli do triedy, prehrabali batohy a odišli s nálepkami.	I told the teacher that two teenagers had shown up on a motorbike, entered the classroom, rifled through backpacks, and left with the stickers.	0.400962
Ako si asi dokážete domyslieť, moja lož sa rozpadla pri najmenšom vyšetrovaní a ja som neochotne vrátil, čo som ukradol.	As you might expect, this fib collapsed at the gentlest probing, and I reluctantly returned what I had pilfered.	0.277895
Moje naivné klamstvá, ktoré sa časom zlepšili, zodpovedali mojej dôverčivosti v šiestej triede, keď mi priateľ povedal, že jeho rodina vlastní lietajúcu kabínu, ktorá nás dopraví kamkoľvek na svete.	My naive lying—I got better, trust me—was matched by my gullibility in sixth grade, when a friend told me that his family owned a flying capsule that could transport us anywhere in the world.	0.277358
Ako súčasť prípravy na presun týmto zariadením som požiadal mojich rodičov, aby mi zbalili nejaké jedlo na cestu.	Preparing to travel on this craft, I asked my parents if they could pack me a few meals for the journey.	0.257647
Dokonca aj keď sa mi môj starší brat posmieval, odmietol som neveriť tvrdeniu môjho priateľa a nakoniec zostalo na jeho otcovi, aby ma konečne presvedčil, že som bol podvedený.	Even when my older brother snickered, I refused to disbelieve my friend‟s claim, and it was left to my friend's father to finally convince me that I'd been duped.	0.268889
Tieto moje a kamarátove lži neboli ničím nezvyčajným pre deti v našom veku.	These lies that my friend and I told were nothing out of the ordinary for kids our age.	0.267187
Naučiť sa klamať je istým spôsobom míľnikom vo vývoji, podobne ako učiť sa chodiť a rozprávať.	Like learning to walk and talk, lying is something of a developmental milestone.	0.46646
Zatiaľ čo rodičov klamstvá ich detí často znepokojujú, pretože signalizujú začiatok straty nevinnosti, psychológ Torontskej univerzity Kang Lee vníma vývin tohto správania u batoliat ako uisťujúci znak, že ich kognitívny rast je na dobrej ceste.	While parents often find their children's lies troubling—for they signal the beginning of a loss of innocence—Kang Lee, a psychologist at the University of Toronto, sees the emergence of the behavior in toddlers as a reassuring sign that their cognitive growth is on track.	0.273113
Pre prvých pár hračiek sú indície zrejmé. Deti ľahko uhádnu, že hračkou je pes alebo mačka, keď je indíciou zvuk ako brechanie alebo mňaučanie.	For the first few toys, the clue is obvious—a bark for a dog, a meow for a cat—and the children answer easily.	0.196667
Zvuky, ktoré nasledujú, už nemajú nič spoločné s danou hračkou.	Then the sound played has nothing to do with the toy.	0.225
Pustíte im Beethovena, ale hračkou je auto, vysvetľuje Lee.	So you play Beethoven, but the toy's a car,” Lee explains.	0.281633
Vedúci experimentu potom v záujme vedy použije lož a odíde z miestnosti pod zámienkou vymysleného telefonátu. ~~~ Dieťa požiada, aby sa nepozrelo, o akú hračku ide.	The experimenter leaves the room on the pretext of taking a phone call—a lie for the sake of science—and asks the child not to peek at the toy.	0.0534985
Po návrate do miestnosti sa spýta dieťaťa na odpoveď a nadviaže ďalšou otázkou: Pozrel si sa alebo nie?	Returning, the experimenter asks the child for the answer, following up with the question: Did you peek or not?	0.275862
Frank Abagnale Jr. klamal za účelom osobného zisku. ~~~ V súčasnosti je uznávaným bezpečnostným poradcom, ale bezočivé podvody z jeho minulosti inšpirovali tvorcov filmu z roku 2002 s názvom Chyť ma, ak to dokážeš.	Lying for personal gain Frank Abagnale, Jr., is now a highly regarded security consultant, but his brazen deceptions earlier in life inspired the 2002 movie Catch Me if You Can.	0.61906
Leonardo DiCaprio v ňom hral Abagnala, ktorý v šestnástich rokoch ušiel z domu a naučil sa na prežitie využívať svoj dôvtip. ~~~ Stal sa z neho falšovateľ šekov, podvodník a imitátor.	Leonardo DiCaprio played Abagnale, who ran away from home at 16 and learned to survive by his wits, becoming a check forger, con man, and impostor.	0.178831
Musel som byť kreatívny, aby som prežil, povedal.	I had to be creative in order to survive,” he says.	0.292857
Mrzí ma to a budem to ľutovať po zvyšok môjho života.	I do and will continue to regret it for the rest of my life.	0.522727
Abagnale sa vydával za pilota, pediatra a právnika s titulom z Harvardovej univerzity.	Abagnale masqueraded as a pilot, a pediatrician, and an attorney with a Harvard law degree.	0.716571
Lee a jeho kolegovia monitorovaním skrytých kamier zistili, že väčšina detí nedokáže odolať a na hračku sa pozrie.	Most children can't resist peeking, Lee and his researchers have found by monitoring hidden cameras.	0.449569
Percento detí, ktoré hračku odkryjú a následne klamú, závisí od ich veku.	The percentage of the children who peek and then lie about it depends on their age.	0.271429
Spomedzi dvojročných previnilcov klame len 30 percent.	Among two-year-old transgressors, only 30 percent are untruthful.	4.36378
Z trojročných detí klame 50 percent.	Among three- year-olds, 50 percent lie.	4.98616
Keď už majú osem rokov, asi 80 percent tvrdí, že sa na hračku nepozrelo.	And by eight, about 80 percent claim they didn't peek.	3.48142
Deti sa s pribúdajúcim vekom v klamaní aj zlepšujú.	Kids also get better at lying as they get older.	0.27
Pri hádaní hračky, na ktorú sa tajne pozreli, troj až štvorročné deti zvyčajne vyhŕknu správnu odpoveď a neuvedomujú si, že tým odhaľujú svoj prehrešok a klamstvo.	In guessing the toy that they secretly looked at, three- and four-year-olds typically blurt out the right answer, without realizing that this reveals their transgression and lying.	0.265468
Vo veku sedem alebo osem rokov sa deti naučia maskovať svoje klamstvo tak, že odpovedajú nesprávne alebo sa snažia, aby ich odpoveď pôsobila ako racionálny odhad.	At seven or eight, kids learn to mask their lying by deliberately giving a wrong answer or trying to make their answer seem like a reasoned guess.	0.257851
Päť a šesťročné deti spadajú do kategórie niekde uprostred.	Five- and six-year-old kids fall in between.	0.2
V jednej štúdii Lee použil ako hračku fialového dinosaura Barneyho.	In one study Lee used Barney the dinosaur as the toy.	0.470455
Päťročné dievča, ktoré poprelo, že sa na hračku pozrelo, mu povedalo, že sa chce hračky dotknúť pred tým, ako bude hádať.	A five-year-old girl who denied having looked at the toy, which was hidden under a cloth, told Lee she wanted to feel it before guessing.	0.264706
Dala teda ruku pod látku, zavrela oči a povedala: Ah, viem, že to je Barney, spomína Lee.	So she puts her hand underneath the cloth, closes her eyes, and says, Ah, I know it's Barney,‟ Lee recounts.	0.401802
Spýtal som sa jej, ako to vie a ona odpovedala: Pretože je na dotyk fialový.	I ask, Why?‟ She says, Because it feels purple.	0.1275
Toto zvýšenie sofistikovanosti v klamaní je spôsobené vývojom schopnosti dieťaťa vcítiť sa do kože niekoho iného.	What drives this increase in lying sophistication is the development of a child's ability to put himself or herself in someone else's shoes.	0.239394
Túto zručnosť známu ako teória mysle si osvojujeme pre porozumenie názorov, zámerov a poznatkov iných.	Known as theory of mind, this is the facility we acquire for understanding the beliefs, intentions, and knowledge of others.	0.242697
Pre schopnosť klamať je tiež nevyhnutná výkonná funkcia mozgu, teda schopnosti potrebné pre plánovanie, pozornosť a sebakontrolu.	Also fundamental to lying is the brain's executive function: the abilities required for planning, attention, and self-control.	0.291892
Dvojročné deti, ktoré v Leeho experimentoch klamali, dosiahli lepšie výsledky v testoch teórie mysle a výkonnej funkcie ako tie, ktoré neklamali.	The two-year-olds who lied in Lee's experiments performed better on tests of theory of mind and executive function than those who didn't.	0.276923
Dokonca aj deti vo veku 16 rokov, ktoré boli zdatnými klamármi, prekonali zlých klamárov.	Even at 16, kids who were proficient liars outperformed poor liars.	0.201724
Na druhej strane deti s poruchou autistického spektra, o ktorých je známe, že majú oneskorený vývoj bohatej teórie mysle, nie sú veľmi dobrými klamármi.	On the other hand, kids on the autism spectrum—known to be delayed in developing a robust theory of mind—are not very good at lying.	0.245455
Valerie Plameová klamala pre vlasť. ~~~ Táto bývalá agentka CIA pracovala v utajení viac ako dvadsať rokov.	Lying for country Valerie Plame, a former CIA agent, worked undercover for two decades.	0.093
V roku 2003, keď administratíva prezidenta Busha uverejnila jej meno v novinách, bola odhalená. ~~~ Jej utajovaná kariéra sa skočila.	In 2003 her cover was blown and her clandestine career ended when Bush Administration officials leaked her name to a newspaper columnist.	-0.00394737
Spolu so svojím manželom tvrdia, že to bola odplata za jeho tvrdenia, že Biely dom zveličoval informácie tajnej služby, aby odôvodnil inváziu v Iraku.	She and her husband say it was done in retribution for his claim that the White House had exaggerated intelligence to justify the invasion of Iraq.	0.407805
Čo sa naučila počas svojej práce špiónky?	What lesson did she take away from her years as a spy?	0.233333
Väčšinou sú ľudia veľmi ochotní o sebe rozprávať, povedala.	Most people,” she says, are more than willing to talk about themselves.	0.248077
Nedávno som si jedno ráno zavolal Uber na stretnutie s Danom Arielym, psychológom na Univerzite Duke, ktorý je jedným z popredných svetových expertov na klamstvo.	On a recent morning, I took an Uber to visit Dan Ariely, a psychologist at Duke University and one of the world‟s foremost experts on lying.	0.355902
Taxík zvnútra pôsobil čisto, no ja som v ňom cítil smrad z ponožiek, a hoci bola šoférka zdvorilá, mala problém nájsť cestu.	The inside of the car, though neat, had a strong odor of sweaty socks, and the driver, though courteous, had trouble finding her way.	0.410242
Keď sme konečne dorazili, s úsmevom sa ma spýtala, či jej dám hodnotenie päť hviezdičiek.	When we finally got there, she asked me smilingly if I would give her a five-star rating.	0.291892
Samozrejme, odpovedal som.	Sure,” I replied.	0.13125
Neskôr som jej dal tri hviezdičky.	Later, I gave her three stars.	0.253846
Svoje výčitky som umlčal tým, že som si povedal, že je to lepšie ako uviesť do omylu tisíce zákazníkov Uberu.	I assuaged my guilt by telling myself that it was better not to mislead thousands of Uber riders.	0.420858
Arielyho začala neúprimnosť fascinovať asi pred 15 rokmi.	Ariely became fascinated with dishonesty about 15 years ago.	3.9549
Počas diaľkového letu natrafil v magazíne na test mentálnej spôsobilosti.	Looking through a magazine on a long-distance flight, he came across a mental aptitude test.	0.235385
Odpovedal na prvú otázku a skontroloval svoju odpoveď v zozname správnych odpovedí v zadnej časti magazínu.	He answered the first question and flipped to the key in the back to see if he got it right.	0.222973
Prichytil sa pri tom, že rýchlo nahliadol aj na odpoveď na nasledujúcu otázku.	He found himself taking a quick glance at the answer to the next question.	0.275806
Ariely takýmto štýlom pokračoval počas celého testu a niet divu, že dosiahol veľmi dobrý výsledok.	Continuing in this vein through the entire test, Ariely, not surprisingly, scored very well.	0.28125
Keď som skončil, pomyslel som si, že som sa podviedol, povedal.	When I finished, I thought—I cheated myself,” he says.	0.255319
Podľa všetkého som sa chcel dozvedieť, aký som múdry, ale chcel som to aj sám sebe dokázať.	Presumably, I wanted to know how smart I am, but I also wanted to prove I'm this smart to myself.	0.454825
Táto skúsenosť bola začiatkom Arielyho celoživotného záujmu o štúdium klamstva a iných foriem nečestnosti.	The experience led Ariely to develop a lifelong interest in the study of lying and other forms of dishonesty.	0.493478
V experimentoch, ktoré viedol so svojimi kolegami na vysokých školách a iných miestach, dobrovoľníci dostanú test s 20 jednoduchými matematickými úlohami.	In experiments he and his colleagues have run on college campuses and elsewhere, volunteers are given a test with 20 simple math problems.	2.02657
Musia ich za päť minút vyriešiť čo najviac a sú platení na základe toho, koľko ich vyriešia správne.	They must solve as many as they can in five minutes and are paid based on how many they get right.	0.281013
Dostanú inštrukcie, že majú papier s odpoveďami hodiť do stroja na skartovanie pred tým, ako nahlásia počet svojich správnych odpovedí.	They are told to drop the sheet into a shredder before reporting the number they solved correctly.	0.177108
Ich odpovede sa však v skutočnosti neskartujú.	But the sheets don't actually get shredded.	0.276316
Ukázalo sa, že veľa dobrovoľníkov klame.	A lot of volunteers lie, as it turns out.	0.282353
Dobrovoľníci v priemere nahlasujú šesť vyriešených príkladov, keď to v skutočnosti boli skôr štyri.	On average, volunteers report having solved six matrices, when it was really more like four.	0.26962
Aj testovaním rôznych kultúr dosiahli vždy podobné výsledky.	The results are similar across different cultures.	0.24
Väčšina z nás klame, ale iba trochu.	Most of us lie, but only a little.	0.267857
Otázka, ktorá Arielyho zaujíma, nie je prečo toľko ľudí klame, ale skôr to, prečo neklamú oveľa viac.	The question Ariely finds interesting is not why so many lie, but rather why they don't lie a lot more.	0.296471
Dokonca aj keď sa výrazne zvýši hodnota finančnej odmeny za správne odpovede, nezvýši sa u dobrovoľníkov miera podvádzania.	Even when the amount of money offered for correct answers is raised significantly, the volunteers don't increase their level of cheating.	0.269159
Tu dávame ľuďom šancu ukradnúť veľa peňazí a oni podvádzajú len trochu.	Here we give people a chance to steal lots of money, and people cheat only a little bit.	0.476671
Takže nám, alebo aspoň väčšine z nás, niečo bráni klamať naplno, hovorí Ariely.	So something stops us— most of us—from not lying all the way,” Ariely says.	0.27619
Dôvodom podľa neho je, že si chceme o sebe myslieť, že sme poctiví, pretože sme sa do istej miery stotožnili s poctivosťou ako dobrou vlastnosťou, ktorej nás učí spoločnosť.	The reason, according to him, is that we want to see ourselves as honest, because we have, to some degree, internalized honesty as a value taught to us by society.	0.275556
Preto pokiaľ človek nie je sociopat, väčšina z nás neprekračuje istú hranicu v tom, koľko sme ochotní klamať.	Which is why, unless one is a sociopath, most of us place limits on how much we are willing to lie.	0.25125
Ariely a iní dokázali, že to, ako ďaleko sme ochotní zájsť závisí od spoločenských noriem, ku ktorým sme dospeli na základe nevysloveného konsenzu, akým je napríklad nepísané pravidlo, že zobrať domov pár ceruziek zo skrinky na kancelárske potreby v práci je akceptovateľné.	How far most of us are willing to go—Ariely and others have shown—is determined by social norms arrived at through unspoken consensus, like the tacit acceptability of taking a few pencils home from the office supply cabinet.	0.307519
Apollo Robbins a Ava Doová klamú pre zábavu iných. Títo partneri v manželstve aj biznise používajú triky na pobavenie a poučenie.	Lying to entertain Apollo Robbins and Ava Do, who are married and business partners, use sleight of hand to entertain and educate.	0.709091
Robbins je ohromne vrtký vreckový zlodej, ktorý sa preslávil tým, že vyprázdnil vrecká agentov tajnej služby prezidentovej ochranky.	Robbins is an astonishingly agile pickpocket, perhaps best known for emptying the pockets of some Secret Service agents on a presidential detail.	0.434619
Doová je kúzelníčka, ktorá študovala psychobiológiu.	Do is a magician who has studied psychobiology.	0.24878
Podvody vnímame ako snahu skresliť niekoho vnímanie reality, tvrdia.	We think of deception as the intent to distort someone's perception of reality,” they say.	0.221311
Je to nestranný prostriedok, ktorý môže byť využitý na dobro alebo zlo, s cieľom informovať alebo uviesť do omylu.	It is an impartial tool that can be used for good or bad, to inform or mislead.	0.311979
Zamestnanci a kolegovia Patricka Couwenberga, sudcu Najvyššieho okresného súdu Los Angeles verili, že je americkým hrdinom.	Patrick Couwenberg's staff and fellow judges in the Los Angeles County Superior Court believed he was an American hero.	0.632353
Podľa jeho tvrdení získal vo Vietname cenu Purpurového srdca.	By his account, he had been awarded a Purple Heart in Vietnam.	0.288462
Podieľal sa na tajných operáciách spravodajskej služby CIA.	He'd participated in covert operations for the Central Intelligence Agency.	0.220755
Sudca sa vychvaľoval aj obdivuhodným vzdelaním, bakalárskym titulom z fyziky a magisterským titulom z psychológie.	The judge boasted of an impressive educational background as well—an undergraduate degree in physics and a master's degree in psychology.	0.434035
Nič z toho nebola pravda.	None of it was true.	0.211765
Keď ho odhalili, Couwenberg sa bránil tým, že za svoje klamstvá vinil poruchu zvanú pseudologia fantastica, čo je sklon rozprávať príbehy obsahujúce fakty poprepletané s výplodmi fantázie.	When confronted, Couwenberg's defense was to blame a condition called pseudologia fantastica, a tendency to tell stories containing facts interwoven with fantasy.	0.516503
Tento argument ho nezachránil pred pozastavením výkonu funkcie sudcu v roku 2001.	The argument didn't save him from being removed from the bench in 2001.	0.706538
Zdá sa, že psychiatri sa nezhodujú v probléme vzťahu medzi psychickým zdravím a klamaním, aj keď u ľudí s určitými psychickými poruchami sa prejavujú isté špecifické druhy klamania.	There appears to be no agreement among psychiatrists about the relationship between mental health and lying, even though people with certain psychiatric disorders seem to exhibit specific lying behaviors.	0.257419
Jedinci trpiaci sociopatiou s diagnostikovanou asociálnou poruchou osobnosti zvyknú používať manipulatívne lži, zatiaľ čo ľudia s narcizmom využívajú klamstvá na posilnenie svojho imidžu.	Sociopathic individuals—those diagnosed with antisocial personality disorder—tend to tell manipulative lies, while narcissists may tell falsehoods to boost their image.	0.268
Je však na mozgoch tých, ktorí klamú, viac ako ostatní niečo výnimočné?	But is there anything unique about the brains of individuals who lie more than others?	0.240984
V roku 2005 psychologička Yaling Yangová a jej kolegovia porovnali snímky mozgu troch skupín ľudí. ~~~ Bolo to 12 dospelých so zvykom opakovane klamať, 16 osôb s príznakmi asociálnej poruchy osobnosti bez zvyku často klamať a 21 osôb bez asociálnej poruchy a zvyku klamať.	In 2005 psychologist Yaling Yang and her colleagues compared the brain scans of three groups: 12 adults with a history of repeated lying, 16 who met the criteria for antisocial personality disorder but were not frequent liars, and 21 who were neither antisocial nor had a lying habit.	0.252725
Vedci zistili, že klamári majú aspoň o 20 percent väčší objem nervových vláken v prefrontálnej mozgovej kôre, čo naznačuje, že ľudia so zvykom klamať majú väčšiu konektivitu mozgu.	The researchers found that the liars had at least 20 percent more neural fibers by volume in their prefrontal cortices, suggesting that habitual liars have greater connectivity within their brains.	1.51216
Je možné, že toto predurčuje ich klamstvá, pretože ich dokážu vymýšľať pohotovejšie ako iní, alebo to môže byť výsledkom opakovaného klamania.	It's possible this predisposes them to lying because they can think up lies more readily than others, or it might be the result of repeated lying.	0.433905
Daniel Negreanu klame, aby získal strategickú výhodu. ~~~ Na cenách zo súťaží už zarobil viac ako 32 miliónov dolárov.	Lying for strategic advantage Raking in more than $32 million in tournament prizes, Daniel Negreanu has won more money than anyone in poker history.	0.13125
Vyhral najviac peňazí v histórii pokru. ~~~ Presťahoval sa z Kanady do Las Vegas pred dvadsiatimi rokmi a stal sa hviezdou. ~~~ Precestoval svet ako veľvyslanec pokru a objavil sa v nespočetných televíznych programoch.	The Canadian-born superstar, who moved to Las Vegas 20 years ago, has traveled the world as an ambassador of the game and appeared on countless televised shows.	-0.0681592
Ak chcete vyhrať v pokri, podvod je jednoznačne nevyhnutný, povedal.	If you want to win at poker,” he says, deception is absolutely necessary.	0.29
Problém podľa neho nastáva až vtedy, keď hráči trávia toľko času podvádzaním súperov, že sa to prenesie do ich osobného života.	The trouble comes, he says, when players spend so much time deceiving competitors that it infiltrates their personal life.”	0.29434
Psychológovia Nobuhito Abe z Kjótskej univerzity a Joshua Greene z Harvardovej univerzity snímali mozgy subjektov pomocou funkčného zobrazovania magnetickou rezonanciou (fMRI). ~~~ Zistili, že tí, ktorí sa správali nečestne, vykazovali vyššiu aktivitu v časti zvanej nucleus accumbens, čo je štruktúra v bazálnom prednom mozgu, ktorá zohráva dôležitú úlohu v takzvanom systéme odmeny.	Psychologists Nobuhito Abe at Kyoto University and Joshua Greene at Harvard University scanned the brains of subjects using functional magnetic resonance imaging (fMRI) and found that those who acted dishonestly showed greater activation in the nucleus accumbens—a structure in the basal forebrain that plays a key role in reward processing.	0.210973
Čím viac je váš systém odmien nadšený z možnosti získať peniaze dokonca aj úplne čestným spôsobom, tým je pravdepodobnejšie, že budete podvádzať, vysvetlil Greene.	The more excited your reward system gets at the possibility of getting money—even in a perfectly honest context—the more likely you are to cheat,” explains Greene.	0.415683
Inými slovami, chamtivosť môže zvýšiť náchylnosť človeka klamať.	In other words, greed may increase one's predisposition to lying.	0.294737
Jedna lož môže viesť k ďalším a ďalším, ako to dokázali bezproblémové a neľútostné klamstvá sériových podvodníkov ako Hogue.	One lie can lead to another and another, as evidenced by the smooth, remorseless lying of serial con men such as Hogue.	0.575758
Experiment Tali Sharotovej, neurovedkyne na Londýnskej univerzite UCL a jej kolegov ukázal, ako si mozog zvyká na stres a emocionálne nepohodlie vyvolané klamaním, čím sa budúce klamstvá stávajú jednoduchšími.	An experiment by Tali Sharot, a neuroscientist at University College London, and colleagues showed how the brain becomes inured to the stress or emotional discomfort that happens when we lie, making it easier to tell the next fib.	0.48022
V fMRI snímkach subjektov sa ich tím sústredil na amygdalu, čo je oblasť mozgu spojená so spracovaním emócií.	In the fMRI scans of the participants, the team focused on the amygdala, a region that is involved in processing emotions.	0.425637
Vedci zistili, že reakcia amygdaly pri každej lži postupne slabla, aj keď sa klamstvá zväčšovali.	The researchers found that the amygdala's response to lies got progressively weaker with each lie, even as the lies got bigger.	0.214286
Možno malé podvody môžu viesť k väčším, povedala.	Perhaps engaging in small acts of deception can lead to bigger acts of deception,” she says.	0.055814
Tajnostkársky umelec známy ako Zardulu, ktorý len málokedy prezrádza svoje tajomstvá, klame v záujme príbehu. ~~~ Zinscenoval niektoré z najznámejších videí a fotografií na internete.	Lying to tell stories Some of the Internet's most viral videos and photographs have been staged by a secretive artist known as Zardulu, who rarely reveals the fabrications.	0.0803938
Ako všetky mýty, aj tie moje majú vyvolať údiv nad svetom. ~~~ Majú uviesť do perspektívy naše doterajšie vnímanie a chápanie bytia, povedal Zardulu.	Like all myths,” Zardulu says, mine are established to engender a sense of wonder about the world, to counter our perceived mastery and understanding of it.	0.0048583
Na fotografii má Zardulu nasadenú baraniu hlavu, čo symbolizuje cestu do podvedomia, zatiaľ čo vykladač záhad hierofant (veľkňaz) reprezentuje tieňové ja.	Zardulu appears wearing a ram's head, symbolizing a journey into the unconscious mind, while the hierophant, an interpreter of mysteries, represents the shadow self.	0.418586
Väčšina vedomostí, pomocou ktorých sa orientujeme vo svete, pochádza od iných ľudí.	Much of the knowledge we use to navigate the world comes from what others have told us.	0.295833
Bez implicitnej dôvery, ktorú vkladáme do ľudskej komunikácie, by sme boli ako jednotlivci paralyzovaní a neschopní udržiavať sociálne vzťahy.	Without the implicit trust that we place in human communication, we would be paralyzed as individuals and cease to have social relationships.	0.290083
Z dôvery veľa získame a keď sme občas oklamaní, spôsobí to relatívne málo škody, povedal Tim Levine, psychológ na Alabamskej univerzite v Birminghame, ktorý túto myšlienku nazýva teória automatickej pravdy.	We get so much from believing, and there's relatively little harm when we occasionally get duped,” says Tim Levine, a psychologist at the University of Alabama at Birmingham, who calls this idea the truth default theory.	0.576839
Sme nastavení dôverovať ľuďom a to nás robí v našej podstate naivnými.	Being hardwired to be trusting makes us intrinsically gullible.	0.578571
Ak niekomu poviete, Som pilot´, nebude sedieť a rozmýšľať ,Možno nie je pilot´. ~~~ Prečo by povedal, že je pilot?	If you say to someone, I am a pilot,‟ they are not sitting there thinking: Maybe he's not a pilot.	0.0806723
Ľudia tak nerozmýšľajú, povedal Frank Abagnale ml., bezpečnostný poradca, ktorého podvody z mladosti vrátane falšovania šekov a vydávania sa za pilota lietadla inšpirovali tvorcov filmu z roku 2002 s názvom Chyť ma, ak to dokážeš.	Why would he say he's a pilot? ‟They don't think that way,” says Frank Abagnale, Jr., a security consultant whose cons as a young man, including forging checks and impersonating an airline pilot, inspired the 2002 movie Catch Me if You Can.	1.37876
Podvody fungujú preto, že keď niekomu zazvoní telefón a ID volajúceho je Úrad pre daňovú správu, ľudia tomu automaticky veria.	This is why scams work, because when the phone rings and the caller ID says it's the Internal Revenue Service, people automatically believe it is the IRS.	0.384524
Neuvedomujú si, že ID volajúceho sa dá zmanipulovať.	They don't realize that someone could manipulate the caller ID.	0.241304
Robert Feldman, psychológ z Massachusettskej univerzity to nazýva výhodou klamára.	Robert Feldman, a psychologist at the University of Massachusetts, calls that the liar's advantage.	0.792752
Ľudia klamstvá neočakávajú, nevyhľadávajú ich, povedal, a často chcú počuť to, čo počujú.	People are not expecting lies, people are not searching for lies,” he says, and a lot of the time, people want to hear what they are hearing.	0.368132
Klamstvám, ktoré nám robia radosť alebo nás utešujú, kladieme len malý odpor. ~~~ Či už je to falošná chvála alebo prísľub neuveriteľne vysokej návratnosti investícií.	We put up little resistance to the deceptions that please us and comfort us—be it false praise or the promise of impossibly high investment returns.	0.0153846
Keď nás klamstvami kŕmia ľudia, ktorí majú bohatstvo, moc a spoločenské postavenie, zdá sa, že ich ľahšie prijímame, čo sa dokázalo aj tým, aké dôverčivé boli médiá v prípade Lochteho tvrdení o lúpeži, ktoré sa krátko nato objasnilo.	When we are fed falsehoods by people who have wealth, power, and status, they appear to be even easier to swallow, as evidenced by the media's credulous reporting of Lochte's robbery claim, which unraveled shortly thereafter.	0.290576
Vedci preukázali, že sme obzvlášť náchylní akceptovať klamstvá, ktoré potvrdzujú naše názory.	Researchers have shown that we are especially prone to accepting lies that affirm our worldview.	0.3
Pre túto našu náchylnosť meme obrázky, ktoré tvrdia, že Obama sa nenarodil v Spojených štátoch, popierajú klimatickú zmenu, obviňujú vládu USA zo zosnovania teroristických útokov z 11. septembra 2001 a šíria rôzne iné alternatívne fakty, ako Trumpov poradca nazval jeho tvrdenia o inauguračnom dave, na internete a sociálnych sieťach prekvitajú.	Memes that claim Obama was not born in the United States, deny climate change, accuse the U. S. government of masterminding the terrorist strikes of September 11, 2001, and spread other alternative facts,” as a Trump adviser called his Inauguration crowd claims, have thrived on the Internet and social media because of this vulnerability.	0.407194
George Lakoff, kognitívny lingvista z Kalifornskej univerzity v Berkeley, tvrdí, že ich vyvracaním sa neznižuje ich sila, pretože ľudia posudzujú dôkazy, ktoré sú im poskytnuté v rámci už existujúcich názorov a predsudkov.	Debunking them does not demolish their power, because people assess the evidence presented to them through a framework of preexisting beliefs and prejudices, says George Lakoff, a cognitive linguist at the University of California, Berkeley.	0.547727
Ak sa k vám dostane fakt, ktorý nezapadá do vášho rámca, buď si ho nevšimnete, ignorujete ho, vysmievate sa mu, alebo vás zmätie.	If a fact comes in that doesn't fit into your frame, you'll either not notice it, or ignore it, or ridicule it, or be puzzled by it—or attack it if it's threatening.	0.225
Jayson Blair klamal v záujme osobného zisku. ~~~ Tento životný poradca sa snaží pomôcť ľuďom definovať a dosiahnuť ich ciele.	Lying for professional gain Jayson Blair is a life coach, seeking to help people define and achieve their goals.	0.159615
V minulosti bol úspešným reportérom pre noviny New York Times. ~~~ Jeho kariéra stroskotala, keď sa v roku 2003 zistilo, že vykonštruoval a plagizoval materiály v niekoľkých svojich článkoch.	Before that, he was a fast-rising New York Times reporter whose career imploded in 2003 when he was discovered to have fabricated and plagiarized material in dozens of articles.	0.889035
Najprv som zakrýval klamstvá iných, potom som sa sám stal klamárom. ~~~ Nakoniec som začal hľadať odpovede na to, prečo som klamal a prečo to isté robia aj iní, povedal.	My world went from one in which I covered the deception of others to being the one doing the deception,” he says, and eventually, searching for answers to questions about why I lied and why others do so as well.	-0.0353571
Nedávna štúdia pod vedením Briony Swire-Thompsonovej, doktorandky kognitívnej psychológie Univerzity Západnej Austrálie dokumentuje, že pri vyvracaní nesprávneho presvedčenia sú informácie založené na dôkazoch neefektívne.	A recent study led by Briony Swire-Thompson, a doctoral candidate in cognitive psychology at the University of Western Australia, documents the ineffectiveness of evidence-based information in refuting incorrect beliefs.	0.409119
V roku 2015 Swire-Thompsonová a jej kolegovia predložili približne 2 000 dospelým Američanom jedno z dvoch tvrdení: Vakcíny spôsobujú autizmus alebo Donald Trump povedal, že vakcíny spôsobujú autizmus. (Trump opakovane naznačoval, že tu existuje prepojenie, a to aj napriek nedostatku vedeckých dôkazov.)	In 2015 Swire-Thompson and her colleagues presented about 2, 000 adult Americans with one of two statements: Vaccines cause autism” or Donald Trump said that vaccines cause autism.” (Trump has repeatedly suggested there's a link, despite the lack of scientific evidence for it. )	0.684427
Ako sa dalo čakať, účastníci, ktorí boli Trumpovými priaznivcami rozhodne dezinformácii verili viac, keď bola spojená s jeho menom.	Not surprisingly, participants who were Trump supporters showed a decidedly stronger belief in the misinformation when it had Trump's name attached to it.	0.25
Potom účastníci dostali krátke vysvetlenie, ktoré sa odvolávalo na rozsiahlu štúdiu o tom, prečo je spojenie medzi vakcínami a autizmom nepravdivé, a mali prehodnotiť svoj názor.	Afterward the participants were given a short explanation—citing a large-scale study—for why the vaccine-autism link was false, and they were asked to reevaluate their belief in it.	0.518326
Účastníci z celého politického spektra vtedy uznali, že tvrdenia o ich spojitosti sú nepravdivé, ale ich ďalším testovaním o týždeň neskôr sa ukázalo, že ich dôvera v túto dezinformáciu sa vrátila takmer do pôvodného stavu.	The participants—across the political spectrum—now accepted that the statements claiming the link were untrue, but testing them again a week later showed that their belief in the misinformation had bounced back to nearly the same level.	0.281053
Ďalšie štúdie preukázali, že dôkazy, ktoré klamstvá podkopávajú, môžu mať v skutočnosti opačný účinok.	Other studies have shown that evidence undermining lies may in fact strengthen belief in them.	0.266667
Ľudia majú sklon veriť, že informácie, ktoré sú im povedomé, sú pravdivé.	People are likely to think that familiar information is true.	0.243396
Takže zakaždým, keď ich popriete, riskujete, že sa tým stanú viac povedomé, čo z dlhodobého hľadiska ironicky znižuje efektívnosť ich popretia, tvrdí Swire-Thompsonová.	So any time you retract it, you run the risk of making it more familiar, which makes that retraction actually less effective, ironically, over the long term,” says Swire-Thompson.	0.289796
Tento jav som zažil na vlastnej koži krátko po rozhovore so Swire-Thompsonovou.	I experienced this phenomenon firsthand not long after I spoke to Swire-Thompson.	0.291304
Keď mi priateľ poslal link článku s rebríčkom 10 najskorumpovanejších politických strán na svete, hneď som ho zdieľal v skupine v aplikácii WhatsApp s asi stovkou kamarátov zo strednej školy v Indii.	When a friend sent me a link to an article ranking the 10 most corrupt political parties in the world, I promptly posted it to a WhatsApp group of about a hundred high school friends from India.	1.46295
Dôvodom môjho entuziazmu bolo, že na štvrtom mieste v rebríčku sa umiestnila Indická kongresová strana, ktorá bola v posledných desaťročiach zapletená do viacerých korupčných škandálov.	The reason for my enthusiasm was that the fourth spot in the ranking was held by India's Congress Party, which in recent decades has been implicated in numerous corruption scandals.	0.282353
Škodoradostne som sa potešil, pretože nie som fanúšikom tejto strany.	I chortled with glee because I'm not a fan of the party.	0.202174
Krátko po zdieľaní článku som však zistil, že rebríček, ktorý zahŕňal politické strany z Ruska, Pakistanu, Číny a Ugandy, nebol založený na žiadnych parametroch.	But shortly after sharing the article, I discovered that the ranking, which included parties from Russia, Pakistan, China, and Uganda, wasn't based on any metrics.	0.297842
Bol vytvorený stránkou s názvom BBC Newspoint, čo znelo ako dôveryhodný zdroj.	It had been done by a site called BBC Newspoint, which sounded like a credible source.	0.743891
Zistil som však, že nemá s Britskou vysielacou spoločnosťou BBC nič spoločné.	But I found out that it had no connection to the British Broadcasting Corporation.	0.286567
Do skupiny som pridal ospravedlnenie s upozornením, že článok bol s najväčšou pravdepodobnosťou falošnou správou.	I posted an apology to the group, noting that the article was in all likelihood fake news.	0.2
To ostatným nezabránilo článok v skupine počas nasledujúceho dňa niekoľkokrát opäť zdieľať.	That didn't stop others from reposting the article to the group several times over the next day.	0.3
Uvedomil som si, že oprava, ktorú som zverejnil, nemala žiadny účinok.	I realized that the correction I'd posted had not had any effect.	0.267273
Preto, že mnoho mojich priateľov súhlasí s mojou antipatiou voči Kongresovej strane, boli presvedčení, že rebríček je pravdivý, a zakaždým, keď ho zdieľali, nevedomky alebo možno zámerne podporovali jeho legitímnosť.	Many of my friends— because they shared my antipathy toward the Congress Party—were convinced the ranking was true, and every time they shared it, they were unwittingly, or perhaps knowingly, nudging it toward legitimacy.	0.298404
Odporovať faktami by bolo zbytočné.	Countering it with fact would be in vain.	0.271875
Ako teda najlepšie zabrániť bleskovému pokroku neprávd v životoch nás všetkých?	What then might be the best way to impede the fleet-footed advance of untruths into our collective lives?	0.218571
Odpoveď nie je jasná.	The answer isn't clear.	0.268421
Technológia otvorila novú dimenziu podvodov, čím vytvorila v 21. storočí novú verziu odvekého konfliktu medzi našou neúprimnosťou a dôverčivosťou.	Technology has opened up a new frontier for deceit, adding a 21st-century twist to the age-old conflict between our lying and trusting selves.	0.430165
Zamrznutá pôda sa zohrieva rýchlejšie, ako sa očakávalo, tým sa mení zemský povrch a uvoľňujú sa uhlíkové plyny, ktoré urýchľujú globálne otepľovanie.	As the frozen ground warms much faster than expected, it’s reshaping the landscape —and releasing carbon gases that fuel global warming.	0.266667
Kráter Batagaika na východe Sibíri, ktorý je široký približne 800 metrov a neustále sa zväčšuje, patrí medzi najväčšie krátery Arktídy.	The Batagaika crater in eastern Siberia, half a mile wide and growing, is the largest of many across the Arctic.	0.51231
Keď permafrost prešpikoval roztopené miesta, pôda sa zrútila a vytvorili sa krátery a jazerá.	As permafrost laced with buried ice thaws, the ground collapses, forming craters or lakes.	0.488462
Zimov starší ako prvý zistil, že v permafroste sa ukrýva oveľa viac uhlíka, než vedci predpokladali.	The elder Zimov first figured out that permafrost stores far more carbon than scientists once thought.	0.469494
Isté množstvo dnes uniká pri zvyšujúcich sa teplotách.	Some of it is now escaping as temperatures rise.	0.24878
S E R G E Y Z I M O V , vyškolený ekológ, odhodil kosť z mamuta srstnatého na kopu.	S E R G E Y Z I M O V , A N ecologist by training, tossed a woolly mammoth bone on the pile.	1.91293
Čupel v blate pri chladnej širokej rieke Kolyma, pod vysokým rozpadajúcim sa útesom.	He was squatting in mud along the cool, wide Kolyma River, below a towering cliff of crumbling earth.	0.250685
Vo východnej Sibíri, ďaleko za Severným polárnym kruhom, v časti Ruska, ktorá je bližšie k Aljaške než Moskve, bolo leto.	It was summer in eastern Siberia, far above the Arctic Circle, in that part of Russia that’s closer to Alaska than to Moscow.	0.297087
Nebol tam mráz ani sneh.	There wasn’t a speck of frost or snow in sight.	0.0428571
Napriek tomu na útese Duvanny Yar si rieka Kolyma prehrýzla cestu a odhalila to, čo sa nachádzalo pod povrchom. ~~~ Vrstvu zamrznutej zeme, zvanej aj permafrost, ktorá je hlboká približne 3 kilometre, no rýchlo sa zohrieva.	Yet at this cliff, called Duvanny Yar, the Kolyma had chewed through and exposed what lies beneath: a layer of frozen ground, or permafrost, that is hundreds of feet deep—and warming fast.	0.122872
Konáriky, ďalšie časti rastlín a zvierat z doby ľadovej — čeľuste bizónov, stehenné kosti koní, kosti mamutov — to všetko bolo na pláži, do ktorej sa zabárali Zimove topánky.	Twigs, other plant matter, and Ice Age animal parts—bison jaws, horse femurs, mammoth bones—spilled onto a beach that sucked at Zimov’s boots.	0.368959
Mám rád Duvanny Yar, povedal, keď vyberal fosílie z blata.	I love Duvanny Yar,” he said as he yanked fossils from the muck.	0.554727
Pripomína mi to knihu.	It is like a book.	0.2
Každá strana je príbeh z dejín prírody.	Each page is a story about the history of nature.	0.238235
Zmena klímy píše v oblasti na vrchu planéty s rozlohou asi 15 miliónov kilometrov štvorcových novú kapitolu.	Across nine million square miles at the top of the planet, climate change is writing a new chapter.	0.263855
Arktický permafrost sa netopí postupne tak, ako to predtým predpovedali vedci.	Arctic permafrost isn’t thawing gradually, as scientists once predicted.	0.581538
Jazykom geológov možno povedať, že sa topí takmer zo dňa na deň.	Geologically speaking, it’s thawing almost overnight.	0.269388
Mäknutie a klesanie pôdy aká je aj na Duvanny Yar, odhaľuje pozostatky prastarého života a množstvo uhlíka, ktorý bol celé tisícročia väznený v zamrznutej pôde.	As soils like the ones at Duvanny Yar soften and slump, they’re releasing vestiges of ancient life—and masses of carbon—that have been locked in frozen dirt for millennia.	0.397866
Uhlík sa dostáva do atmosféry v podobe metánu a oxidu uhličitého, a tak urýchľuje zmenu klímy, hoci sa ľudia snažia emisie fosílnych palív znížiť.	Entering the atmosphere as methane or carbon dioxide, the carbon promises to accelerate climate change, even as humans struggle to curb our fossil fuel emissions.	0.26371
Iba hŕstka ľudí sa tejto problematike rozumie lepšie ako Zimov.	Few understand this threat better than Zimov.	0.5625
Ten už desaťročia odhaľuje záhady otepľovania Arktídy z výskumnej stanice, ktorá sa nachádza v základni pre ťažbu zlata v meste Cherskiy, asi tri hodiny plavby motorovým člnom od Duvanny Yar a je na spadnutie.	From a ramshackle research station in the gold-mining outpost of Cherskiy, about three hours by speedboat from Duvanny Yar, he has spent decades unearthing the mysteries of a warming Arctic.	0.562545
Popri tom pomohol vyvrátiť všeobecne platnú myšlienku; predstavu, že ďaleko na severe v staršom období štvrtohôr – pleistocéne – existovala súvislá plocha ľadu a plytkej pôdy posiatej šalviou.	Along the way, he has helped upend conventional wisdom—especially the notion that the far north, back in the Pleistocene ice ages, had been an unbroken desert of ice and thin soils dotted with sage.	0.3
Veľké množstvo fosílií mamutov a iných obrovských pasúcich sa zvierat objavených na útese Duvanny Yar a v okolí Zimovi prezrádza, že Sibír, Aljaška a západná Kanada boli kedysi úrodnými trávnatými pláňami plnými byliniek a vŕb.	Instead, the abundant fossils of mammoths and other large grazers at Duvanny Yar and other sites told Zimov that Siberia, Alaska, and western Canada had been fertile grasslands, rich with herbs and willows.	0.443899
Zima spomalila rozklad odumretých rastlín a zvierat.	As these plants and animals died, the cold slowed their decomposition.	0.210638
Časom ich nanosené bahno pochovalo hlbšie, a tak zostali uväznené v permafroste.	Over time, windblown silt buried them deep, locking them in permafrost.	0.26129
Z toho vyplýva, že arktický permafrost je oveľa bohatší na uhlík, než predtým vedci odhadovali.	The upshot is that Arctic permafrost is much richer in carbon than scientists once thought.	0.472115
Nové objavy poukazujú na to, že z dôvodu otepľovania planéty uhlík uniká rýchlejšie.	Now new discoveries suggest that the carbon will escape faster as the planet warms.	0.291549
Vedci sa pre nepredpokladanú rýchlosť otepľovania Arktídy a znepokojujúci spôsob pohybu vody z roztopených častí cez polárnu krajinu domnievajú, že zvýšenie priemernej zemskej teploty o 1 °C môže prepustiť také množstvo emisií uhlia, oleja a zemných plynov, ktoré sa rovná množstvu prepusteného za 4 až 6 rokov. ~~~ To je dvojnásobne až trojnásobne viac než pôvodne odhadované množstvo.	From the unexpected speed of Arctic warming and the troubling ways that meltwater moves through polar landscapes, researchers now suspect that for every one degree Celsius rise in Earth’s average temperature, permafrost may release the equivalent of four to six years’ worth of coal, oil, and natural gas emissions— double to triple what scientists thought a few years ago.	0.00305451
Ak neobmedzíme spotrebu fosílnych palív, permafrost sa stane takým obrovským zdrojom skleníkových plynov, akým je dnes Čína – najväčší producent emisií.	Within a few decades, if we don’t curb fossil fuel use, permafrost could be as big a source of greenhouse gases as China, the world’s largest emitter, is today.	0.436364
Do úvahy to však veľmi neberieme.	We aren’t accounting for that.	0.277778
Medzivládny panel pre zmenu klímy (IPCC) sa iba nedávno začal zaoberať problematikou permafrostu.	The UN’s Intergovernmental Panel on Climate Change has only recently started incorporating permafrost into its projections.	0.219767
Vážnosť prítomnosti uhlíka v permafroste sa stále podceňuje.	It still underestimates just how wide Pandora’s freezer could swing open—and how much havoc that could unleash.	0.0666667
Je to akási Pandorina skrinka, ktorej otvorenie môže spôsobiť veľký chaos.	Permafrost’s potential to warm the planet is dwarfed by our own.	0.495455
Vplyv permafrostu na otepľovanie planéty je v porovnaní s vplyvom ľudskej činnosti zanedbateľný.		-0.3
Aby sme prebrali zodpovednosť za stále prebiehajúce otepľovanie, pravdepodobne budeme musieť znížiť emisie o 8 rokov skôr, ako to naznačovali odhady IPCC. Poukazuje na to nový výskum. Predtým však musíme zmierniť otepľovanie na 2 °C, na čom sa dohodlo aj 195 krajín na parížskej konferencii v roku 2015.	But if we hope to limit warming to two degrees Celsius, as 195 nations agreed to during the 2015 Paris talks, new research suggests we may have to cut emissions eight years sooner than IPCC models project, just to account for the thawing that will be going on.	0.423393
Prečo rýchlejšie prejsť na využívanie čistej energie si však málo uvedomujeme. ~~~ Na dosiahnutie cieľa v boji proti otepľovaniu bude potrebné rozhodovať sa rýchlejšie než si myslíme.	It is perhaps our least appreciated reason to hasten a transition to cleaner energy: To reach whatever goal we set to combat warming, we’ll need to move even faster than we think.	-0.00805369
Zimov prvýkrát prišiel na výskumnú stanicu Cherskiy v 70. rokoch, aby pomohol pri mapovaní expedície ako vysokoškolák.	Zimov first came to Cherskiy in the 1970s as a college student to help with mapping on an expedition.	0.565476
Zbožňoval drsnú krajinu a samotu, takisto aj vzdialenosť od sovietskych energetických centier.	He loved the stark landscape and isolation and remoteness from Soviet power centers.	0.254795
Temné zimy mu poskytovali čas na premýšľanie.	The dark winters promised time to think.	0.257143
Opäť sa sem vrátil o pár rokov neskôr a pod záštitou Ruskej akadémie vied založil severovýchodnú výskumnú stanicu (Northeast Science Station).	He returned a few years later and founded the Northeast Science Station, at first under the auspices of the Russian Academy of Sciences.	0.551858
Dnes Zimov stanicu vlastní a riadi ju spolu so svojím synom Nikitom.	Today he owns and runs it with his son, Nikita.	0.153846
Pre nedostatok financií musia improvizovať. ~~~ Využívajú hlavne už použité vybavenie.	It’s an improvisational operation run on a shoestring and on secondhand equipment.	-0.00833333
Napriek tomu však stanica láka vedcov z celého sveta, ktorí sa zaujímajú o Arktídu.	But the station attracts Arctic scientists from around the world.	0.226316
Spolu s fotografkou Katie Orlinskou sme sa raz v lete 2018 pridali k Zimovi na chátrajúcu loď, ktorá dodávala zásoby zariadeniu monitorujúcemu uhlík v zálive Ambarchik v blízkosti ústia rieky Kolyma na území Severného ľadového oceánu.	One day in the summer of 2018, photographer Katie Orlinsky and I joined Zimov in an aging boat to ferry supplies to a carbon-monitoring facility at Ambarchik Bay, near the mouth of the Kolyma on the Arctic Ocean.	0.502334
Táto oblasť bola pôvodne tranzitnou stanicou pre väzňov, ktorých prevážali do Stalinových gulagov. ~~~ Všade boli pozostatky z obdobia existencie Sovietskeho zväzu.	The site had originally been occupied by a transit station for prisoners bound for Stalin’s gulags, and Soviet-era relics were everywhere.	-0.0302521
Prekročili sme rozmočený trávnik po chodníku vytvorenom zo starých radiátorov.	We traversed spongy grasses across a walkway fashioned from a string of old steam radiators.	0.261429
Ako sme po ňom kráčali, Zimov s mohutnou hruďou a dlhými bielymi vlasmi schovanými v barete skúmal zem kovovou rukoväťou.	Zimov, bull chested, his long white hair tucked in a beret, probed the ground with a metal shaft as he walked.	0.403297
V poslednom čase to robil veľmi často, aby tak zistil hrúbku tuhého permafrostu.	He’s been doing that a lot lately, to check the depth of the hard permafrost.	0.490848
Permafrost – pôda zamrznutá po celý rok – je pokrytá vrstvou špiny a zvyškami rastlín.	Permafrost—ground that remains frozen year-round—is capped by a few feet of dirt and plant detritus.	0.429966
Táto pôda, tzv. aktívna vrstva, sa v lete roztápa a v zime opäť mrzne. ~~~ Tým sa permafrost chráni pred stúpajúcou vonkajšou teplotou.	Called the active layer, this soil normally thaws each summer and refreezes in winter, protecting permafrost from rising heat above.	0
Avšak na jar roku 2018 Nikitov tím zistil, že povrch zeme v okolí mesta Cherskiy počas dlhej tmavej polárnej noci vôbec nezamrzol.	But in the spring of 2018, a crew working for Nikita found that dirt near the surface around Cherskiy had not iced up at all during the long dark polar night.	0.378617
Bolo to nezvyčajné. Január na Sibíri je taký chladný, že ľudský dych zamŕza a pri tom počuť zvonivý zvuk, ktorý domorodí Jakuti nazývajú šepot hviezd.	That was unheard of: January in Siberia is so brutally cold that human breath can freeze with a tinkling sound that the indigenous Yakuts call the whisper of stars.	0.391763
Sovieti zvykli na Kolyme pristávať s ťažkými lietadlami.	The Soviets used to land heavy planes on the Kolyma.	0.259091
Pôda mala byť zamrznutá do hĺbky 80 centimetrov.	Soil 30 inches down should have been frozen.	0.268421
Namiesto toho bola ako kaša.	Instead it was mush.	0.183333
Pred tromi rokmi namerali nad permafrostom -3 °C, tvrdí Sergey Zimov, potom -2, neskôr -1.	Three years ago, the temperature in the ground above our permafrost was minus 3 degrees Celsius [27 degrees Fahrenheit],” Sergey Zimov said. Then it was minus 2. Then it was minus one.	0.1875
Tento rok sme namerali teplotu 2 °C.	This year, the temperature was plus 2 degrees.	4.3379
Na jednej strane to nie je vôbec prekvapujúce.		-0.3
Od roku 2014 sme zažili päť najteplejších zím.	On one level that’s not surprising.	0.212903
Naposledy sa to stalo v 19. storočí. ~~~ Arktída sa otepľuje minimálne dvakrát rýchlejšie než zvyšok planéty, pretože sa stráca morský ľad, ktorý ju ochladzoval.	Earth’s five warmest years since the late 19th century have come since 2014, and the Arctic is warming more than twice as fast as the rest of the planet, as it loses the sea ice that helps chill it.	-0.0262774
V roku 2017 tundru v Grónsku zachvátil dovtedy najhorší požiar.	In 2017 tundra in Greenland faced its worst known wildfire.	3.27647
Pár dní pred tým, ako sme pristáli na Sibíri, namerali v nórskom meste Lakselv vzdialenom 386 kilometrov za Severným polárnym kruhom neuveriteľných 32 °C.	Days before we landed in Siberia, thermometers in Lakselv, Norway, 240 miles above the Arctic Circle, recorded a blistering 32 degrees Celsius, or 90 degrees Fahrenheit.	0.390455
Soby arktické sa schovávali v cestných tuneloch.	Arctic reindeer hid in road tunnels for relief.	0.285366
Teplota permafrostu globálne stúpa už pol storočia.	Permafrost temperatures globally have been rising for half a century.	0.202174
Teplota v aljašskej oblasti North Slope za posledných 30 rokov stúpla o 6 °C.	On Alaska’s North Slope, they spiked 11 degrees Fahrenheit in 30 years.	0.741866
Topenie permafrostu v určitých lokalitách – hlavne v obciach, v ktorých vývoj narúša povrch a umožňuje prenikanie tepla – narušilo pobrežia, podrylo cesty a školy, spôsobilo popraskanie potrubí a zrútilo ľadové pivnice arktických lovcov na úschovu mrožieho mäsa a veľrybieho tuku.	Localized thawing of permafrost, especially in villages where development disturbs the surface and allows heat to penetrate, has eroded shorelines, undermined roads and schools, cracked pipelines, and collapsed ice cellars where Arctic hunters store walrus meat and bowhead whale blubber.	0.288797
Avšak v roku 2018 Zimovci spozorovali niečo iné. ~~~ Niečo, čo sa týka aj oblasti za Arktídou – zimné topenie.	What the Zimovs were documenting in 2018, though, was something different, with implications beyond the Arctic: a wintertime thaw.	-0.0362637
Paradoxne ho spôsobilo husté sneženie.	The culprit, paradoxically, was heavy snow.	0.265714
Sibír je suchá. ~~~ Počas viacerých zím pred rokom 2018 hrubá vrstva snehu pokryla celý región.	Siberia is dry, but for several winters before 2018, thick snow had smothered the region.	-0.00789474
Sneh pôsobil ako prikrývka, ktorá udržiavala letné teplo v pôde.	The snow acted like a blanket, trapping summer heat in the soil.	0.288889
