Ich počet sa výrazne zvýšil a obidva poddruhy sa v štyroch krajinách môžu loviť legálne.	Its populations have increased significantly, and both of its subspecies are legally hunted in four countries.	0.216
V niektorých častiach Afriky sa žirafám skutočne darí.	And in fact, in some parts of Africa giraffes are doing fine.	0.28125
Na súkromných farmách v Južnej Afrike a Namíbii rastie počet voľne žijúcich živočíchov a žirafy sa v nich legálne lovia. ~~~ V týchto krajinách sa populácia žiráf v posledných desaťročiach takmer zdvojnásobila.	In South Africa and Namibia, where private game farms boost wildlife numbers and giraffes are hunted legally, populations have nearly doubled in recent decades.	-0.0445652
Vo východnej Afrike však sieťovaný a masajský druh však čelí omnoho tragickejšej situácii.	But in East Africa, the reticulated and Masai species of giraffe face a much grimmer outlook.	0.514286
V južnej Keni je príčinou hynutia žiráf oplotenie.	What’s killing giraffes in southern Kenya is fences.	0.286364
Predstavuje dokonca väčšiu hrozbu ako pytliactvo.	They’re an even bigger threat than poaching.	0.253846
Žirafy cez ploty nedokážu preskočiť, ploty rozdeľujú ich životný priestor, hovorí Arthur Muneza, koordinátor nadácie pre zachovanie žiráf pre východnú Afriku.	Giraffes can’t jump over fences, which means their ranges are being fragmented, says Arthur Muneza, the East Africa coordinator of the GCF.	0.522307
Je to práve rast populácie, nadmerná pastva hospodárskych zvierat a zmena podnebia, ktoré pastierov a poľnohospodárov tlačia do divočiny a do prostredia, ktoré patrí žirafám.	Population growth, livestock overgrazing, and climate change are pushing pastoralists and farmers into wildlands and giraffe habitat.	0.216102
Počet jedincov žirafy severnej núbijskej klesol v Ugande za posledných 30 rokov až o 97 %. ~~~ Tento pokles zapríčinil, že sú zaradené medzi najohrozenejšie veľké cicavce na svete.	Meanwhile the population of Nubian giraffes, found mostly in Uganda, has declined by as much as 97 percent over the past 30 years, making them one of the world’s most critically endangered large mammals.	0.871324
Výskyt žiráf na území Nigérie je ešte zriedkavejší. ~~~ V roku 1996 ich bolo len 49, no tento počet sa v západnej Afrike za posledných 25 rokov zvýšil na viac ako 600 jedincov.	The giraffes of Niger are scarcer still, and yet, from a low point of just 49 individuals in 1996, the population of West African giraffes has bounced back to more than 600 in the past two and a half decades.	-0.0270833
Ich návrat sa radí medzi najväčšie ochranárske úspechy na kontinente.	Their return is one of the greatest conservation success stories on the continent.	0.25082
Prinavrátenie žiráf do prírody bolo nepravdepodobné.	It is also one of the most unlikely.	0.12
Nigéria sa v počte úmrtí žiráf zaraďuje na posledné miesto zo 189 krajín v indexe ľudského rozvoja (HDI) OSN. ~~~ Miera predpokladanej dĺžky života, vzdelanie, národný príjem a ochrana voľne žijúcich živočíchov nepatrila do tradičných priorít krajiny.	Niger ranks dead last out of 189 countries on the UN’s Human Development Index— a measure of life expectancy, schooling, and national income—and conserving wildlife had not traditionally been a priority of the country.	0.671739
Po štátnom prevrate v roku 1996 vyslal nový prezident Nigérie Ibrahim Baré Maïnassara do prírody armádu, aby zajala niekoľko zvierat a priniesla ich ako dar prezidentom blízkej Nigérie a štátu Burkina Faso.	In 1996, after a coup d’etat, the new president of Niger, Ibrahim Baré Maïnassara, sent the army into the bush to capture a group of animals to present as gifts to the presidents of nearby Nigeria and Burkina Faso.	0.84375
Ani jedna zo zajatých žiráf tento proces neprežila a počet západných afrických žiráf klesol takmer o tretinu.	Not a single captured giraffe survived the operation, and the population of West African giraffes fell by nearly a third.	0.437943
Ďalšie dve zvieratá zomreli o 3 roky neskôr, po tom, ako sa ich ďalší prezident pokúsil poslať ako dar vodcovi štátu Togo.	Three years later, two more animals died when the next president tried to send a gift to the leader of Togo.	0.392543
Katastrofálna situácia a fakt, že posledné žirafy zo západnej Afriky boli vzácnym a zriedkavým druhom voľne žijúcich živočíchov v krajine, ktorá ich už veľa nemá, viedlo v roku 2011 Nigériu k vytvoreniu prvej národnej stratégie na ochranu žiráf v Afrike.	The dire situation, and the recognition that the last West African giraffes were a precious and rare wildlife resource in a country that has few others, led Niger in 2011 to craft the first national conservation strategy in Africa for protecting giraffes.	1.24982
Vláda zamedzila pytliactvo. ~~~ Populácia žiráf v oblasti Koure sa mohla rozrastať bez akýchkoľvek prírodných predátorov.	With poaching all but quashed by the government and without any natural predators, the population of giraffes in Koure has been able to grow.	0.0394352
Konflikt s pastiermi a poľnohospodármi sa dal očakávať, pretože populácia žiráf narastala o viac ako 11 % ročne.	As the population exploded at a rate of more than 11 percent a year, conflict with farmers and herders seemed inevitable.	2.17599
Zamieril som do neďalekej dediny Kanaré, aby som sa porozprával s miestnym náčelníkom Hamadom Yacoubaom.	A day earlier I’d gone to the nearby village of Kanaré to speak with the local chief, Hamadou Yacouba.	0.278824
Žirafy sa považujú za zdomácnené zvieratá.	Sitting under the bushy canopy of a neem tree to shade us from the midday sun, he explained that giraffes are considered like domesticated animals here.	-0.410526
Boh umiestnil žirafy práve do Afriky, tak s nimi žijeme.	God placed the giraffes here, so we live with them.	0.265116
Dedina Kanaré profitovala zo žirafieho turizmu a z miestneho rozvojového fondu, ktorý založili medzinárodní ochrancovia prírody.	Kanaré has benefited from a bit of giraffe tourism and a local development fund created by international conservationists.	0.6303
Keďže islamský štát Boko Haram pôsobí na východe krajiny a pridružené krajiny al-Káidy na severe a západe, cestovný ruch sa spomalil.	But with Boko Haram active in the country’s east and al Qaeda affiliates operating in the country’s north and west, tourism has slowed to a trickle.	0.682775
Na žirafy sa minulý rok prišlo pozrieť iba 1 700 turistov, väčšinou to boli obyvatelia Niamey, ktorí sa vybrali na jednodňový výlet.	The giraffes were visited by just 1, 700 tourists last year, mostly well-to-do Niamey residents on day-trips.	0.40922
V poslednom desaťročí prešla Afrika pozoruhodnou obnovou prírody. ~~~ Ochranári do prírody znovu prinavrátili dávno vyhynuté druhy, ako napríklad čadský oryx horský (Oryx Dammah) a umiestnili ich do oblastí, ktoré boli kedysi ich domovom.	There has been a remarkable rewilding of Africa during the past decade as conservationists have reintroduced long-departed species, such as Chad’s scimitar- horned oryx, to areas that once were part of their home ranges.	0.0132095
Nadácia pre zachovanie žiráf za posledné dva roky premiestnila ďalšie tri žirafy. ~~~ Cez rieku Níl previezli dve žirafy z ugandského národného parku Murchison Falls.	In the past two years the GCF has orchestrated three other giraffe translocations, including two inside Uganda’s Murchison Falls National Park, which required ferrying animals across the Nile River.	-0.0306338
Hodnotenie potenciálnych biotopov krajiny označilo rezerváciu Gadabedji za najbezpečnejšie miesto pre druhú populáciu žiráf v západnej Afrike.	In Niger, an assessment of the country’s potential habitats determined the safest place to park a second population of West African giraffes was on 2.	0.3
Žirafy umiestnili na viac ako 10 000 neobývaných kilometrov štvorcových v rezervácii Gadabedji, oblasti v strede krajiny, ktorá bola označená za biosférickú rezerváciu.	5 million uninhabited acres in Gadabedji, an area in the center of the country that has been designated as a biosphere reserve.	0.318285
Je to obľúbená oblasť pre supy a gazely. ~~~ Pred 50 rokmi táto rezervácia poskytovala domov predkom týchto žiráf.	It’s a hot spot for vultures and gazelles, and 50 years ago the area was host to ancestors of these giraffes as well.	1.41393
Sťahovanie žiráf cez Níl Úradníci, ktorí sa zaoberajú voľné žijúcimi zvieratami, naložia tri žirafy núbijské rotchildove do nákladného auta. ~~~ Auto je lemované listovými vetvami, aby sa zvieratá mohli počas svojej cesty do novej časti Ugandského národného parku Murchison Falls občerstviť.	Moving Giraffes Across the Nile Wildlife officials load three Rothschild’s giraffes into a truck lined with leafy branches for the animals to snack on during their journey to a new part of Uganda’s Murchison Falls National Park.	0.0584109
Práve tieto tri žirafy boli súčasťou projektu, ktorý premiestnil až 19 ohrozených žiráf.	The trio was part of a project that relocated 19 of the endangered giraffes.	2.59621
Nákladné auto, v ktorom sú umiestnené žirafy, prechádza cez Níl.	A truck loaded with giraffes is ferried across the Nile.	0.25
Zvieratá premiestnili z národného parku Murchison Falls, na severe Nílu do vzdialenej južnej časti. ~~~ V tejto oblasti žirafy ohrozujú pytliaci a následky ťažby ropy.	The animals were moved from a section of Murchison Falls National Park on the north side of the Nile, where giraffes are threatened by poachers and the effects of oil extraction, to a remote southern sector.	0.0685315
Tri žirafy núbijské rotchildove vypustia v národnom parku Murchison Falls na južnej strane Nílu. ~~~ Ochrancovia prírody dúfajú, že práve v tejto oblasti sa ich počet zvýši.	Three Rothschild’s giraffes are released in Murchison Falls National Park on the southern side of the Nile, where conservationists hope their numbers will grow.	0.103571
Keďže žirafy nevedia plávať, do svojho predchádzajúceho prostredia sa cez rieku nevrátia.	Since giraffes can’t swim, they won’t cross the river and return to their previous habitat.	0.296154
Samozrejme, premiestňovanie žiráf má aj svojich kritikov.	The translocation is not without critics.	0.178378
Ak sú žirafy v ich súčasnom umiestnení ohrozené, prečo ich počty narastajú?	If giraffes are in danger in their present location, why are their numbers augmenting?	0.258462
To jednoducho nedáva zmysel, vyjadrila sa etologička Isabelle Ciofolová, ktorá sa v polovici 90. rokov pripojila k miestnym snahám na ochranu žiráf v Koure.	It simply doesn’t make sense, says Isabelle Ciofolo, an ethologist who joined the local conservation efforts in Koure in the mid-1990s.	0.389812
Najlepším riešením je nechať rozhodnutie na žirafy, aby si podľa svojich inštinktov a potrieb vybrali to najvhodnejšie miesto na život.	To the extent possible, it is best to leave the giraffes to their own natural tendencies in determining which habitat is suited to their needs.	0.435165
Etologička poukazuje na to, že žirafy sa v Nigérii dokážu túlať až do vzdialenosti 290 kilometrov.	She points out that the giraffes of Niger have shown they can roam up to 180 miles.	0.229412
Pokiaľ im niekde hrozí nebezpečenstvo, samy si dokážu nájsť nové, vhodnejšie prostredie.	If there is a menace in one place, they are perfectly capable of finding a new habitat on their own.	0.284615
Dobré dievča.	Good girl.	0.21
Aký sladký koláčik, šepká si Morkel, keď sa plazí k nič netušiacej žirafe.	What a sweetie pie, Morkel whispers to himself as he creeps closer to the unsuspecting giraffe.	0.214286
Odhaduje, že zviera má okolo 680 kilogramov, tlak v puške nastaví na 1, 2 megapascalov (MPa) na 30 metrový výstrel a odistí poistku na puške.	He estimates the animal at about 1, 500 pounds, sets the pressure in his rifle to 12 bar for a 100-foot shot, and turns the safety off.	0.508951
Je 13. 00 a teplota práve dosiahla 38 °C.	It’s 1 p. m. , and the temperature has just hit 100°F.	0.211765
Ešte nikdy som nemal príležitosť byť tak blízko pri žirafe.	I’ve never had this sort of situation where you can walk right up to a giraffe.	0.217647
Zvyčajne sedím v pickupe a na žirafy strieľam z diaľky, povedal mi Morkel.	Normally, you’re in a pickup, shooting them from a distance, Morkel tells me.	0.5
Musím však povedať, že sú to podivné stvorenia, v neposlednom rade preto, lebo žijú na komunitnej pôde, ďaleko od zvieracej rezervácie alebo národného parku. ~~~ Dni trávia tým, že krížia cesty farmárom a pastierom.	But these are strange creatures, not least because they live on community land, far from any game reserve or national park, and spend their days crossing paths with farmers and herders.	-0.0233333
Cez noc búchajú hlavami do stien z vyvýšených obilnín v tvare miestnych úľov a jedia listy zo strukoviny cowpea, ktoré si dedinčania skladujú pre svoj dobytok, rovnako ako aj mangá a tekvice.	At night they bust their heads through the walls of the locals’ elevated beehive-shaped granaries and eat the cowpea leaves that villagers store for their livestock, as well as their mangoes and pumpkins.	0.27764
Našťastie, jediné jedlo, ktoré žirafám záhadne nechutí je proso, čo je základná výživná miestna obilnina.	Fortunately for everyone, the one food they mysteriously have no taste for is millet, the nutritious local cereal staple.	0.26087
Pracovníci divočiny vytiahli mŕtvu žirafu z pytliackej pasce v Amboseli, v Keni.	Wildlife personnel pull a dead giraffe from a poacher’s snare in Amboseli, Kenya.	0.530769
Z jednej žirafy majú pytliaci skoro 300 kilogramov cenného mäsa.	A single animal can yield 650 pounds of valuable meat.	0.234783
Niekedy sa žirafy zabíjajú len pre ich chvosty, ktoré v niektorých kultúrach zaručujú vyššie postavenie.	Sometimes giraffes are killed only for their tails—status symbols in some cultures.	0.226027
Morkel si ukladá pušku na rameno a stláča spúšť, jeho uspávacia šípka naplnená etorfínom zasiahla zviera do ľavého ramena. ~~~ Bol to priamy zásah, potrvá však niekoľko minút, kým opiát zaúčinkuje.	Morkel raises the gun to his shoulder and pulls the trigger, sending his etorphine- laden dart sailing into the animal’s left shoulder, a direct hit, but it will take several minutes for the drug to kick in.	0.120509
Podávanie sedatív divokým žirafám je relatívne nový postup, ktorý sa za posledných 30 rokov výrazne vylepšil, stále však predstavuje určité riziká.	The sedation of wild giraffes is a relatively new practice that has been refined over the past 30 years and carries major risks.	1.74112
U zvieraťa môže dôjsť k zastaveniu dýchania, v dôsledku smrteľnej dávky opioidom.	The animal can stop breathing from a lethal dose of opioid.	0.174
Zviera si pri páde môže poraniť hlavu, čo má za následok prasknutie lebky.	It can fall headfirst and crack its skull, or break its long back or spindly legs.	0.27619
Tiež si môže zlomiť dlhý chrbát alebo tenučké nohy.		-0.3
Zviera môže vyvrátiť už čiastočne natrávené jedlo a následne ho vdýchnuť do pľúc, čo môže zapríčiniť zápal pľúc.	It can regurgitate partly digested food and inhale it into its lungs, leading to pneumonia.	0.230769
Keďže leží na rozpálenom piesku, môže sa dokonca prehriať.	And it can overheat while lying on the scorching sand.	0.267391
V Ugande v roku 2017 zahynuli tri zvieratá v dôsledku stresu zo zajatia a ďalšie pri premiestňovaní.	During a 2017 translocation in Uganda, three animals died from stresses related to being captured, and another died while it was being moved.	2.17647
Čakali sme, kým opiát zaúčinkuje a s Morkelom sme sa vrátili k pick-upu.	While we wait for the drug to kick in, Morkel and I walk back to a waiting pickup truck filled with a team of rangers and researchers.	0.27822
Tam čakal tím strážcov a vedcov. ~~~ S týmto druhom sa pracuje ťažko, povedal Morkel.	This is a hard species to work with, Morkel says.	0.144643
Pred nami je ešte dlhá cesta pádov a unikátna anatómia žiráf.	There’s a long way to fall, and a lot of unique anatomy.	0.51087
Anatómia tohto stvorenia je skutočne extrémna.		-0.3
Samozrejme mám na mysli slávny žirafí krk, ale tiež jej neuveriteľne dlhé mihalnice.	Everything about this creature’s anatomy indeed seems to be uniquely stretched to the extreme.	0.263014
Nohy má zo všetkých zvierat najdlhšie a oči zo všetkých suchozemských cicavcov najširšie. ~~~ Výnimočná je aj pretiahnutá lebka a hlavne fialovo-čierny chytajúci jazyk, ktorý sa môže rozprestierať od jej nohy až do polovice úst. ~~~ Obratne dokáže odtrhnúť holú stonku agátu s toľkými tŕňmi, že by ste ju určite nechceli chytiť holou rukou.	There’s its famous neck, of course, but also its outrageously long eyelashes, its legs (the longest of any animal), its eyes (the widest of any land mammal), its elongated skull, and especially its purple-black prehensile tongue, which can extend over a foot and a half from its mouth and nimbly strip bare an acacia stem so thorny you wouldn’t want to grab it with your bare hand.	-0.117432
Dokonca aj jej srdce, ktoré pumpuje krv cez väčšie vertikálne rozpätie ako u ktoréhokoľvek iného suchozemského cicavca, môže byť veľké približne pol metra a steny komôr môžu byť hrubšie ako 7, 5 centimetrov.	Even its heart, which pumps blood over a greater vertical span than any other land mammal, can be more than two feet long, with ventricle walls more than three inches thick.	0.327083
Kenskí experti na divú zver sa približujú k žirafe sieťovanej, ktorú omámili sedatívami v Louisabe.		-0.3
Louisaba je organizácia na ochranu života vo voľnej prírode v Keni.		-0.3
Aby odborníci mohli žirafy sledovať, pripoja jednotku GPS na jeden z rohov, čo sú kostnaté výrastky na ich hlavách.	Kenyan wildlife experts approach a reticulated giraffe that has been tranquilized in the Loisaba Wildlife Conservancy.	0.281633
Súčasťou tohto výskumu je sledovať 250 žiráf v kľúčových častiach Afriky, aby vedci lepšie pochopili, koľko priestoru žirafy v skutočnosti potrebujú.	They’ll attach a GPS unit to one of its ossicones—the bony knobs on its head—so scientists can follow it, part of a plan to track 250 giraffes in key parts of Africa to better understand how much space giraffes need.	1.68923
Žirafa má najvyšší krvný tlak spomedzi všetkých zvierat, a aj napriek tomu sa jej nejakým spôsobom podarí rýchlo spustiť hlavu z 5 metrov rovno na zem bez toho, aby omdlela.	The giraffe has the highest known blood pressure of any animal, and yet somehow it can manage to quickly drop its head 16 or 17 feet to the ground without passing out.	0.282482
Vo voľnej prírode sa obzvlášť ťažko pozoruje jav, ktorý dokazuje, že žirafy počas dňa spia len pár minút. Príčinou ich krátkeho spánku je fakt, že sa im ťažko vstáva a líha a tiež to, že žirafy ležiace na zemi sú ľahkou korisťou.	Because it’s so difficult for them to get up and down, and because they’re so vulnerable when they’re on the ground, giraffes only seem to sleep for a few minutes at a time (a phenomenon difficult to observe in the wild).	0.431319
Bez vody vydržia týždne, ich jediným spôsobom hydratácie je vlhkosť, ktorú vysajú z listov.	They can go for weeks without water by hydrating only with the moisture they suck from leaves.	0.3
Pozorovanie žiráf na púšti v Namíbii trvalo 5 rokov, kým Fennessy, popredný svetový odborník na žirafy, videl, ako si jedna žirafa roztiahla nohy a nemotorne si ponorila hlavu a napila sa z kaluže.	It took five years of observing giraffes in the deserts of Namibia before the GCF’s Fennessy, perhaps the world’s leading expert on giraffes, ever saw one splay its legs and dip its head awkwardly to drink from a ground puddle.	0.434904
Pri pozorovaní tejto nešikovnej snahy získať najzákladnejšiu obživu sa vynára otázka, prečo majú žirafy taký krátky krk v porovnaní s ich dlhými nohami?	Witnessing this gawky effort to obtain the most basic sustenance makes one wonder if the right question to ask isn’t why the giraffe has such a long neck, but rather, why is it so short relative to such long legs?	0.199237
Pravdu povediac, stále nevieme prečo majú žirafy taký dlhý krk.	In truth we still don’t know why the giraffe has such a long neck.	0.294444
Podľa evolučného biológa v Technologickom inštitúte v New Yorku Nicosa Soulouniasa sa žirafa vyvinula na indickom subkontinente.	According to Nikos Soulounias, an evolutionary biologist at the New York Institute of Technology, the giraffe evolved on the Indian subcontinent and migrated to Africa from Asia some eight million years ago.	0.296755
Následne, pred 8 miliónmi rokov emigrovala z Ázie do Afriky. ~~~ Ich najbližšími žijúcimi príbuznými sú okápie, žijúce v rovníkových dažďových pralesoch Konžskej demokratickej republiky.	Its closest living relative, the okapi, which lives in the equatorial rainforests of the Democratic Republic of the Congo, noticeably lacks its cousin’s long neck.	-0.0235714
Tým očividne chýbajú dlhé krky, ktorými sa pýšia ich bratranci. ~~~ Žirafy označujeme za topiaristov, pre ich umenie tvarovať kríky do rôznych tvarov. ~~~ Živia sa listami tropického stromu zvaným akácia. Tieto stromy obžúvajú do tvaru presýpacích hodín, ktoré vejú na vrchole stromov. ~~~ Ich týčiace sa krky ani natiahnuté jazyky do tejto výšky už nedosiahnu.	Giraffes are naturally topiarists, eating the acacias into hourglass profiles that fan up at the top, just above the browse line where the animals’ towering necks and outstretched tongues can no longer reach, and so it would make sense that the long neck evolved to open up a feeding niche unavailable to shorter species.	-0.183468
Týmto sa vysvetľuje, že ich dlhý krk sa vyvinul tak, aby sa mohol otvoriť kŕmny otvor, ktorý nemajú kratšie druhy.	But some researchers have suggested that the giraffe’s long neck is actually a function of sexual selection.	0.290323
Avšak niektorí vedci tvrdia, že dlhý krk slúži pri výbere sexuálneho partnera. ~~~ Jeho hlavnou výhodou nie je hľadanie potravy v horných častiach stromov. Samci žiráf sa visiacimi hlavami s extra silnými lebkami vedia efektívnejšie udierať, keď v ruji súťažia o samice.	Its principal benefit is not for foraging in the upper reaches of trees but rather for males to more effectively club each other with their pendulous heads, outfitted with extra-thick skulls, when competing for females in heat.	-0.0289062
Ich dlhý krk môže poskytnúť vysoký výhľad bezbrannému zvieraťu, aby mohlo sledovať predátorov.	Or perhaps the giraffe’s long neck is simply to give an otherwise fairly defenseless animal a high vantage point to watch the horizon for predators.	0.148193
S dlhým krkom žirafy nepochybne súvisí aj jej desivé ticho.	Undoubtedly linked to the giraffe’s long neck is its eerie silence.	0.258824
Žirafy takmer nikdy nevydávajú zvuky a komunikujú medzi sebou bez akejkoľvek signalizácie, ktorú by mohlo zachytiť ľudské ucho.	Giraffes almost never make a sound and don’t communicate with each other using any kind of signaling audible to human ears.	0.437702
Ich mlčanie je zvláštne aj preto, že ide o spoločenské stvorenia žijúce v skupinách, v ktorých sa jednotlivci stretávajú, a pri hľadaní potravy sa rozdeľujú.	Their silence is especially bizarre given that they’re social creatures that live in a fission-fusion society, in which groups of individuals frequently get together for a period of time before dissolving.	0.321355
Ostatné druhy, ktoré patria do tejto triedy ako sú slony a šimpanzy, sú zvyčajne zhovorčivé.	Other species with fission-fusion societies, such as elephants and chimpanzees, tend to be loquacious communicators.	0.208861
Niektorí vedci preto dospeli k názoru, že žirafy pravdepodobne vysielajú nízkofrekvenčný infrazvuk, (podobný nízkofrekvenčnému rachotu slonov), aby spolu dokázali komunikovať na veľké vzdialenosti, zatiaľ sa však názory vedcov líšia.	This has led some researchers to suggest that giraffes may emit low- frequency infrasound to communicate with each other over long distances (similar to the low-frequency rumblings of elephants), but so far the evidence has been mixed.	0.291
Pracovníci naložia západoafrickú žirafu do prívesu.	Workers load a West African giraffe into a trailer.	0.279545
Neskôr žirafu presunú 500 kilometrov do severovýchodnej Nigérijskej biosférickej rezervácie Gadabedji. ~~~ Táto žirafa pomôže vytvoriť novú populáciu poddruhu, v ktorej sa nachádza približne 600 zvierat.	Later it will be moved 500 miles to Niger’s northeast Gadabedji Biosphere Reserve to help grow a new population of the subspecies, which has about 600 animals.	0.058871
Po dvoch minútach nečinnosti sa zdá, že žirafa, ktorú Morkel uspal, sa začína cítiť zvláštne.	After two minutes of standing still, the giraffe that Morkel has darted appears to realize how weird she’s starting to feel.	0.39375
Zrazu začne cválať preč od skupiny a vyzerá to tak, akoby bežala v spomalenom zábere.	Suddenly she gallops off from the group, her long legs seeming to fly in slow motion.	0.483275
Naše nákladné auto sa za ňou vydáva, predierame sa cez tigrie teritórium rýchlosťou 32 kilometrov za hodinu, pretože vodič sa snaží držať krok so šprintujúcim zvieraťom.	Our truck sets off after her, weaving through the tiger brush at 20 miles an hour, as the driver tries to keep up with the sprinting animal.	0.221739
Konečne sme vystrelili pred žirafu, a tým sme jej znemožnili cestu vpred.	Finally we’re able to shoot out in front of the giraffe to cut her off.	0.274138
Pneumatiky škrípu, až kým auto nezastaví. ~~~ Štyria muži vyskočia z auta a nastavia lano, aby zviera spomalili.	The tires screech to a halt so that four men in the bed can leap out and set up a rope line to slow the animal.	0.0460526
Ako sa žirafa rúti priamo na lano, hlavný miestny výskumník Abdoul Razack Moussa Zaberiou sa za ňou hodí, zatiaľ čo sa žirafa rúti k zemi v oblaku prachu.	As the giraffe barrels straight into the line, the head local researcher, Abdoul Razack Moussa Zaberiou, is sent flying through the air while the giraffe tumbles to the ground in a cloud of dust.	0.528314
Morkel skočí tesne pod hlavu spadnutej žirafy a do krčnej žily jej vpichne protijed, zatiaľ čo sa dvaja strážcovia rozkročia nad dolnou časťou krku a držia ju nehybnú.	Morkel jumps on top of the downed giraffe just below her head and plunges a syringe full of antidote into a jugular vein, while two rangers straddle the lower part of her neck to keep her pinned.	0.569919
Majú asi len dve minúty, kým sa zviera preberie. ~~~ Do uší jej rýchlo napchajú handru a cez oči dajú pásku.	They only have about two minutes until the animal comes to her senses, and so the team hustles to stuff her ears with a rag and put a blindfold over her eyes.	-0.0681818
Kým Morkel nadáva, tím veterinárov a strážcov odoberá vzorky krvi a vstrekuje žirafe vitamín E, antibiotiká a protizápalové lieky.	While Morkel lets fly a string of expletives, the team of vets and rangers take blood samples and inject syringefuls of vitamin E, antibiotics, and an anti-inflammatory drug.	0.65708
Žirafe odmerajú teplotu, následne si zaznačia jej miery a odrežú jej ušnú špičku na neskoršie výskumy DNA.	They take the giraffe’s temperature and measurements and cut off an ear tip for later DNA testing.	0.271084
Sotva zvieraťu stihli omotať lano okolo trupu, už sa začalo prebúdzať, divoko kopať okolo seba a rozprašovať do vzduchu piesok broskyňovej farby.	No sooner have they wrapped a rope around her torso than the animal awakens and kicks wildly, spraying peach-colored sand into the air.	0.401487
Morkel žirafu udrie po jej vzácnom pozadí a žirafa sa prudko pohne vpred. ~~~ S handrou na očiach a zapchatými ušami je vedú na lane do zadnej časti prívesu, v ktorom ju privezú k veľkému výbehu s množstvom stoniek eukalyptu a slamy.	Morkel delivers a slap on her rear end and she shoots up, blind and deaf, to be guided by a rope into the back of a trailer, in which she’ll be driven to a large enclosure made of eucalyptus poles and thatching.	0.0850272
Obďaleč, ani nie 30 metrov od nás, stojí 5 žiráf, ktoré sústredene pozorujú okolie z vyvýšeného miesta.	Five more giraffes are standing by, intently observing from their perch high above us, not 30 yards away.	0.463258
Dve z nich prežúvajú krmivo, ktoré sa im do úst vrátilo, aby ho požuli druhýkrát.	Two of them chew their cud, rolling a bolus between their teeth.	0.222222
S krmivom medzi zubami sa pohrávajú. ~~~ Z diaľky ich pozorujú aj mladí zarmanskí pastieri so svojimi stádami kôz.	Farther in the distance a pair of young Zarma herders, with their flock of goats, lean against a tree, watching as well.	-0.00625
Táto šialená naháňačka vyzerá, akoby sa zvrhol mafiánsky zásah, alebo akoby došlo k únosu mimozemšťanmi.	The whole frenzied chase has the feeling of a mobster hit gone awry, or perhaps an alien abduction.	0.271084
V čadskom národnom parku Zakouma si žirafy Kordofan trú krky – je to možno predohra pred bojom, alebo iná forma komunikácie medzi týmito zväčša tichými zvieratami.	In Chad’s Zakouma National Park, Kordofan giraffes rub necks—possibly a prelude to fighting or some other form of communication among the mostly silent animals.	0.657826
Zakouma je relatívne bezpečné útočisko pre žirafy Kordofan. ~~~ Žije tu viac ako polovica ich svetovej populácie.	Zakouma is a relatively safe haven for Kordofans; more than half the world’s population is there.	0.081761
Po troch týždňoch, počas ktorých si žirafy zvykali na život v ohrade, sú pripravené na prepravu do ich nového útočiska v Gadabedji.	After three weeks getting accustomed to life in an enclosure, the giraffes that will recolonize Gadabedji are ready for transport.	0.297297
V nedeľu okolo 11. 00 vedú prvé štyri žirafy do 6 metrového prepravného kontajnera, ktorý je natretý na bielo a má odrezanú strechu.	At about 11 a. m. on a Sunday, the first four giraffes are guided into a 20-foot shipping container that has been painted white and had its roof cut off.	0.387162
Podlaha je pokrytá mokrým pieskom, na ktorom budú zvieratá stáť. ~~~ Na okrajoch kontajnera sú pripevnené stojany, z ktorých visia listy, určené na občerstvenie počas cesty.	The floor is packed with wet sand for the animals to stand on and has poles fastened all along the edges to hang leaves as an in-transit snack.	-0.0397436
Dôležité je, aby žirafy zostali pokojné.	It’s crucial that the giraffes stay calm during the trip.	0.191667
Pred niekoľkými týždňami prišiel tím o príliš rozrušenú žirafu, ktorá sa pošmykla, narazila hlavou o príves a neskôr zomrela.	Weeks earlier the team lost an overexcited animal that slipped and knocked its head against the trailer and later died.	0.279208
Nákladné auto vyráža na cestu rýchlosťou viac ako 15 kilometrov za hodinu.		-0.3
Mieri k rezervácii Gadabedji vzdialenej asi 800 kilometrov. ~~~ Pred nákladným autom ide vozidlo vyhľadávajúce elektrické drôty, ktoré by mohli uťať hlavu vzácnemu nákladu.	Led by a spotter vehicle that looks out for electrical wires that could decapitate the precious cargo, the truck sets off at a 10-mile-an-hour crawl for Gadabedji, some 500 miles away.	-0.000986842
Štyri zvedavé žirafy vykuknú z prívesu a naskytne sa im pohľad, aký doposiaľ ešte nevideli. ~~~ Muži sa strihajú pri kraji cesty, zmasakrované kozy visia zo stĺpov a malé biele mešity sú preplnené modliacimi sa mužmi. ~~~ Prechádzame okolo tuaregského pastiera, ktorý jazdí na ťave.	Four curious giraffe heads poking above the trailer watch a parade of sights they’ve never encountered before: men getting haircuts by the side of the road, butchered goats hanging from poles, and small white mosques overflowing with prostrate men.	-0.068315
Naskytol sa nám pohľad na trh s dobytkom plný mužných býkov s dlhými rohami. ~~~ Ženy v hidžáboch sa usmievajú a ukazujú na nás prstom. ~~~ Je tu pomerne veľa ľudí, ktorí sa ani len nepozrú hore, aby videli ten najzvláštnejší náklad, ktorý kedy prešiel cez ich dedinu.	We drive past a camel-driving Tuareg herder, a cattle market filled with mangy long- horned bulls, women in hijabs who smile and point, and quite a few people who don’t even look up to notice the strangest cargo ever to blow through their village.	-0.132258
Kenská študentka modeluje masku žirafy, počas návštevy Twiga Walinzi - strážcovia žiráf. ~~~ Je to ochranný tím, ktorý učí žiakov o žirafách a dúfajú, že im študenti pomôžu ochrániť tento druh.	A Kenyan student models a mask during a visit to her school by the Twiga Walinzi—Giraffe Guards—a conservation team whose work includes teaching pupils about giraffes in hopes the children will help protect the species.	0.094219
O 47 hodín neskôr sme konečne dorazili do Gadabeji, kde nás privítal tuaregský starosta v červenom rúchu a turbane. ~~~ Počas cesty sme zastavili iba dvakrát za deň, aby sa žirafy nakŕmili pod stromami gao a aby si posádka mohla pospať.	Forty-seven hours later, having stopped only for twice-a-day feeds beneath gao trees and a three-hour nap for the crew, we finally arrive at Gadabedji, where we’re greeted by the Tuareg mayor in a bright red robe and turban.	0.068617
Gadabeji je piesočná krajina s nízkou trávou a kríkmi.	It’s a sandy landscape, with little grass or brush.	0.579545
Deti vybehli oproti nášmu karavanu, dvíhali ruky a skákali od radosti.	Children run out to meet our caravan, raising their arms and jumping for joy.	0.280328
Už mesiace počúvali o našom príchode.	They have heard for months that we are coming.	0.245455
Táto krajina je ako stvorená pre žirafy, povedal mi Morkel s úsmevom na tvári.	This is perfect country for a giraffe, Morkel tells me, smiling.	0.49
Hlavy žiráf vykúkali cez bočnú stranu prepravného kontajnera a rozhliadali sa okolo jasnej plochy a po vreckách plných jedlých akácií.	The heads peeking over the side of the shipping container look around at the clear expanse and pockets of edible acacias.	0.258824
Áno, toto je dokonalá krajina pre žirafy.	Yes, this is indeed good giraffe country.	0.3
Brány prepravného kontajnera sa otvárajú a pri nich stoja tuaregské stráže so zbraňami AK-47 v rukách.	As Tuareg guards stand by with AK-47s, the gates of the shipping container are opened.	0.238356
Žirafy dorazili do svojho domova pod žeravým slnkom, denným mesiacom a oblohou s chumáčovitými citrusovými oblakmi.	Under a blazing sun, a daytime moon, and a sky of wispy cirrus clouds, the giraffes have arrived at their new home.	0.457523
Toto je iba prvá skupina zakladajúcej populácie.	This is just the first cohort of the founding population.	0.25814
Plánom je, aby sa k nim v budúcom roku pridali ďalšie zvieratá.	There are plans for more animals to join them next year.	0.261702
A o rok možno viac.	And the year after, possibly more.	0.0375
Keď uplynú dve minúty, prvá žirafa vystrčí hlavu z prepravného kontajnera a opatrne vyklusá von.	After two minutes the first giraffe pokes her head forward and cautiously trots out.	0.254167
Netrvá dlho a nasledujú ju ďalšie.	She is soon followed by the others.	0.3
Zastavia sa a pozorujú, ako ich sledujú ľudia.	They stop to watch the humans watching them.	0.284211
Veje jemný vánok. Štyri žirafy sa otočia, pomaly sa potulujú a pochodujú k stojanu akácií na obzore.	A breeze blows by, and the four turn and wander off slowly, marching toward a stand of acacias at the horizon.	0.44549
Presunú sa o jeden rad a znova sa obzerajú, akoby si neboli isté, čo majú robiť, kým sa na nich pozerajú ľudia.	They move single file, looking back now and again as if unsure what they’re supposed to do next, until they are out of sight.	0.26044
Naši autori vybrali 10 skvelých trás: Začiatok/Cieľ: mestečko Cranbrook Vzdialenosť/Čas: 16, 1 km/5 hodín Relax: hostinec The Three Chimneys, dedinka Biddenden Pokiaľ sa človek v kraji Weald nevyzná, nemôže písať o dejinách Anglicka, poznamenala Hilaire Bellocová začiatkom minulého storočia, obdivujúc všetku tú zem, ktorá leží medzi kriedovými horami juhovýchodného Anglicka a prechádza cez grófstva Sussex, Kent, Surrey a Hampshire.	Our writers pick 10 great trails Cranbrook-Sissinghurst, Kent Start/finish Cranbrook Distance/time 10 miles/5 hours. Refuel The Three Chimneys, Biddenden Unless a man understands the Weald, he cannot easily write about the beginnings of England, ” Hilaire Belloc noted early in the last century, admiring all that roll of land which lies held between and above the chalk of south-eastern England” and that crosses Sussex, Kent, Surrey, Hampshire.	0.847619
Bod, v ktorom sa prírodná rezervácia High Weald premieňa na grófstvo Kent, je v mojich očiach anglická krajina vo svojej najväčšej nádhere – úsek prastarých lesov a úchvatných budov, určených na sušenie. ~~~ Kombinácia zemskej vône a tieňa listov naznačuje, že tu je krajina zasadená najhlbšie.	The point at which the High Weald arcs into Kent is to my eye the English landscape at its most sublime – a stretch of ancient woodland and oast housed-prettiness, where the combination of earth scent and leaf shade seems to suggest that here the land sits at its deepest.	0.137599
Každé ročné obdobie prináša turistom osobité potešenie, no práve zimné mesiace odkrývajú najtajnejšie krásy krajiny: králiky zlatohlavé, stehlíky a glezky; liesku a hrab pokryté inovaťou; červené šípy divej šípovej ruže.	Every season brings its own particular joy for walkers, but the winter months hold the landscape’s subtlest pleasures: goldcrests, linnets and hawfinches; frosted hazel and hornbeam; the red hips of the wild dog rose.	0.288649
Ílovité chodníky, mäkké pod nohami, zaručia príjemnú chôdzu, i keď sa zavše zablatíte.	The paths are clay, and soft underfoot, which makes for occasionally muddy though always pleasurable walking.	0.22
Vyrazte od kostola sv. Dunstana v Cranbrooku, ktorý je známy aj ako Wealdská katedrála, stará viac ako 500 rokov. ~~~ Podoby pohanského Zeleného muža, vyrezané v drevených štítoch a na kamenej verande sú svedkami obdobia, keď bolo okolie pokryté hustým lesom.	Head out from St Dunstan’s Church in Cranbrook. ~~~ Known as the Cathedral of the Weald, the church is more than 500 years old, and the depictions of the pagan Green Man, in both wooden shields and a porch stone carving, nod to the time when the surrounding area was covered by dense forest.	0.51875
Odtiaľ sa vyberte na sever, mimo mesta a hlavnej cesty, až do lesov.	From here you head northwards, away from the town and the main road and out into woodland.	0.205263
Krajina má v týchto miestach nádych intimity – čiastočne pre spleť malých, podivne tvarovaných polí – pozostatkov zo stredoveku, kedy krajinu po prvýkrát uspôsobili na farmárske účely: dnešné živé ploty, ktorými prechádzate, sa vyvinuli z húštin, ktoré ich kedysi delili.	There is an intimacy to the landscape here, in part due to the patchwork of small, oddly shaped fields, a remnant of medieval times when the land was first cleared for farming: the hedgerows you pass today evolved out of the strips of woodland – or shaws” – that once divided them.	0.443744
Prechádzka je dlhá, no ľahko si ju skrátite. ~~~ Prevedie vás históriou poľnohospodárstva tohto grófstva – popri ovocných sadoch, sýpkach, ktoré počas obdobia zberu poskytli prístrešie robotníkom z Londýna a tiež popri niekdajších mlynských nádržiach a krajčírskych domoch.	This particular walk is long, though easy to abbreviate, and guides you through some of the county’s agricultural history – past fruit orchards, hopper huts that housed workers from London during the picking season, former millponds, and clothiers’ houses.	0.0332487
V istej chvíli sa ocitnete na ceste so zaujímavým názvom Digdog Lane – meno si vyslúžila vďaka túlavým psom, ktoré vyhrabávali obete moru pochované v neďalekej zemi.	At one point you will spill out on to the intriguingly named Digdog Lane — so-called for the stray dogs that would dig up plague victims buried in the land nearby.	0.500853
Hostinec The Three Chimneys, dedinka Biddenden.	The Three Chimneys pub, Biddenden.	1.68387
Počas tridsiatich rokov dvojica zmenila niekdajší statok na jednu z najuznávanejších záhrad v Anglicku.	Over the course of 30 years, the couple transformed the one-time farmstead into one of the most revered gardens in England.	0.257143
V zime, keď bujná výsadba oddychuje, je ten vhodný čas vychutnať si formálnosť Nicolsonovho záhradného dizajnu: rad záhradných domčekov a bezchybných živých plotov, dlhú prechádzku medzi prepletanými vetvami limetiek.	Winter, when Sackville-West’s exuberant planting stands in relief, is a fine moment to relish the formality of Nicolson’s garden design: the series of garden rooms and immaculate hedges, the long walk of pleached limes.	0.395187
Z hradu odbočte do samotného Sissinghurstu, peknej dedinky, ktorá odráža bohatstvo železiarskeho a odevného priemyslu oblasti Wealden a potom späť do Cranbrooku.	From the castle you may turn towards Sissinghurst itself, a handsome village built on the wealth of the Wealden iron and cloth industries, and then back to Cranbrook.	0.558727
Alebo zamierte na východ k The Three Chimneys s dubovými trámami a otvoreným ohniskom. ~~~ Hostinec je nositeľom ocenenia Good Pub Guide’s County Dining Award a skvelým miestom, kde môžete ochutnať miestne pivo Kentish Ale.	Or head east towards the Three Chimneys, an oak-beamed and open-fired freehouse, winner of the Good Pub Guide’s county dining award, and a fine place to sample Kentish ale.	0.316353
Laura Bartonová, novinárka a autorka knihy Twenty-One Locks (Dvadsaťjeden zámkov, z angl. preložila S. Č.) Ohromujúci pohľad na pohorie Beinn Eighe.	Laura Barton, journalist and author of Twenty-One Locks Beinn Eighe Mountain Trail, Wester Ross Stupendous views of Beinn Eighe.	1.00135
Táto prechádzka vedie od príťažlivých brehov jazera Loch Maree cez borovicové lesy ku kremencovej náhornej plošine s ohromným výhľadom na hory.	Setting out from the luscious banks of Loch Maree, this walk climbs through pine woods to an icy quartzite plateau with stupendous mountain views.	0.436364
Výstup je síce náročný a strmý, no o to zaujímavejší.	The ascent is hard work, but the steepness makes it special.	0.26
Turisti môžu na niekoľkých ďalších miestach celkom plynulo prechádzať mnohými biotopmi a tak aj zažiť rôzne ročné obdobia.	In few other places can walkers cross so many habitats, or seem to see so many seasons, quite this quickly.	0.242697
Vystupuje sa po vyznačenej, no mimoriadne členitej ceste, nezmiernenej rovinou (na parkovisku si môžete vyzdvihnúť bezplatného sprievodcu po tejto trase).	The ascent is up a well-marked but extremely rugged path that’s unalleviated by flat ground (a free guide to the route can be picked up in the car park).	0.27619
Cestu po lese Coille na Glas Leitir (Drevo sivého svahu) sa oplatí prejsť pomaly, pretože je čo obdivovať.	It’s worth taking this route up Coille na Glas Leitir (the Wood of the Grey Slope) slowly, because there’s an extraordinary amount to see.	0.844912
Borovice na dolných svahoch sú domovom bohatých spoločenstiev machov a pečeňoviek.	The pines on the lower slopes accommodate rich communities of mosses and liverworts.	0.3
Všímajte si lesné kuny a vtáky.	Look out for pine martens and woodland birds.	0.166667
Vysoké stromy neskôr vystrieda zakrpatená jarabina a vtáctvo spozorujete len zriedka.	Soon, these tall trees give way to stunted rowans and the bird-life becomes sparse.	0.278873
Nad vami sa však môže vznášať orliak morský alebo orol skalný.	But an eagle – white-tailed or golden – might drift above.	0.27551
Čím vyššie stúpate, tým je všetko zvláštnejšie.	Climb higher, and things get stranger.	0.229412
Na mrazových trhlinách pod nohami hľadajte viacuholníkové vzory a ostnaté borievky, krčiace sa v skalných prasklinách.	Look for polygonal patterns of frost heave underfoot, and spiny prostrate junipers that cower in fissures in the rock.	0.291089
Môžete zbadať kŕdle snehuliek severských a dokonca aj oranžové pečeňovky (tento druh sa nachádza len na štyroch známych lokalitách, ďalšie tri sú v Nórsku).	You might spot flurries of snow buntings, and even orange liverwort (the species is found in only four known sites; the other three are in Norway).	0.273171
Najväčším lákadlom je však široký výhľad z náhornej plošiny.	The greatest appeal of this walk, however, is the scale of the view as you breach the plateau.	0.158491
Danú scenériu vám zvyčajne poskytnú len najvyššie vrcholce (ktoré by si vyžadovali mačky a cepín); zachytíte ju za chladného a jasného dňa a tieto hory sa vám navždy vryjú do pamäti.	This is the kind of scene that you can only usually get from the highest peaks (which would require crampons and ice axe); catch it on a cold, clear day and these mountains will be etched in your memory for ever.	0.354534
Z náhornej plošiny sa dá zísť tým istým svahom, no prechádzku si môžete predĺžiť rozličnými spôsobmi.	From the plateau you could take a different route back down the same slope, but there are many alternatives to extend the walk.	0.234483
Nech už si zvolíte ktorýkoľvek, po ňom sa zahrejte v hoteli Kinlochewe.	Whatever you choose, warm up at the Kinlochewe Hotel afterwards.	0.273214
Ponúka izby, nocľaháreň, výdatné jedlá a whisky, vrátane intenzívnej rašelinovej terapie Octomore a celú škálu procedúr Old Pulteneys (hrejivá sladkosť za rozumnú cenu).	It has rooms, a bunkhouse, hearty dishes and whisky, including Octomore (an intense peat hit) and the full range of Old Pulteneys (for warming sweetness on any budget).	0.912324
Môžete si tiež prečítať knihu Beinn Eighe: Saw-Toothed Mountain (Beinn Eighe: Pílovitá hora) od Dicka Balbarryho a J. Laughtona, ktorá opisuje bohatú históriu svahov okolo vás.	You can also take a look at Beinn Eighe: the Saw-Toothed Mountain, Dick Balbarry and J Laughton’s book outlining the rich history of the slopes you’ve just climbed.	0.71401
Poveternostné podmienky a rady horských sprievodcov sledujte na stránke scotlandinfo.eu David Gange, autor knihy The Frayed Atlantic Edge: Historian's Journey from Shetland to the Channel (Zodraný breh Atlantiku: Cesta históriou zo súostrovia Shetland do Lamanšského prielivu, z angl. preložila S. Č.) Rady kamenných suchých múrikov sú charakteristické pre Chelmorton.	Check weather conditions and mountain guide advice, scotlandinfo.eu David Gange, author of The Frayed Atlantic Edge: A Historian’s Journey from Shetland to the Channel Chelmorton, Peak District Stone rows … the distinctive drystone walls of Chelmorton.	1.29339
Zima sa s národným parkom Peak District stretáva v najmrazivejšom bode, no keď zmizne vegetácia a divá zver z pastvín, krajina odhalí svoju históriu.	Winter sees the Peak District at its bleakest, but as vegetation disappears and pasture is stripped of wildlife, the landscape gives up clues to its history.	0.525827
Podlhovastá dedina Chelmorton je známa svojím charakteristickým vzorom suchých múrikov, ktoré vymedzujú tenké pruhy zeme a ohraničujú pozemky v zmysle zákona o zaberaní pôdy.	The linear village of Chelmorton is famous for its distinctive pattern of drystone walls, which delineate thin strips of land said to predate the enclosure acts.	0.387153
Nad dedinou a ulicou Main Street sa týči kopec Chelmorton Low s dvoma prehistorickými mohylami na vrchole.	From Main Street, the hill of Chelmorton Low, topped by two prehistoric tumuli, looms over the village.	0.623106
Na úpätí sa nachádza Kostol sv. Jána Krstiteľa, ktorý sa považuje za najvyšší kostol v grófstve Derbyshire a na jeho veži žiari zlatá kobylka.	At its foot is St John the Baptist, said to be the highest church in Derbyshire, where a golden locust weather vane glints atop the spire.	0.404211
Cesta končí pri prameni Bank Pit Spring, kde potok Illy Willy Water steká do podzemnej riečky.	The road ends at Bank Pit Spring where Illy Willy Water cascades into an underground stream.	1.17466
Stúpajúci chodník vedie cez pozostatky hrablí – zvislých spletí baní ťažiacich olovo.	The uphill path runs through the remains of a rake, a mined vertical vein of lead.	0.269118
Niektoré zvlnené trávnaté pahorky na poliach sú starými baňami.	Some of the undulating grassy mounds in the fields are old mine workings.	0.267857
V Peak District je množstvo priemyselných zaujímavostí.	The industrial is never far away in the Peak District.	0.648913
Na vrchole sa oplatí vydať krátkou okľukou po zníženej ceste ku kamennej mohyle Five Wells, jednej z najvyšších britských megalitických hrobiek, z ktorej je krásny výhľad na cestu Taddington Moor.	At the top, it is worth taking a short detour along the concessionary path to Five Wells cairn, one of the UK’s highest megalithic burial chambers, with fine views across Taddington Moor.	0.569303
Na kopcoch okolo Chelmortonu je veľa starobylých hrobov, z ktorých väčšinu vykopali (alebo znesvätili, záleží od uhla pohľadu) viktoriánski starožitníci.	There are many ancient tombs on the hills around Chelmorton, most of them excavated (or desecrated, depending on your point of view) by Victorian antiquarians.	0.297778
Keď sa vrátite na jazdeckú trať, túlajte sa po poliach až k dlhému vápencovému chodníku Limestone Way, vedúcemu cez náhornú plošinu White Peak.	Back on the bridleway, tramp through the fields until you meet the Limestone Way, the long- distance footpath through the White Peak plateau.	0.67
Zamierte smerom na dedinu Flagg, ktorej alžbetísnke panstvo bolo kedysi známe vďaka strašidelnej lebke, ktorá zmarila všetky pokusy o jej dôstojný pohreb.	Head towards the village of Flagg, whose Elizabethan manor was once renowned for its haunted” skull, which repelled all attempts to give it a decent burial.	0.425889
Záverečný úsek lemujúcich sa polí na označených chodníkoch vedie ku križovatke známej ako Chelmorton Thorn. ~~~ Pripomína starú tradíciu výsadby kríkov hlohu na rázcestiach a na iných hraničných miestach.	The final leg, crossing fields on signposted footpaths, leads to a junction known as Chelmorton Thorn, a reminder of the old tradition of planting hawthorn bushes at crossroads and other liminal places.	0.0902616
Odtiaľ cesta klesá späť do Chelmortonu a hostinca Church Inn z 18. storočia s vynikajúcim jedlom a otvoreným ohniskom, ktoré si udržiava takmer tropické teploty.	From here, it drops back down into Chelmorton and the 18th-century Church Inn, with its excellent food and an open fire that keeps temperatures inside close to Snow shoes … a hiker descending Meall a’Bhuachaille.	0.441639
Fotografia: Alamy Začiatok/Cieľ: návštevnícke centrum Glenmore Forest Vzdialenosť/Čas: 8, 9 km/4 hodiny Relax: bar The Pine Marten Bar, Glenmore	Photograph: Alamy Start/finish Glenmore Forest visitor centre Distance/time 5. miles/4 hours Refuel The Pine Marten Bar, Glenmore	1.59912
Výstup do zimnej krajiny po okružnej ceste Meall a’Bhuachaille (Shepherd’s Hill) vám dá poriadne zabrať.	For a journey into winter wonderland, the circular walk up Meall a’Bhuachaille (the Shepherd’s Hill) takes some beating.	0.819643
Úchvatný výhľad, vzácne druhy zvierat a obnovené pôvodné lesy; prechádzku možno prirovnať k whisky: Cairngorms destilované do čistej, výdatnej formy.	Stunning views, rare wildlife and native woodland regeneration: think of this walk as a whisky; the Cairngorms distilled into pure, rich form.	0.563583
Počas výstupu na vrchol vždy zažívam radostné uvoľnenie tela, ktoré Nan Shepherd nazýva niečím nevídaným.	Climbing this peak, I always experience that joyous release of body” that Nan Shepherd terms feyness.	0.657759
Z návštevníckeho centra sa vyberte stúpajúcou cestičkou cez les.	From the visitor centre, follow a track uphill through the forest.	0.3
Ak budete mať oči otvorené, možno zazriete veveričky, srnce či kuny lesné.	Keep your eyes peeled for red squirrels, roe deer and pine martens.	0.263158
Srnce sa starajú o to, aby sa borovice, brezy a vŕby mohli rozmnožovať a rásť.	Deer are carefully managed to enable pine, birch and willow trees to self-seed and grow up the hill.	0.212308
Medzi novými sadenicami sa týčia staré babičky-borovice.	Among the new seedlings, regal old granny pines stand tall.	0.3
Keď sa slnko odráža od snehu, koruny týchto storočných stromov žiaria teplou medenou farbou.	When the sun reflects off the snow, the crowns of these 100-year-old survivors glow a wonderful warm copper colour.	0.2325
Ďalej pokračujte po hrebeni do kopca až k masívnej žulovej mohyle.	Gaining the ridge, continue uphill to the bulky granite cairn.	0.283333
Vo výške 810 metrov nad morom sa vám naskytnú úžasné výhľady na les Glenmore, náhornú plošinu Cairngorms, zátoku Moray Firth a – za výnimočne jasného dňa – aj na vrch Ben Nevis.	At 810 metres high, there are excellent views across Glenmore Forest, the Cairngorms plateau, the Moray Firth and – on an exceptionally clear day – Ben Nevis.	2.08985
Môže byť chladno a veterno, preto sa radšej naobedujte v chatke Ryvoan. Potom zamierte doprava po Thieves Road (Cesta zlodejov), starej honelníckej ceste, ktorú využívali aj obávaní záškodníci (zlodeji dobytka).	It can be very cold and windy, so lunch is best saved for the shelter of Ryvoan bothy; then turn right along the Thieves Road, an old drovers’ route that was also used by fearsome cateran (cattle raiders).	0.371922
Vedie k ohromnému ľadovcovému údoliu – kedysi tadiaľto tiekla voda z roztopeného snehu, dnes jeho strmé okraje lemuje Kaledónsky les.	The track leads into a dramatic glacial valley: meltwater once poured through this channel; now the steep sides are lined with regenerating Caledonian forest.	0.245217
Odbočte na chvíľu z chodníka a navštívte jazero Lochan Uaine (Zelený Lochan).	Leave the track for a moment to visit Lochan Uaine (the Green Lochan).	1.1824
Voda je výrazne tyrkysová, pretože víly si v nej perú svoje šaty (i keď v zime je to pre ne problémom, pretože jazero býva často zamrznuté).	The water is a distinctive turquoise because fairies wash their clothes here (although the wee people must struggle in winter, because the lochan is often frozen).	0.240517
Vydajte sa doprava po chodníčku, ktorý sa po chvíli vinie do kopca cez nádherné staré škótske borovice s výhľadom na Northern Corries.	Turn right on a smaller path that soon winds uphill through beautiful old Scots pines with views to the Northern Corries.	0.537433
Mierny zostup lesnou cestou vedie späť k začiatočnému bodu.	A gentle descent on forest track leads back to your starting point.	0.271154
Potom volajte do Sobieho centra, či je sob Rudolf doma.	Call into the Reindeer Centre to see if Rudolph is at home.	0.287234
Na záver navštívte útulný bar Pine Marten Bar obložený drevom a okúste aktivity v après ski v Cairngorme.	Finish up in the cosy wood- panelled Pine Marten Bar for a taste of Cairngorm après ski.	1.06758
Rybník Keeper’s Pond na severovýchodnej strane Blorenge vyzerá ako zrkadlo.	Keeper’s Pond, on Blorenge’s north-east face.	0.538328
Doprajte si mandľový croissant z mestskej pekárne Angel Bakery.	Pick up an almond croissant from the town’s Angel Bakery.	1.15714
Budete potrebovať energiu, pretože po príjemnej úvodnej prechádzke okolo hradu, popri rieke Usk a popod prieplavy Monmouthshire a Brecon, cez nízky, klenutý, navlhnutý tunel, začína strmý výstup na horu Blorendge.	You’ll need energy, because after a gentle (pre)amble past the castle, along the River Usk and then under the Monmouthshire and Brecon canal using a low, vaulted, dripping foot tunnel, you start the steep ascent of the Blorenge.	0.675745
Vedie po ceste Hill’s Tramroad, postavenej v 20. rokoch 19. storočia na prepravu surového železa a vápenca do prieplavu, ktorý je spomienkou na bohaté priemyselné dedičstvo oblasti.	The climb follows the route of Hill’s Tramroad, built in the 1820s to transport pig iron and limestone to the canal, a reminder of the area’s rich industrial heritage.	0.587143
Môžete kráčať po kamenných podvaloch, ktoré zostali zachované.	Luckily, the stone sleepers are still there to provide steps.	0.283019
Po dvoch tretinách stúpania odbočte doľava a zamierte k dostupnejšiemu a rovnejšiemu chodníku pozdĺž doliny Cwm Craf, ktorá je na severovýchodnej strane Blorenge, okolo Keeperovho rybníka v údolí Punchbowl, niekdajším dejiskom bojov holými rukami a popri vpadnutej ceste medzi obrovskými starovekými stromami, ktoré Richard Mabey opísal ako drevený vír – ohromné bukové chrliče.	Two-thirds of the way up, turn left and follow the mercifully flatter path along the Cwm Craf, a hollow on Blorenge’s north-east face, past Keeper’s Pond, cradled by the Punchbowl, once the scene of bare-knuckle fights, and along a sunken road between huge, ancient trees described by Richard Mabey as a whirlpool of wood … immense gargoyles of beech”.	0.711902
Stúpajte ďalej ponad stromy a prebroďte sa cez močiar a húštiny k pustej, trávnatej náhornej plošine, kde sa svet okolo vás otvára.	Climb again now, above the trees, squelching through bog and gorse, to the bleak, tussocky summit plateau, the world around you opening up.	0.281081
Na severe sa nad mestom Abergavenny majetnícky týčia vrchy Skirrid a Sugar Loaf; smerom na západ je najvyšší vrchol južného Walesu Pen y Fan a na juhu, ak máte šťastie, sa v jase zimného slnka trbliece Bristolský záliv.	To the north the Skirrid and Sugar Loaf loom proprietorially over Abergavenny; to the west is Pen y Fan, south Wales’ highest peak; and to the south the Bristol Channel glints under the winter sun, if you are so blessed.	0.606044
Vezmite si oblečenie navyše, pretože za veterného dňa môže byť hora Blorenge obzvlášť krutá.	Take extra clothes, for the Blorenge can be a beast when she blows.	0.385714
Blízko najvyššieho bodu (561 metrov) sa nachádza pohrebisko z doby bronzovej a pamätná tabuľa, označujúca miesto, kde bol v roku 1959 pochovaný šampión parkúrového jazdectva Foxhunter.	Near the summit (561 metres) is a bronze age burial site, and a plaque marking the place where Foxhunter, a champion showjumper, was buried in 1959.	0.435125
Na rovnakom mieste bol v roku 1999 rozptýlený popol jeho jazdca, Sira Harryho Llewellyna.	The ashes of his rider, Sir Harry Llewellyn, were scattered on the same spot in 1999.	0.274648
Nájdite si miesto na záveternej strane skaly, dajte si sendvič a uvažujte o dvoch anglických slovách, ktoré sa rýmujú s anglickým slovom orange.	Find a place in the lee of rocks to eat your sandwiches and contemplate the two words in the English language that rhyme with orange.	0.514545
Na jednom práve sedíte.	You’re sitting on one.	0.285
Po namáhavom výstupe zamierte domov, smerom dole po západnom úpätí hory popri pustatine na úbočí, ktorá je podobná departmánu Somme. ~~~ Donedávna ju tvoril veľkolepý smrekovcový les, až kým ho nevyplienila vyčíňajúca choroba, spôsobujúca náhle odumieranie, tzv. ramorum.	Turn for home now, the hard work done, dropping down around the western flank of the mountain, past a Somme-like wasteland on the hillside, until recently a magnificent larch wood before the rampaging ramorum disease wiped it out.	-0.0309278
Po návrate do Abergavenny si rýchlo obsaďte jednu z prepychových kožených pohoviek vedľa tlejúceho ohňa v drevom obloženom bare Foxhunter v hoteli Angel, víťazom ocenenia 2020 Cesar Welsh Hotel of the Year (víťaz najlepšieho hotela vo Wales pre rok 2020), a objednajte si pivo značky Sir Henry, pomenovaného po zosnulom významnom parkúrovom jazdcovi.	Back in Abergavenny, bag one of the sumptuous leather sofas next to the roaring fire in the wood-panelled Foxhunter bar of the Angel Hotel – 2020 Cesar Welsh Hotel of the Year – and order a pint of Sir Harry, named after the late, great showjumper.	1.43689
Zaslúžite si to.	You will have earned it.	0.18
Ideálne by bolo, keby ste do malebnej dediny Clare pricestovali vlakom a vydali sa na prechádzku v tichom, čarovnom vidieku, ale Richard Beeching nám to v 60. rokoch odobral.	It would be perfect to arrive in picturesque Clare by train to start this stroll amid quietly magical countryside, but Richard Beeching took that from us in the 1960s.	0.785
Z bohato zdobenej viktoriánskej staničnej budovy je dnes prívetivá a hrejivá kaviareň Platform One.	The ornate Victorian station building is now the friendly, warm Platform One cafe.	0.44668
Je ťažké rozlúčiť sa s prírodným parkom Clare, najmä s jeho vznešenými zrúcaninami normanského hradu, zeleňou, lesmi, starým priorstvom, rybníkmi a železničnými nástupišťami.	Clare country park is hard to tear yourself away from, with its lofty ruins of a Norman castle, its greens, woods, old priory, ponds and railway platforms.	0.371923
A potom je tu jedna z najcharizmatickejších riek južného Anglicka za slávy Constabla, Stour.	And then there’s one of southern England’s most charismatic rivers, the Stour, of Constable fame.	0.285
Jeho najslávnejšia maľba vo Flatford Mill zobrazuje scenériu, vzdialenú približne 50 km smerom na juhovýchod v častejšie navštevovanej oblasti Dedham Vale.	His most famous painting, at Flatford Mill, depicts scenes 30 miles south-east, in the more frequented Dedham Vale.	0.661563
Clare sa však teší zo svojej relatívnej tajuplnosti s množstvom dobre značených chodníkov, vedúcich z prírodného parku.	But Clare revels in its relative obscurity, with a profusion of well-signposted walks starting from the country park.	0.457756
Táto trasa do ďalšej osobitej dediny Cavendish spočiatku zavedie turistov na juh, popri peknom mlynskom dome, cez rieku Stour do grófstva Essex.	This route to another characterful village, Cavendish, takes walkers south initially, past the handsome Mill House and across the Stour into Essex.	0.553612
Tu sa stáča na východ pozdĺž nekonečného zástupu živých plotov, plných trepotajúcich sa drobných stehlíkov a strnádok.	Here it turns east along a never-ending line of hedgerows alive with the flitterings of small birds, including linnets and corn buntings.	0.42589
Pred festivalovou sieňou Bower Hall zo 16. storočia preteká rýchla rieka Stour zahalená vŕbami. Vytvára tak ideálne miesto na pozorovanie rybárikov a možno aj vydier, ktorých výskyt sa na tomto úseku obnovil.	In front of 16th-century Bower Hall, the swiftly flowing Stour is shrouded by willows, a perfect spot to watch for kingfishers and, less likely, the otters now re-established on this stretch.	0.55162
V dedinke Pentlow neďaleko Cavendishu sa medzi stromami vynára úchvatný ranostredoveký Kostol sv. Gregora s nezvyčajnou okrúhlou vežou a v zachovanom stave.	Nearing Cavendish, at Pentlow hamlet, an evocative early medieval church, St Gregory’s, with an unusual round tower and in great nick, appears between trees.	0.428213
Keď zabočíte smerom na sever a prejdete cez rieku späť do grófstva Suffolk, trasa vedie hneď k vstupu do Cavendishu, okolo záhrad a výstredných chatiek.	Now turning north and crossing the river back into Suffolk, the route passes gardens and eccentric cottages as it enters Cavendish.	0.390828
Skromná reštaurácia Five Bells ponúkajúca nápoje Greene King, velí rozsiahlej dedinskej zeleni a je ideálnym miestom na oddych.	The unpretentious, Greene King-serving Five Bells commands the large village green and is an ideal pit stop.	0.741935
Za ňou sa nachádza Kostol Panny Márie, kde údajne v roku 1381 chytili a neskôr zabili z pomsty za vraždu vodcu anglického povstania Wata Tylera Johna Cavendisha, miestne veľké zviera.	Behind is St Mary’s church, where it’s claimed that in 1381 the local big cheese, John Cavendish, was seized, later to be killed in revenge for the slaying of peasants’ revolt leader Wat Tyler.	1.3529
Prejdite zeleňou, okolo cintorína smerom na západ cez nízke kopce a rozľahlé polia, žiariace v zapadajúcom zimnom slnku zlatou, zelenou a čiernou farbou, naprieč zalesnenými svahmi späť do Clare.	Cross the green and pass the cemetery to head west across low hills and vast fields, gold, green and black under the lowering winter sun, and through woody dips back to Clare.	0.352414
Dedina s dominantným kostolom prvej triedy sa nakoniec vynorí pod vami.	The village finally appears below, dominated by yet another Grade I-listed church.	0.251613
Zastavte sa v tradične zariadenej reštaurácii Swan, ktorá podáva pivo značiek Adnams, Timothy Taylor’s Landlord a poctivý krčmový pokrm vrátane štyroch vegetariánskych alternatív a pízz.	Drop in at the traditionally styled Swan, which serves Adnams, Timothy Taylor’s Landlord and solid homemade pub grub, including four veggie options and pizzas.	0.843066
Milovníci piva, ktorí nie sú hladní, možno uprednostnia 10 minútovú prechádzku cez dedinu do energického baru The Globe. Tento víťaz ocenenia Camra ponúka svetlé pivo a vystúpenia živých kapiel.	But beer aficionados who aren’t hungry might prefer to walk through the village for 10 minutes to The Globe, a lively Camra-award winner, with guest ales and live bands.	1.54718
Obe prevádzky povoľujú vstup so psom.	Both are dog friendly.	0.105
Oslavujem, až keď prvý lúč svetla ožiari oblohu.	I celebrate when the first light of a new year hits the skies.	0.235714
Prvý deň vždy strávim vonku, s výhľadom na rozbúrené vlny, chladným morským vzduchom, ovievajúcim moju tvár.	For day one I need to be outside, with a face full of cold sea air and a view of some broiling waves.	0.2475
Táto prechádza je na to ako stvorená.	This walk delivers exactly that.	0.268966
Vedie z miesta na miesto pozdĺž pobrežnej cesty Severného Cornwallu.	It is a point-to-point walk along the North Cornwall coastal path.	0.284211
Po chodníku prejdete s ľahkosťou, no miestami sa musíte šplhať.	The path is clear but requires scrambling in places.	0.233333
Pre taký typ chodníka sa rozhodnete náhodou, azda i ráno, po noci strávenej v St Ives. Pomyslíte si, že prechádzka do krčmy by bola fajn; potom si v polovici spomeniete, že trvá 4 hodiny, a to je už pridlho.	It’s one of those you might decide upon casually, perhaps the morning after a night in St Ives, thinking a walk to a pub would be nice; then halfway through you remember it’s four hours long and that’s quite a long time.	0.507353
Po pár hodinách sa z mysu stáva pobrežie divokého Atlantiku.	After a couple of hours, the headland becomes wild Atlantic coast.	0.271154
Dolu môžete zazrieť tulene, vyhrievajúce sa na čiernych skalách pri ľadovo studenej tyrkysovej vode.	You might see seals below, basking on black rocks by turquoise, ice-cold water.	0.211765
Zvažujete, že zleziete dolu útesom, zhodíte zo seba šaty a ponoríte sa do tejto osviežujúcej scény, pripomínajúcej krst, akoby vás pokrstili na nastávajúce dni a obdobia.	You consider scrambling down the cliffside to strip off and dunk yourself in that refreshing scene as a baptism of faith – in the days and seasons to come.	0.368924
Prechádzka sa stáva svojím spôsobom meditáciou; všetko, čo musíte urobiť, je dosiahnuť bod B a opäť nájdete civilizáciu; no zatiaľ vás zamestnávajú vaše kroky, a teda máte aspoň dostatok priestoru a pokoja.	The walk becomes a meditation of sorts, where all that needs to happen is to reach point B and you will find civilisation again; but for now the work of putting one foot in front of the other brings space and peace.	0.480104
Po úplnom vysilení sa vydajte od mora do dediny Zennor. V hostinci z 13. storočia, s nízkym stropom a tlejúcim ohňom, si objednajte nahrubo narezané a posolené hranolčeky a vetrom popraskanými perami srkajte chladené pivo.	Just when you feel thoroughly fatigued you take the path away from the sea to Zennor, and find yourself in a low-ceilinged 13th-century inn with a roaring fire, ordering thick-cut salty chips and sipping cold beer through wind-chapped lips.	0.444444
Anglický spisovateľ D. H. Lawrence označil Zennor za najkrajšie miesto s výhľadom na nekonečný Atlantik ešte krajší ako Stredozemné more. ~~~ Myslím si, že je to najlepšie miesto, ktoré som navštívil.	DH Lawrence called Zennor the most beautiful place”, with a view of the infinite Atlantic … lovelier even than the Mediterranean … It is the best place I have been in, I think. ”	0.108824
Celá prechádzka je o to príjemnejšia, že ju zdoláte na vlastných nohách. ~~~ Je to úžasný spôsob, ako spracovať uplynulý rok a začať nanovo.	Made even lovelier by arriving on foot, the whole walk is a fantastic way to process the year past and begin anew.	0.138889
Zo Zennoru sa dostanete do St Ives taxíkom, alebo sa odvezte autobusom, i keď na Nový Rok žiadne nepremávajú, a tak si môžete urobiť okružnú prechádzku vidieckou krajinou naspäť cez farmu Tremedda a park Trevalgan s celkovou vzdialenosťou 19 km.	On reaching Zennor you can book a taxi back to St Ives, or take the bus, although as there are no buses on New Year’s Day, you could make this a circular walk back through the countryside, via Tremedda and Trevalgan – a total distance of 12 miles.	0.656898
Pri vstupe do údolia Kentmere sa za dedinou Staveley týči dokonalá zelená kupola.	At the entrance to the Kentmere valley a perfect wooded dome rises behind the village of Staveley.	0.458571
Chodník vstupuje pri malej drevenej bráne do lesov Craggy Woods na postrannej ceste do Littlewoodu a následne prechádza po úbočí pod rovnomenným klenutým skaliskom.	The path enters Craggy Woods at a small wooden gate on the back road to Littlewood, then traverses the hillside beneath the eponymous vaulting crags.	0.621905
Trasa je strmá a smerom na juh ponúka výhľad na údolie rieky Kent.	The route winds its way steeply, affording views south over the valley of the River Kent.	0.405195
Je známe, že do lesa Craggy prilietavajú myšiaky, a pri správnych podmienkach môžete počuť, ako sa v teplých vzdušných prúdoch ozýva ich volanie podobné mraučaniu.	Buzzards frequent Craggy, as the wood is known, and with the right conditions they can be heard mewing contact calls as they surf thermals.	0.241026
Výstup až na vrchol stojí za to.	On reaching the top, the rewards are great.	0.188889
Turisti nielenže kráčajú v jednej rovine s korunami prastarých bukov, ale pri pohľade na sever sa im ako na dlani rozprestiera krajina, pripomínajúca tradičnú východnú zenovú záhradu, so skalnatými výbežkami a tôniacimi poľnými hlohmi. ~~~ Pohľad vám padne na vrch údolia Kentmere a na vrcholce hôr Shipman Knotts, Kentmere Pike, Froswick, Ill Bell a Yoke.	Not only do walkers continue at the level of the ancient beech canopy, but looking north, a zen landscape of rocky outcrops and sheltering field hawthorn unfolds, leading the eye into the head of the Kentmere valley and the summits of Shipman Knotts, Kentmere Pike, Froswick, Ill Bell and Yoke.	0.487755
Chodník pokračuje cez údolie tienené starovekými tismi a bukmi, pod nohami vám šuštia zlatisté listy a bukvice, nahromadené z predošlého ročného obdobia a následne prechádza okolo dvoch 120-centimetrových kamenných obeliskov.	The path continues through a sheltered vale of ancient yew and beech, accumulations of last season’s golden leaves and beech mast crunching underfoot, then passes a pair of four-foot- high stone obelisks.	0.453893
Stĺpy označujú polohu vetracích otvorov použitých pri stavbe akvaduktu z Thilmere do Manchesteru.	The pillars mark the position of air-vents used during the construction of the Thirlmere-to-Manchester aqueduct.	0.254651
Tento inžiniersky projekt, uvedený do prevádzky v roku 1894, prenáša vodu 155 kilometrov priamo z centra Lake District do srdca Manchesteru a prechádza priamo pod zalesneným svahom.	This feat of engineering, which opened in 1894, transports water directly from the centre of the Lake District 96 miles into the heart of Manchester, and tunnels directly underneath the wooded hillside.	0.590659
Je to najdlhší spádovo napájaný akvadukt v Británii – na trase nenájdete jediné čerpadlo.	It’s the longest gravity-fed aqueduct in Britain – there’s not a single pump along the route.	0.492208
Inde túto trasu akvaduktu označujú rady čiernych brán vsunutých do kamenných múrov.		-0.3
Na kraji lesa odbočte doprava cez polia do Littlewoodu pozdĺž cestičiek v zadnej časti Craggy.	Elsewhere, a series of black gates inserted into drystone walls mark the ongoing route of the aqueduct.	0.274074
Prejdete popod svahy pohoria Potter Fell a okolo nenápadného plesa, ukrytého za stromom a skalným odkryvom.	At the woodland boundary turn right over the fields to Littlewood, along the lanes at the back of Craggy, passing beneath the slopes of Potter Fell and winding past a discreet little tarn hidden behind an outcrop fusion of rock and tree.	0.493928
Staveley ponúka niekoľko výborných miest, kde sa môžete najesť, od kaviarne Mill Yard’s Wilf’s Café na brehu rieky Kent, pekárne More Bakery alebo ďalej po hlavnej ulici si doprajte pivo a dobré jedlo v reštaurácii Eagle and Child.	Staveley offers a choice of excellent hostelries, from the Mill Yard’s Wilf’s Café, on the banks of the River Kent, More Bakery or, further along the main street, ale and good grub at the Eagle and Child.	1.12227
Krajina je tu premenlivá a počasie vrtošivé, raz tuhý mráz, inokedy čľapkanica. ~~~ Táto prechádzka je dokonalým prechodom do zimného obdobia.	A shifting and moody landscape, one minute frozen solid, then squelching through mud, this is the perfect walk to shift gear into winter.	-0.00775862
Trasa nie je namáhavá, no ak si udáte plynulé tempo, môžete mysľou blúdiť alebo debatovať s občasnými bežcami alebo sólovými turistami, ktorých stretnete.	It’s not a taxing route, but encourages a steady rhythm, allowing the mind to wander and random conversation to ensue while bumping into the odd fell runner or solo walker.	0.275188
Krajinka poskytuje bohatú škálu farieb a štruktúr, pri ktorej je najlepšie jednoducho sa zastaviť a vychutnať si daný okamih a dopriať si potešenie z vami určeného tempa.	The landscape provides a rich tapestry of colours and textures you can’t help but pause to take in, savouring the moment and allowing yourself the pleasure of setting your own pace.	0.39266
Skutočným zážitkom, ktorý vo vás dlho zanechá pocit smelosti, je objavenie pravekého kamenného kruhu The Twelve Apostles (Dvanásť apoštolov). ~~~ Nachádza sa vysoko na vresoviskách, perfektnom mieste na spoločné sledovanie hviezd počas zimného slnovratu.	Long enough to feel virtuous, the real treat is finding The Twelve Apostles, a prehistoric stone circle set high up on the moors, the perfect place for a winter solstice gathering to gaze at the stars.	0.0979839
Predpokladá sa, že pôvodných 20 kameňov sa využívalo na pozorovanie Slnka a Mesiaca, vďaka čomu osadníci z doby bronzovej vedeli, kedy príde zima.	Originally said to have been 20 stones, it is believed it was used to observe the sun and the moon, allowing bronze age settlers to know when winter was coming.	1.6582
Toto fascinujúce a hravé starobylé miesto je ideálnou zastávkou na ceste ku kamenným formáciám Doubler Stones a Ilkley, alebo naspäť do krčmy, kde na vás čaká teplo a dobroty.	This intriguing and playful ancient site is the perfect pit stop before continuing on to either the Doubler Stones and Ilkley, or back to the pub for warmth and rewards.	0.585106
V rokoch 1850 až 1878 bola krčma Dick Hudsons Pub pôvodne hostincom, slávnym svojím jedlom a vínom.	Dick Hudsons Pub was formerly a hostelry that was famous for its food and wine between 1850 and 1878, long before it was taken over by the eponymous Mr Hudson, who was a farmer and food lover.	0.872619
Bolo to dávno predtým, ako ho prevzal jeho menovec, farmár a milovník jedla, pán Hudson.	A cosy country pub complete with roaring log fire, it welcomes muddy boots and paws”.	0.2875
Útulná krčma s tlejúcim ohňom v krbe je otvorená aj pre zablatené čižmy a laby.		-0.3
Vychutnajte si horúcu čokoládu alebo teplú whisky a zahľaďte sa na jeden z najkrajších výhľadov v krajine a naplánujte ďalšie potulky.	Savour a hot chocolate or a warming whisky as you look out onto one of the best views in the country and plan your next ramble.	0.674139
Táto vyše 25 kilometrov dlhá túra prechádza cez jedno z najmalebnejších pobrežných miest a dedín v Severnom Írsku. ~~~ Tvoria ju plážové vyhliadky a vidiecke parky, ktoré ukrývajú poklady a mnoho ďalšieho.	Taking in some of Northern Ireland’s most picturesque coastal towns and villages, this 16- mile trek sees beachy vistas and country parks give way to tucked-away treasures and much more besides.	-0.00818182
Po zhliadnutí prekrásnych scenérií na promenáde v Holywoode sa ráno vydajte k mestu Bangor cez jachtársky klub Royal North Yacht Club.	After taking in postcard-worthy panoramas at the esplanade in Holywood, start off in the morning towards Bangor via the Royal North Yacht Club.	0.963557
V prvej časti, skôr než sa opäť napojíte na pobrežnú cestu, je prechádzka po malom verejnom chodníku sama o sebe odmenou. ~~~ Nádherne členité pobrežie s kľukatými štrkovými i asfaltovými chodníkmi v sebe ukrýva rozkvitnuté zimné kvety, sivé tulene čľapkajúce sa na brehu a morský vánok, ktorý vám pohľadí dušu.	In this first section, navigating a little public footpath before rejoining the coastal path is a pay-off in itself – with the consistent promise of beautifully rugged coastline, by way of winding gravel and asphalt pathways, blooms of winter wildflowers, offshore grey seals and a soul-affirming sea breeze.	0
Klenotom vo vetrom ošľahanom obvode North Down, dokonca i v zime, je rovnako idylická pláž Helen’s Bay Beach v prírodnom parku Crawfordsburn.	A jewel in the crown of windswept North Down, even in winter, Helen’s Bay Beach in Crawfordsburn country park is as idyllic as it comes.	0.930935
Doprajte si čas a pozorujte jemne sa zvažujúce piesočnaté pobrežie, ohraničené zalesnenými výbežkami a lúkami.	Set aside some time to take in its gently shelving sands, which are framed by the wooded headlands and meadows.	0.287097
Potrebujete krátky oddych?	Ready for a little rest?	0.242857
Ukryte sa v dedine Crawfordsburn a zahrejte sa v The Old Inn, kvalitnom boutique hoteli, ktorý vás vyjde raz toľko, ako tradičné B&B za £80 (cca 88 €). ~~~ Nachádza sa na jednej z najstarších diaľnic na ostrove, ktorá vedie z holywoodskeho priorstva do opátstva Parent v Bangore.	Mosey into the village of Crawfordsburn to warm up in The Old Inn, which is also a fine boutique hotel (doubles from £80 B&B) located on one of the island’s most ancient highways, leading from Holywood Priory to the Parent Abbey at Bangor.	0.274469
Ak si chcete prechádzku skrátiť, urobte tak na železničnej stanici Helen’s Bay.	You will find easy access to Helen’s Bay railway station if you wish to cut the walk short here.	0.487291
V opačnom prípade pokračujte k prírodnej pamiatke Orlock Point v lokalite Portavo cez prímorské mesto Bangor.	Otherwise, resume towards Orlock Point in Portavo via the seaside town of Bangor.	1.05
Na konci trasy sa rozprestiera očarujúca spleť poloprirodzených prostredí, ktoré sú domovom širokej škále rastlín a živočíchov. Tu sa vám naskytne nádherný výhľad na Copelandské ostrovy krížom cez Írske more až ku Škótsku.	Offering stunning views of the Copeland Islands, across the Irish Sea towards Scotland, the end of the trail doubles up as an enchanting mosaic of semi-natural habitats which support a rich medley of plants and animals.	0.378506
Stále máte dosť energie?	Still kicking?	0.128571
Výlet zakončite trojkilometrovou prechádzkou po pobreží, kde si napokon odpočiniete v maximálne najútulnejšej krčme Grace Neill’s v mestečku Donaghadee, otvorenej v roku 1611.	A further two-mile amble down the coast to rest up at the supremely cosy Grace Neill’s in Donaghadee will seal the deal.	0.39887
Je to dokonalá krčmička, v ktorej sa schováte pred chladom, vypijete si horúcu whisky a budete rozmýšľať nad boľavými pätami a príjemne strávenom dni.	Opened in 1611, it’s a perfectly secluded little inn to come into from out of the cold, sip a hot whiskey and reflect upon sore heels and a day well spent.	0.655238
Z Orlock Point alebo mesta Donaghadee jazdí každú chvíľu autobus späť na stanicu Bangor alebo ďalej.	From Orlock Point or Donaghadee catch the frequent bus back to Bangor station or beyond.	1.006
Nemôžem si pomôcť, ale keď sa listy vrtule spomalili, dali do zástavovej polohy a zastavili, bol som plný dojmov.	As the propeller blades slowed, feathered and stopped, I couldn’t help but be impressed.	0.221053
Kĺzavý let okolo hôr som zažil už mnoho krát, no nikdy nie s lietadlom, ktoré má maximálnu vzletovú hmotnosť 4 740kg.	I’ve done quite a lot of gliding over and around mountains, but never in an aircraft with a maximum take-off weight (MTOW) of 4, 740kg (10, 449lb).	0.226531
Hneď ako sa priblížite k Pilatusu PC-12NG vám napadne, že s výškou 4, 26 m je to na jednomotorové lietadlo pomerne veľký stroj.	As you approach a Pilatus PC-12NG your initial thought is that, for a single-engine aircraft, it really is quite a big machine.	0.427605
Na priemernej rampe všeobecného letectva prevyšuje väčšinu ostatných lietadiel, dokonca aj tie dvojmotorové.	Standing 4. 26, (13, 9ft), it towers over most of the other aircraft on an average GA ramp, even the twin-engine ones.	0.296907
Švajčiari mali odjakživa reputáciu kvalitných inžinierov. ~~~ Ich precíznosť výroby som uvidel v momente, keď som spolu so skúšobným pilotom Pilatusu Janom Schattemanom kráčal okolo lesknúceho sa PC-12NG.	The Swiss have always had a reputation for quality engineering, and as Pilatus production test pilot Jan Schatteman and I walked around the gleaming PC-12NG, I could see immediately that it was beautifully made.	-0.00169492
Začnem od vrtuľového kužeľa, ktorý je poháňaný turbovrtuľovým motorom PT6A-68P od Pratt & Whitney o sile 1845 konských síl (1, 376 kW).	Starting at the spinner, it is powered by a Pratt & Whitney PT6A-68P turboprop which can produce up to 1, 845shp (1, 376kW).	0.917222
Všetku energiu premieňa na ťah štvorlistá hliníková vrtuľa Hartzell, ktorá má plne nastaviteľnú reverznú a zástavovú polohu.	All the power is converted into thrust via a four-blade aluminium Hartzell prop, which is both fully feathering and reversible.	0.466667
K udržaniu nízkej pádovej rýchlosti slúžia Fowlerove vztlakové klapky s jedným slotom, ktoré tvoria 67% odtokovej hrany, lenže také malé krídelká majú často na svedomí zníženú priečnu riaditeľnosť.	The single-slotted Fowler flaps cover 67% of the trailing edge to keep the stall speed down, but as small ailerons often result in reduced control authority around the longitudinal axis, I wondered if spoilers were fitted to augment the lateral control (as they are on the TBM series).	0.28415
Preto ma zaujímalo, či bol vybavený spoilermi, ktoré by ju mohli zvýšiť (tak ako na sériách TBM).	I was surprised to see that they aren’t, and made a mental note to check the roll rate.	0.253521
Prekvapilo ma, že ich nemá, takže si nesmiem zabudnúť overiť jeho rýchlosť klonenia, aj keby som si to mal zapísať za uši.	The wings feature elegant winglets and I wondered if they contributed to the aileron’s efficiency, possibly by contrasting spanwise flow.	0.392857
Krídla majú elegantné winglety (aerodynamicky zahnuté konce krídel), a napadlo mi, či azda oni neprispeli k účinnosti krídeliek kvôli rozdielnemu prúdeniu vzduchu pozdĺž nich.	The Honeywell weather radar is housed in a pod at the starboard wing tip, while de-ice protection is provided by Goodrich pneumatic boots on the wings and tailplane, and engine bleed-air to the intake.	0.388627
Na vonkajšom konci pravého krídla je umiestnená gondola s meteorologickým radarom od firmy Honeywell.	The windscreen and prop are heated electrically, just like they are in airliners.	0.218571
Odstránenie námrazy zabezpečuje na krídlach a chvoste systém od firmy Goodrich a na nasávaní horúci vzduch z motora. ~~~ Čelné sklo a vrtule sú 23 elektricky vyhrievané, rovnako ako v dopravných lietadlách.	This is a much better method than ducting engine bleed-air onto the screen which is always noisy and less efficient at reduced power during the descent and on the approach – just when you need them.	0.0688864
Je to oveľa praktickejšie, ako hlučné vedenie horúceho vzduchu z motora na predné sklo, ktoré je menej účinné pri zníženom výkone počas zostupu a priblíženia.		-0.3
A práve vtedy potrebujete odstránenie námrazy najviac.		-0.3
Myslím si, že vo viacerých ohľadoch bol PC-12NG navrhnutý a zostavený vysoko nad požadovanými špecifikáciami.	I could see that in many respects the PC-12NG has been designed and built to far higher specifications than it required.	0.471875
Mnohými prvkami pripomína skôr lietadlo dopravnej kategórie, aj keď s maximálnou rolovacou vzletovou hmotnosťou 4760 kg podľa Federálneho leteckého úradu USA (FAA) typovú kvalifikáciu nepotrebuje.	Many of its features are more reminiscent of a transport category aeroplane, although with a maximum ramp weight of 4, 760kg (10, 494lb) the Federal Aviation Administration doesn’t need a type rating.	0.294706
Európska agentúra pre bezpečnosť letectva (EASA) na druhej strane požaduje ako minimum licenciu súkromného pilota (PPL) s povolením na vysokovýkonné letúny (HPA) a typovým výcvikom. ~~~ Ten pozostáva z jedného týždňa teórie a minimálne desiatich hodín letového výcviku (jeden pilot, lietanie podľa prístrojov).	However, the European Aviation Safety Agency requires as the minimum a private pilots’ licence with High Performance Airplane (HPA) endorsement and type rating training, which is typically one week of ground school and a minimum of ten hours flight training (single-pilot, instrument flying rules).	0.0800389
Ako ďalší ma zaujal podvozok.	Next to catch my eye was the undercarriage.	0.173077
Vedel som, že PC-12NG bol osvedčený na prevádzku z nespevnených pristávacích plôch a po tom, ako som si prezrel vzhľadom masívne dvojité vlečné rameno nápravy hlavného podvozku a nízkotlakové pneumatiky, som aj pochopil prečo.	I knew that the PC-12NG had been approved to operate from unprepared landing strips and, having inspected the rugged-looking double trailing link main undercarriage and low-pressure tyres, I could see why.	0.363068
Rozchod kolies je tiež chvályhodne široký (hlavný podvozok sa zasúva do krídel), pričom predný podvozok sa zasúva spätne do trupu.	The wheel track is also commendably wide (the main gear retracts inwards into the wings), while the nose leg retracts backwards into the fuselage.	0.267857
Pri trojkolesovom podvozku som si už povšimol, že predný podvozok poskytuje dosť svetlej výšky pre vrtuľu.	I’d already spotted that (for a tricycle undercarriage) the nosewheel did seem to provide a lot of ground clearance for the prop.	0.244565
Udrží ju tak dokonca aj pri defekte, keď sa predný podvozok zníži, čo je naozaj pôsobivé!	This is maintained even with a flat tyre and the nose leg compressed – very impressive!	0.291781
Lietadlo má aj ďalšie prvky, ktoré nám naznačujú, že je určené pre používanie rovnako zo spevnených tak i nespevnených dráh. ~~~ Sú to výkonné LED pristávacie a rolovacie svetlá na každej podvozkovej nohe a viacero svetiel v úhľadných krytoch na spodku krídla.	Other aspects of the aircraft that indicated it is designed to be used from airstrips as well as airports are powerful LED landing and taxi lights on each undercarriage leg and more lights in neat underwing ‘blisters’.	0.0412744
Teraz mi je jasné, prečo je PC-12 obľúbencom austrálskej leteckej záchrannej služby Royal Flying Doctor Service of Australia, ktorá v súčasnosti prevádzkuje viac ako 30 z nich.	I now understand why the aircraft is such a firm favourite with Australia’s Royal Flying Doctor Service, which currently operates over of them.	0.728689
Keď som sa presunul smerom k chvostu, postrehol som dva brušné a jeden veľký chrbtový stabilizátor, no najviac ma dostali obrie nákladné dvere na zadnej strane krídla.	As I moved towards the tail I noted the two ventral strakes and large dorsal fin, but what really got my attention was the giant cargo door aft of the wing.	0.264567
S rozmermi 1,32 m x 1,35 m sú naozaj obrovské, a keďže sú zavesené za ich hornú časť a dajú sa otvoriť dokorán, je nakladanie a vykladanie vskutku jednoduché.	At 1. 32m (4. 3ft) by 1. 35m (4. 4ft) it is absolutely enormous, and as it opens wide and is hinged at the top it makes loading and unloading very easy.	0.277869
Je prekvapivé, že PC-12 je obľúbencom rovnako u nákladných spoločností, leteckých záchranných služieb a armády, ako aj medzi súkromnými vlastníkmi.	It’s little surprise that the PC-12NG is a favourite with freight companies, air ambulance operators and the military, as well as with private owners.	0.440513
Hneď za kokpitom pred krídlom sú dvere aj so schodíkmi pre pilotov.	There is a pilot’s ‘airstair’ door forward of the wing, immediately aft of the cockpit.	0.210526
Ak používate lietadlo na nákladné účely, môžete využiť celú kapacitu kabíny bez toho, aby ste museli nechať voľný priestor v uličke.	Firstly, if you’re using the aircraft as a freighter you can fill the cabin to capacity without having to leave space for an aisle.	0.288991
Vo väčšine menších dopravných lietadiel sa vyčerpá všetok nákladný priestor ešte pred prekročením ich nosnej kapacity. Z toho dôvodu je Cessna Caravan s pridaným nákladným priestorom takou obľúbenou voľbou.	Most small freighters ‘bulk out’ (run out of space) before they ‘gross out’ (run out of weight-carrying capacity) – which is why the Cessna Caravan’s cargo pod is such a popular option.	0.353548
Okrem iného, správne zatvorenie a zaistenie dverí si väčšina súkromných vlastníkov asi radšej overí osobne.	Secondly, most private owners probably prefer to personally check that the door has been shut and locked correctly.	0.284043
Ďalej som sa zameral na veľký T-chvost (nezvyčajný pre lietadlá tohto typu), ktorý je vybavený mechanickým signalizátorom preťaženia a signalizátorom pádovej rýchlosti.	I next studied the large T-tail (unusual in an aircraft of this class), which is fitted with a stick shaker and a stick pusher.	0.307578
Jana som sa opýtal, ako sa lietadlo správa pri pádovej rýchlosti.		-0.3
S úškrnom na tvári mi odpovedal, že to možno o chvíľu zistím na vlastnej koži!	I asked Jan what the stall was like; he replied with a grin that I would soon find out for myself!	0.235385
Rovnako ako mnohé T-chvostové koncepcie je vybavený aerodynamickým krytom.	Like many T-tail designs, it features a ‘bullet’ fairing.	0.198
Vtedy som sa už nevedel dočkať zistenia, či PC-12NG lieta tak dobre, ako vyzerá.	By now I was itching to find out if the PC-12NG flew as good as it looked.	0.454237
Dva komponenty, ktoré vždy stáli za úspechom PC-12, sú rozmerné nákladné dvere a priestorná kabína. ~~~ Keď som vyšiel hore schodíkmi a vstúpil do lietadla, pochopil som prečo –je obrovská!	The big cargo door and large cabin have always been a major part of the PC-12’s success story, and once I’d got to the top of the airstair and entered the aircraft I could see why – it’s huge!	0.0889113
Dĺžka kabíny (bez kokpitu) je úctyhodných 5, 16 m a so šírkou 1, 52 m a výškou 1, 45 m je nesmierne priestorná.	The cabin’s length (excluding the cockpit) is a generous 5. 16m (16. 9ft), and with a width of 1. 52m (4. 98ft) and a height of 1. 45m (4. 7ft), it is extremely spacious.	0.39
V zadnej časti kabíny je batožinový priestor, ktorý má kapacitu 1, 13 m³.	At the back of the cabin is the baggage compartment, which has a capacity of 1. 13m3 (39. 9ft3).	0.217742
Je vyhrievaný, pretlakovaný a plne prístupný za letu.	It is heated, pressurised and fully accessible in flight.	0.280851
Vynikajúce je aj prevedenie toalety.	Another excellent feature is the design of the lavatory.	0.154545
Nachádza sa hneď za pilotnou kabínou, je uzatvorená z oboch strán a má skladacie dvere.	This is immediately aft of the cockpit, and is closed off on both sides by folding doors.	0.3
V mnohých lietadlách sa používajú namiesto dverí závesy, čo vám príliš súkromia rozhodne nedá.	Many aircraft use curtains instead of doors, which is certainly not as private.	0.238235
V PC-12 to vymysleli lepšie.	The PC- 12’s is a much better idea.	0.252
Spolu s Janom sme prešli do kokpitu.	Jan and I now made our way into the cockpit.	0.251613
Sedadlá sú naozaj pohodlné a ponúkajú viacero nastavení (pohybovať sa dá dokonca aj s opierkami na ruky a opierky na hlavu majú 6 polôh).	The seats are extremely comfortable and offer plenty of adjustment (even the armrests move, while the headrests have six positions).	0.297368
Pedále smerového riadenia sa dajú taktiež rôzne prispôsobiť. ~~~ Je dobre, že aj keď sedadlá pre cestujúcich majú trojbodový zadržiavací systém, tie pre pilotov majú štvorbodové popruhy.	The rudder pedals also adjust over a good range, while I fully approve of the fact that although the passenger seats have threepoint restraint systems, the pilot’s seats have four-point harnesses.	-0.0065625
PC-12 je jedna rodina s veľkými jednomotorovými turbovrtuľovými lietadlami, ako sú Caravan a TBM 900, no predáva ho najmä to, že je certifikovaný na prevádzku jedným pilotom a určený hlavne pre súkromných pilotov.	In common with other large single-engined turboprops, such as the Caravan and TBM 900, one of the PC-12NG’s biggest selling points is that it is certified for single-pilot operation and so very much aimed at the owner-pilot.	0.553167
Ďalej som sa začal vŕtať v ovládacích prvkoch a prístrojoch kokpitu, a bol som veľmi zvedavý na jeho používateľskú prívetivosť.	Consequently, as I began to study the instruments and controls I was curious to see how user-friendly the cockpit was.	0.273
Prístrojovú dosku vybavili pokročilým systémom Honeywell Primus Apex.	The instrument panel is fitted with the advanced Honeywell Primus Apex suite.	0.947619
Skladá sa zo štyroch rovnako veľkých LCD displejov, z čoho dva sú primárne letové displeje (PFD) a zvisle uprostred dosky sú ďalšie dva multifunkčné displeje (MFD), ktoré poskytujú situačnú informovanosť a systémové údaje.	This consists of four identically-sized liquid crystal display screens – two are primary flight displays (PFDs) and the other two (used as multi-function displays [MFDs], one each for systems and situational awareness) are mounted vertically in the centre of the panel.	0.238743
S uhlopriečkou 255 mm ich ľahko prečítate dokonca aj pri ostrom slnečnom svetle.	Each screen has a diagonal size of 255mm (10in) and is easy to read, even in bright sunlight.	0.265217
Obrazovky sa dajú šikovne rozdeliť v pomeroch 1/6, 1/3 alebo 2/3. ~~~ Každá časť zobrazuje rôzne údaje, ako napríklad výkon motora alebo navigačné informácie.	Cleverly, each screen can be sub-divided into 1/6th, 1/3rd or 2/3rd sections, with each containing different data, such as engine parameters or navigation information.	-0.0111111
Rovnako tu nájdete aj údaje o konfigurácii lietadla, napríklad jeho vyváženie či polohu klapiek a podvozku.	Aircraft configuration, for example trim, undercarriage and flap position, is also shown here.	0.263855
Je to veľmi elegantný a intuitívny systém, no keďže každú jednu z troch individuálnych ikoniek pozície podvozku môže zobraziť sedem rôznych displejov, bol by som veľmi rád, keby sa mi tie tri kontrolky podarilo nájsť.	It’s a very elegant and intuitive system, yet although each one of the three individual undercarriage position icons can show seven different displays, I’d still also like to see three lights adjacent to the undercarriage selector.	0.445471
Čo sa týka analógových prístrojov, tie tu vôbec nenájdete. ~~~ Záložné prístroje tvorí malý, samostatný záložný systém ESIS (Emergency Standby Instrument System ) naľavo od kapitánovho PFD.	There are no analogue instruments at all, as the back-up instrumentation consists of a small, selfcontained Emergency Standby Instrument System to the left of the captain’s PFD.	0.277928
Tento šikovný prístroj zobrazuje polohu, rýchlosť a výšku letu, a v prípade málo pravdepodobnej úplnej elektrickej poruchy je schopný fungovať ďalej vďaka zabudovanej batérii.	This neat little unit displays attitude, speed and altitude, and can run off its own integral battery in the unlikely event of a total electrical failure.	0.366923
Pod dolným MFD displejom je alfanumerická klávesnica pre systém riadenia letu (FMS) s ovládačom kurzora na konci plynovej páky.	An alpha/numeric keypad for the flight management system (FMS) is located below the lower MFD, with a large cursor control device aft of the power control lever.	0.379091
Jan mi predviedol programovanie FMS pohybom kurzora pomocou guľového ovládača, pričom vstupy potvrdíte tak isto, ako na ktoromkoľvek počítači- tlačidlom enter.	Jan demonstrated how to programme the FMS by moving the cursor with the track ball, while inputs are confirmed by using the ‘enter’ softkey, as you would on any computer.	0.568442
Ukázalo sa, že jeho ovládanie je jednoduché a intuitívne.	It appeared to be both easy and intuitive.	0.183333
Keďže kabína je bezdrôtová, vstupné údaje je možné vložiť rýchlo a jednoducho. ~~~ Je to užitočné najmä pri programovaní FMS, keď je letový plán zložitejší, alebo obsahuje viacero krajín.	As the flight deck is wireless it is possible to input data swiftly and simply – useful when programming the FMS with multiple sectors or a particularly complex flight plan.	0.0737525
Páku na ovládanie vrtule tu nenájdete, pretože je plne automatické.	There isn’t a prop lever.	-0.204545
Jej rýchlosť nikdy nepresiahne príjemných, pomalých (a tichých) 1700ot/min.	Instead, prop control is automatic, and prop speed never exceeds a nice, slow (and quiet) 1, 700rpm.	0.225
Výstražný systém posádky je ďalším prvkom v lietadle, ktorý je typický skôr pre dopravné lietadlá.	Another transport category-type feature fitted to the aircraft is the Crew Alerting System.	0.28125
Hneď nad PFD displejmi rozumne umiestnili červenú hlavnú výstražnú kontrolku Master Warning a oranžovú výstražnú kontrolku Master Caution, kým sila preťaženia je zobrazená na MFD.	There are red ‘Master Warning’ and orange ‘Master Caution’ lights, sensibly sited just above the PFDs, while the nature of the out-of-limits condition is displayed on the system’s MFD.	0.413462
Prepínače pre väčšinu z elektrických systémov, ako sú napríklad vonkajšie svetlá, štartér a generátor, sú na hornom paneli, ako u mnohých lietadiel s turbínovým pohonom.	As on many turbine-powered aircraft, the switches for most of the electrical systems – such as the external lights, starter and generator – are in the overhead panel.	0.287143
Spolu s pákami na riadenie výkonu, polohy klapiek a stavu paliva nesie stredová konzola iba niekoľko prepínačov a reostatov vnútorného osvetlenia.	The centre console carries just a few switches and rheostats for the internal lights, along with the power lever, fuel condition lever and flap selector.	0.429277
Ovládacia páka riadenia je obsypaná prepínačmi a gombíkmi, a dokonca je tu aj západka, ktorú musíte vytiahnuť, aby sa uvoľnilo riadenie.	The control yoke is liberally studded with switches, buttons and even a trigger, which must be pulled to allow use of trim control.	0.417273
Jeden obzvlášť nápadný prvok kokpitu je veľkosť a robustnosť prepínačov (väčšinou veľkých spínačov).	One particularly noticeable aspect of the cockpit is how big and robust the switches (mostly large rockers) are.	0.276404
Napadlo mi, či by azda namiesto trochu nevýraznej sivej neboli lepšie farebne rozlíšené prepínače.	However, I did wonder if perhaps the switches would be colour- coded rather than the somewhat anonymous gray.	0.275581
Pozorne som sledoval, ako Jan prosto a jednoducho naštartoval motor.	Jan started the engine, while I watched closely.	0.504762
Stačí prepnúť na batérie, potom potlačiť tlačidlo štart, a pri 15 % Ng (rýchlosť generátora plynu) posunúť palivovú páku na voľnobeh na zemi.	The start sequence is very straightforward – simply switch on the batteries, then press ‘start’, and at 15%Ng (gas generator speed) move the fuel condition lever to ‘ground Idle’.	0.22
Motor nabehol okamžite, takže sme prešli na predvzletovú kontrolu.	The engine lit promptly, and we moved onto the pretake- off checks.	0.289474
Tá zahŕňa kontrolu systémov ochrany pred pádom (mechanický signalizátor preťaženia a signalizátor pádovej rýchlosti), vysunutie klapiek na 15° a nastavenie trimerov.	These included checking the stall protection system (remember it has a stick-shaker and a stick-pusher) lowering the flaps to 15° and setting the trims.	0.672168
Eventuálne jedinečným a neobvyklým zážitkom je križovanie rušnej cesty počas rolovania z továrne Pilatus na letisko Buochs.	Taxying from the Pilatus factory to Buochs airport is an unusual and possibly unique experience as you cross a busy road.	0.615686
Semafory však hrajú do karát pilotovi (ako by aj mali), takže dlhému čakaniu som sa vždy vyhol.	However, the traffic lights are (properly) biased in the pilot’s favour, and I’ve never had a long wait.	0.27
Rolovanie bolo veľmi plynulé vďaka ovládaniu predného podvozku pomocou pedálov riadidla a pokrokovým, silným hydraulickým brzdám.	Taxying was very easy because the nosewheel steers through the rudder pedals and the hydraulic brakes are both powerful and progressive.	0.294783
Hoci som sa na plynovej páke presvedčil, že som zastavil voľnobeh, lietadlo malo stále prebytok ťahu a malo tendenciu rolovať rýchlejšie, ako by som sám chcel.	Although I ensured that the power lever was on the idle stop, in common with most turboprops there’s so much thrust that it wanted to taxi faster than I did.	0.286047
U väčšiny turbovrtuľových lietadiel je to bežné.		-0.3
Nechcel som namáhať brzdy, takže som radšej pritiahol plynovú páku späť do polohy medzi letovým voľnobehom a maximálnym spätným ťahom.	Rather than ride the brakes, I pulled the power lever up over the gate and back into the ‘Beta’ range.	0.185714
Pri približovaní k dráhe som posunul palivovú páku do polohy letový voľnobeh a opatrne som roloval na pozíciu.	Approaching the runway I pushed the fuel condition lever to ‘Flight Idle’ and carefully taxied into position.	0.3
Zarovnaný do osi s 2000 m dlhou dráhou 07 letiska Buochs som zvýšil výkon oproti brzdám.	Having lined up on Buochs’ 2, 000m (6, 561ft) runway 07, I brought the power up against the brakes.	0.267568
Zbežne som sa pozrel na veternomerný rukáv, ktorý ukazoval mierny bočný vietor z ľavej strany. ~~~ Kým okolité podmienky boli v súlade s Medzinárodnou štandardnou atmosférou (ISA), hustota vzduchu bola asi ako vo výške 457 m .	A glance at the windsock showed a gentle crosswind from port, while as ambient conditions were essentially International Standard Atmosphere (ISA) we had a density altitude of about 1, 500ft (457m).	-0.0186391
S dvoma pasažiermi na palube, bez batožiny a so 750 kg kerozínu Jet A-1 v nádržiach sme boli približne 1040 kg pod maximálnou vzletovou hmotnosťou a s ťažiskom značne vpredu.	With two passengers on board, no baggage and 750kg (1, 653lb) of Jet A-1 in the tanks we were around 1, 040kg (2, 292lb) below the MTOW, with a fairly forward centre of gravity.	0.588254
Pod velením som mal výkon na hriadeli o sile 1200 konských síl, takže výborná akcelerácia nebola prekvapením.	With 1, 200shp at my command the acceleration was unsurprisingly excellent.	0.172727
V PC-12NG, na rozdiel od iných turbovrtuľových lietadiel v ktorých som letel, nemusíte sledovať krútiaci moment.	Unlike most of the other turboprops that I’ve flown, in the PC-12NG you don’t have to monitor the torque gauge, as the torque limiter automatically protects the engine.	0.165306
Motor je automaticky chránený obmedzovačom krútiaceho momentu, takže som len pomaly potlačil plynovú páku dopredu až na doraz, a sústredil som sa na udržanie smeru.	Instead, I just smoothly pushed the power lever forward to the stop and concentrated on keeping straight.	0.13
Aj napriek bočnému vetru som nemal problém sledovať os.	Tracking the centreline was easy, despite the crosswind.	0.2875
Rýchlosť som nabral za okamih a rotoval som pri 157 km/h.	The airspeed increased quickly and I rotated at 85kts (157km/h).	0.25
Zaujalo ma, ako zdanlivo málo sa zdvihne nos lietadla pri rotovaní. ~~~ Možno je to len očný klam, pretože kryt motora sa smerom od kokpitu zvažuje dolu.	It was interesting to note how little the pitch attitude seems to change at rotation, but this could be an optical illusion as the long cowling slopes down and away from the cockpit.	-0.0283465
Potom som zasunul podvozok, zapol tlmič kmitov okolo zvislej osi a zatiahol klapky.	I then retracted the undercarriage, engaged the yaw damper and raised the flaps.	0.286957
Vyvažovanie trimerom sa po zasunutí podvozku nejak výrazne nezmenilo. ~~~ To prišlo po zatiahnutí klapiek a lietadlo mi pripadalo zľahka vyrovnanejšie, aj keď je trochu pretrimované (teda pokiaľ ste nezabudli spustiť trimer).	The undercarriage comes up with no discernible change in pitch trim, but as the flaps retract, the trim changes and the aircraft seems to ‘settle’ slightly; although it’s easily trimmed out (as long as you remember to pull the trigger before operating the trimmer).	-0.0224227
Výkon hriadele o sile 1200 konských síl vytvára roztáčaním štvorlistej vrtule značnú precesiu a efekt asymetrie listov vrtule (p-faktor).	The 1, 200shp turning a big four-blade prop produces considerable amounts of precession and P-factor (asymmetric blade effect).	0.43357
Preto, ak by ste bez tlmičov kmitov okolo zvislej osi chceli zachovať neutrálne rozloženie sily na pedále a ručičku sklonomeru centrovanú, museli by ste upravovať vyváženie smerovky vždy jednak pri zmene nastavenia vzdušnej rýchlosti, alebo výkonu.	Consequently, without the yaw damper you’d have to adjust the rudder trim whenever you changed either the airspeed or power setting if you wanted to keep the pedal forces neutral and the slip ball centred.	0.226744
So zapnutým tlmičom automatika udržiava ručičku sklonu v strede, aj keď spočiatku ma trochu znepokojoval pocit, že sa mi pod nohami hýbu pedále riadenia.	With the yaw damper engaged, the automatics keep the slip ball centred, although initially it’s slightly disconcerting to feel the rudder pedals moving under your feet.	0.270229
Lietadlo som nechal rýchlo akcelerovať na 240 km/h. ~~~ Sme relatívne ľahkí, takže rýchlosť stúpania je fenomenálna a čochvíľa sme vo výške troch kilometrov.	I let the aircraft quickly accelerate to 130kts (240km/h), and as we’re relatively light the rate of climb is phenomenal, and we’re soon at 10, 000ft (3, 048m).	0
Skúšky všeobecnej riaditeľnosti odhalili svižnosť v klonení s prekvapivo slabým odporom riadiacej páky.	An examination of the general handling revealed the roll rate to be brisk, and with surprisingly low stick forces.	0.283696
Čítal som, že skoršie modely sa klonili o dosť ťažšie. ~~~ No jednou zo zmien, ktorú Pilatus predviedol v roku 2006, bolo nainštalovanie pomocného kormidla v každom krídelku.	I had read that earlier models were rather heavy in roll, but one of the changes Pilatus installed in 2006 was a servo-tab in each aileron.	0.0608333
Na tak veľký stroj sa s ním pri manuálnom ovládaní lieta veľmi príjemne. Všimol som si taktiež dobré zosúladenie riadenia a vynikajúca bola aj stabilita letu s voľným riadidlom.	For such a big machine, I thought it very pleasant to ‘hand fly’, and noted that the control harmony was also good, while the stick-free stability is outstanding.	0.372566
Jan ma posmelil, aby som naplno využil PFD. Zistil som, že keď nasmerujem a podržím symbol ukazovateľa dráhy letu na orientačnej čiare roviny horizontu, tak neklesnem ani o meter.	Jan encouraged me to make full use of the PFD, and I found that if I placed and held the flight path marker icon on the horizon’s ‘zero-pitch’ reference line then I don’t lose a foot of altitude.	0.486184
Keďže PC-12NG má T-chvost, je vybavený mechanickým signalizátorom preťaženia a signalizátorom pádovej rýchlosti.	Because the PC-12NG has a T-tail, it is fitted with both a stick-shaker and a stick- pusher.	0.635065
Na nábežnej hrane každého z vonkajších krídel je elektricky vyhrievaná lopatka meradla uhlu nábehu. ~~~ Keď sa jej merania priblížia ku kritickým hodnotám, spustí sa zvukové varovanie a aktivuje sa mechanický signalizátor preťaženia.	There is an electrically heated angle of attack vane in the outboard leading edge of each wing, and when this senses the alpha is approaching a critical value the stall warner sounds and the stick-shaker actuates.	-0.00866325
Pokiaľ nedošlo k nápravnému opatreniu, aktivuje sa signalizátor pádovej rýchlosti.	If no recovery action is taken then the stick-pusher fires.	0.164706
Ten potlačí knipel dopredu silou cca 28 kg.	This pushes the control yoke forward with a force of around 28kg (61lb).	0.105405
Keďže sme boli ľahkí, podarilo sa mi s klapkami na 40° spomaliť na indikovanú vzdušnú rýchlosť 120km/h. Potom sa už aktivoval mechanický signalizátor preťaženia, a v 111 km/h aj signalizátor pádovej 28 rýchlosti.	As we were a good way below MTOW, with the flaps at 40° I managed to get the indicated airspeed down to almost 65kts (120km/h) before the shaker activated, while the pusher fired at about 60kts (111km/h).	0.455169
To sú pekne nízke rýchlosti na veľké lietadlo, ktoré dokáže uháňať rýchlosťou 500km/h vo výške viac ako 9km.	These are pretty slow speeds for an aircraft this big that can cruise at up 270kts (500km/h) and 30, 000ft (9, 144m).	0.283696
PC-12NG je výnimočný stroj nielen kvôli tomu, že jeho živlom je výškový let.	The PC-12NG is very much a ‘going places’ machine, and not only is it in its element at altitude but sometimes favourable winds can add 100kts (185km/h) to the groundspeed.	0.14967
Priaznivé vetry mu totiž môžu pridať niekedy aj 185km/h na traťovej rýchlosti. ~~~ Keďže vďaka tzv. severným vetrom zažíva väčšia časť severnej Európy na pár dní obzvlášť dobrú viditeľnosť, z výšky 9000 m je výhľad na Alpy ohromujúci.	For a few days most of northern Europe had experienced particularly good visibility because of a so-called ‘Polar plume’ of Arctic air that had swept down from the north and, from 30, 000ft above the Alps, the view is stupendous.	-0.00471204
Jan mi ukazuje, kde je Rakúsko, Francúzsko, Nemecko a Taliansko.	From our lofty perch Jan points out Austria, France, Germany and Italy.	0.545942
Maximálna cestovná rýchlosť je 518 km/h, no omnoho typickejšia a efektívnejšia je rýchlosť v rozmedzí od 463 do 481 km/h.	The maximum cruise speed is 280kts (518km/h), but a more representative and efficient speed is between 250-260kts (463- 481km/h).	0.423786
Pri vonkajšej teplote -44 °C sú podmienky v súlade s ISA a pri rýchlosti 472 km/h spaľujeme iba nejakých 225 kg/h.	With an outside air temperature of - 44 °C (-47. 2°F) conditions are essentially ISA, and at 255kts (472km/h) we’re only burning around 225kg/h (496lb/h).	0.322679
Jan mi nariadil vykonať núdzový zostup akoby v prípade zlyhania pretlakového systému.	Jan then directs me to perform an emergency descent as if the pressurisation has failed.	0.530769
Keď pritiahnete plynovú páku úplne k sebe, vrtuľa vyvinie určitý aerodynamický odpor, čo je u turbovrtulákov bežné. ~~~ Aj bez nadmernej rýchlosti sme ľahko dosiahli veľmi vysokú rýchlosť klesania (43 m/s).	As with most turboprops, if you pull the power right back, the prop generates loads of drag, and it was easy to achieve a very high descent rate (8, 500ft per minute/43m per second) without excessive speed.	-0.00438596
Všetko čo môžem povedať k pretlakovému systému je, že som nikdy nepostrehol kedy bežal. A presne tak to má byť.	As for the pressurisation, all I can say is that I never noticed it working – which is exactly what you want.	0.286517
Vyrovnal som to vo výške 3657 m a Jan prebral riadenie.	I level out at 12, 000ft (3, 657m) and Jan takes control.	0.543478
Poznám spôsob, ako môžeme ušetriť ešte viac paliva smial sa.	There’s a way we can burn even less fuel, he grins.	0.228571
Počas brífingu mi vysvetlil, že na skúšobných letoch v rámci výroby a údržby motorov firemní skúšobní piloti počas letu vypnú, a znovu naštartujú motor. ~~~ Robia to však iba ak majú v dosahu kĺzavého letu hlavné letisko Pilatusu.	During the briefing Jan had explained that on production test flights and engine change-related maintenance flights, company test pilots perform an in- flight shutdown and re-light within the glide-cone of Pilatus’s base airfield.	-0.00466321
Vidím, že sme prakticky nad Buochs, takže po informovaní riadenia letovej prevádzky o našich zámeroch Jan pritiahol palivovú páku späť. ~~~ Roztočená vrtuľa sa spomalila a jej štyri listy sa dali do zástavovej polohy.	I can see we’re practically overhead Buochs, so having informed air traffic control of our intentions, he pulls the fuel condition lever back, the prop disc turns into four blades which slow and feather – and we’re in a 3, 600kg (7, 936lb) glider, high above the Alps.	0.0404503
Sme v 3600 kg klzáku vysoko nad Alpami. ~~~ Ako skúsený pilot klzáku som si automaticky všímal našu rýchlosť, mieru klesania a výšku.	As an experienced sailplane pilot I automatically note our speed, sink rate and altitude, and then do a quick ‘final glide’ calculation.	0.124026
Potom som spravil rýchly výpočet nášho doplachtenia.		-0.3
Letíme rýchlosťou 212 km/h v cestovnej výške 9144 m, pričom klesáme približne o 240 m/min. ~~~ To znamená, že motor by sme mali znovu nahodiť asi o 30 minút. ~~~ Ak by motor nenaskočil, čo je veľmi nepravdepodobné, mohli by sme letieť kĺzavým letom asi 96 km.	We’re gliding at 115kts (212km/h) while sinking at 800ft/min (‘eight down’ in glider parlance) which means that we would have 30 minutes from a 30, 000ft cruising altitude to restart the engine.	0.464146
To nám umožňuje doletieť nielen na viacero vhodných letísk, ale aj do niekoľkých rôznych krajín. ~~~ Otočili sme to na Grenchen, letisko kategórie všeobecného letectva pri meste Bern.	In the extremely unlikely event of it not restarting we could glide around 60 miles (96km), enabling us to not only reach many suitable airports, but even several different countries.	-0.000967742
Autopilot predviedol perfektné presné priblíženie pomocou barometrickej vertikálnej navigácie (známej aj ako Baro-VNAV), aj keď zrovna táto dráha je kvôli jej pozemným navigačným prostriedkom vhodná skôr na vizuálne priblíženie (má iba všesmerový rádiomaják VHF).	We head off to Grenchen, a GA airfield close to Bern, where the autopilot flies a perfect precision approach (aka ‘Coupled Baro-VNAV’) even though the groundbased navaids make this particular runway non-precision (it only has VHF omri-range/ distance measuring equipment).	0.296104
Návrat na Buochs bol počas perfektnej viditeľnosti jednoduchý. ~~~ V nepriaznivejšom počasí by sa osvedčil systém Apex, ktorý vám poskytne mimoriadnu situačnú informovanosť. ~~~ Oceníte ho najmä keď je v letiskovom okruhu 2133 m vysoký vrch Mount Pilatus, a vy letíte v smere vetra na dráhu 25.	Returning to Buochs was easy in the great visibility, but in more inclement weather the exceptional situational awareness provided by the Apex system would’ve been much appreciated, particularly as the 7, 000ft (2, 133m)-tall Mount Pilatus is inside the circuit when you’re downwind for runway 25.	-0.0664912
Jan predvádza pozoruhodné pristátie na krátkej dráhe s plným spätným ťahom a potom som na rade ja.	Jan demonstrates a remarkable shortfield landing with full reverse and then it’s my turn.	0.676623
Podvozok i klapky sa vysunuli hladko, no lietadlo trochu stúplo po tom, ako klapky dosiahli 40°.	The undercarriage and flaps both extend smoothly, although the aircraft does balloon slightly as the flaps reach 40ş.	0.230488
Jan odporúča udržiavať symbol ukazovateľa dráhy letu na okraji virtuálnej pristávacej dráhy (PFD využíva syntetický obraz) a kontrovať rýchlosť pomocou ťahu.	Jan recommends placing the flight path marker symbol on the virtual runway’s threshold (remember the PFD uses synthetic vision) and then controlling the speed with power.	0.555336
Po trochu nepodarenom letmom pristátí bolo druhé pristátie veľmi hladké.	This works out pretty well, and after a smooth touch-and-go the second landing is very gentle.	0.225
Keď som dal plynovú páku na spätný ťah, zastavili sme až prekvapivo rýchlo.	Pull the power control lever into reverse and we stop amazingly quickly.	0.290323
Moje druhé pristátie mi trošku nafúklo ego, no Jan mi ho vzápätí akosi spľasol konštatovaním, že ďakovať môžem vlečnému ramenu podvozku. To by som bol asi naozaj umelec, keby som s ním pristál zle.	I’m rather pleased with my second landing, although Jan deflates my ego somewhat by pointing out the trailing-link undercarriage is a flatterer, and that you actually have to apply yourself to make a bad landing.	0.445974
Teraz chápem, prečo je PC-12NG taký obľúbený.	In conclusion, I can see why the PC-12NG is so popular.	0.63
Keď to mám zhrnúť, je to skutočne stroj pre pánov pilotov, má dobrý výkon a jemné ovládanie.	It truly is a pilot’s aeroplane, with good performance and fine handling.	0.464103
Vždy mám pokušenie porovnávať lietadlá medzi sebou, najmä ak majú rovnaké motory.	There’s always a temptation to compare an aircraft with another, particularly if they are both powered by the same engine.	0.160563
Neviem si však vybaviť žiadne iné jednomotorové turbovrtuľové lietadlo na ktorom som letel, ktoré je schopné prepraviť taký ťažký náklad (alebo 9 pasažierov), a vzlietnuť z krátkej, nespevnenej dráhy do výšky 3333 m.	However, I cannot think of any other single-engined turboprop I’ve flown that is capable of hauling such a heavy load (or nine passengers) or flying over 1, 800nm (3, 333km) from a short, unprepared runway.	0.367426
Robiť tu nejaké porovnávania je naozaj zbytočné. PC-12NG vo svojej triede nemá konkurenciu.	Comparisons are meaningless – the PC-12NG is, quite literally, in a class of its own.	0.480952
Rýchlosťou, ktorou pritom môže letieť aj hodiny na nízkych otáčkach, by PC-12 mohol byť ideálnou viacúčelovou platformou, a vyvinul lietadlo schopné niesť rôzne senzory.	With its excellent range, large cabin and ability to cruise at high speed yet loiter for hours on end at low speed, Pilatus realised that the PC-12 would make an ideal multimission platform and it developed a variant of the aircraft to carry different sensors.	0.397143
Pôvodne známy ako Eagle (Orol), dnes nazývaný Spectre (Prízrak), disponuje zaťahovacím senzorom a úžitkovým priestorom pre 7 pasažierov, ktorý štandardne zahŕňa 30 aj konzolu pre operátora senzoru.	Originally known as Eagle and now called Spectre, this model features a retractable sensor platform and a seven-passenger utility interior, including a sensor operator’s console, as standard.	0.503442
Spectre je však väčšinou vyrobený podľa konkrétnych požiadaviek zadávateľa.	However, most Spectres are custom-tailored to the user’s specific mission requirements.	0.255882
Typická konzola operátora pozostáva z dvoch monitorov, digitálneho videorekordéra, komunikačného panela a riadenia zdvíhacej plošiny. ~~~ Rozširujúce panely však umožňujú pridanie ďalších prijímačov a dátových spojení.	A typical operator console incorporates two display monitors, a digital video recorder, a communications panel and a lift-platform control, although multiple expansion bays allow additional radios and data links.	0.0872635
Sedadlo operátora môže byť bezpečne obsadené počas vzletu a pristátia vďaka nafukovaciemu zadržiavaciemu systému.	The operator’s seat is equipped with an Inflatable Restraint System, allowing it to be safely occupied during take-off and landing.	0.264356
Platforma senzoru je umiestnená v chvostovom kuželi lietadla a počas letu môže byť vytiahnutá a zatiahnutá späť.	The sensor platform is housed in the aircraft’s tail cone and it can be extended and retracted in flight.	0.269318
Pri nasadení poskytuje 360° zorné pole a po zatiahnutí je krytá dvojicou dvierok.	Once deployed it provides a full 360ş field of view, and when retracted it is covered by a pair of doors.	0.445714
Spectre je schopný niesť elektro-optické a infračervené senzory a rovnako tak aj viacpásmový radar so syntetickou apertúrou. ~~~ Kabínu je možné rýchlo prekonfigurovať odstránením konzoly operátora, keďže na mieste ju držia západky a zväzok káblov má samostatnú, rýchlo odpojiteľnú zástrčku.	As well as electro-optical and infrared sensors, the Spectre can also carry the Multi-Band Synthetic Aperture Radar, while the cabin can be rapidly reconfigured by removing the operator’s console – the wiring harness uses a single quickdisconnect plug and the console is held in place by latches.	0.0646198
Viacero vzdušných síl a vládnych agentúr využíva Spectre pre rôzne operácie, vrátane spravodajstva, sledovacích a prieskumných misií, hraničného dozoru, boja proti pašovaniu drog a humanitárnej pomoci.	Spectres are operated by many air forces and government agencies and have been used for a wide variety of operations, including intelligence, surveillance and reconnaissance missions, border surveillance, drug enforcement and disaster relief.	0.353484
Bol to celkom zaujímavý pohľad – asi 243 centimetrov vysoká a meter široká kopa konárov a stromčekov bola pokrytá bahnom a machom.	It was quite a sight: a mound of branches and saplings, about eight feet high by 35 feet across, plastered with mud and moss and sitting in a waist-high lake surrounded by marsh.	0.590395
Nachádzala sa v jazere, ktoré človeku siaha asi po pás, v jazere obklopenom močiarom.	The water had been diverted from the river by a series of dams.	0.178846
Vodu z rieky odvádzali priehrady.		-0.3
Tape a Wald chceli preskúmať Alatnu, pretože sprievodca, ktorý pracuje pre Walda, už predtým našiel pozdĺž rieky Nigu drevo obhryzené bobrami.	Tape and Wald had wanted to explore the Alatna in part because a guide who works for Wald had earlier found beaver-chewed wood along the Nigu River.	0.845455
Rieka Nigu pramení na opačnej strane kontinentálneho rozvodia, neďaleko horného toku Alatny, pri jazere Gaedeke. ~~~ Ďalej tečie na sever, vlieva sa do rieky Colville a Severného ľadového oceánu.	The Nigu starts near Gaedeke Lake, the Alatna headwaters, but on the other side of the Continental Divide—and so it flows north into the Colville River and the Arctic Ocean.	0.0709914
Pozdĺž rieky Alatna, nad tzv. Lodge Mahal, sme našli ďalšie rybníky a opustené priehrady.	Along the Alatna, above Lodge Mahal, we found other ponds and abandoned dams.	0.892857
Tape si teraz myslí, že bobry sú na ceste k oblasti North Slope a že Alatnou prechádzajú cez pohorie Brooks Range.	Tape now thinks that beavers are on their way to the North Slope, and that they’re using the Alatna as a route through the Brooks Range.	0.928134
Túto expanziu sledujeme akoby v priamom prenose, uviedol.	We’re seeing this expansion in real time, he said.	0.244186
Nevie dokázať, že takéto zmeny spôsobuje zmena podnebia. ~~~ Výskyt bobrov ovplyvnil aj koniec obchodu s kožušinou pred 150 rokmi.	He can’t prove that climate change is driving it; the beaver population also has been rebounding since the end of the fur trade, a century and a half ago.	-0.0216216
V každom prípade, títo zubatí stavitelia by mohli výrazne zmeniť ráz permafrostu.	But in any case, the bucktoothed engineers could significantly remake permafrost landscapes.	0.253521
Predstavte si, že by ste boli vývojárom a povedali by ste si, že chcete povolenie na vybudovanie troch priehrad na každý druhý prúd v arktickej tundre, povedal Tape.	Imagine if you were a developer and you said, I’d like permission to put three dams on every other stream in the Arctic tundra, Tape said.	0.345322
Takto nejako to môže byť.	That’s what this could be like.	0.231818
Tape videl malú ukážku.	Tape has seen a preview.	0.9
Fotografie prítoku rieky Serpentine, ktorá sa nachádza juhovýchodne od mesta Shishmaref na aljašskom Sewardovom polostrove, nepoukazujú v období od roku 1950 a 1985 na žiadne zmeny.	Southeast of Shishmaref, on Alaska’s Seward Peninsula, photos of a tributary of the Serpentine River show no change at all between 1950 and 1985.	0.457073
Do roku 2002 sa sem nasťahovali bobry a krajina sa zaplavila.	By 2002 beavers had moved in and flooded the landscape.	3.26809
Do roku 2012 sa časť pôdy zrútila a zmenila sa na mokrade.	By 2012 some ground had collapsed and become wetlands.	3.59362
Permafrost sa strácal.	Permafrost was on its way out.	0.978571
