Aféra BALCO poukázala na to, že dopingové testy boli jedna veľká fraška.	BALCO showed that drug testing was a farce.	0.430631
Bývalá atletická hviezda Marion Jonesová pri rozhovore s médiami, ktoré čakali pred federálnym súdom, po tom, ako sa priznala, že klamala federálnemu agentovi o užívaní dopingu.	Above, former track star Marion Jones pauses while speaking to the waiting media at Federal Court after pleading guilty to lying to a federal agent about her drug use.	0.383254
Jej vzorka bola pozitívna na THG, za čo jej odobrali 5 medailí, ktoré vyhrala na letnej olympiáde v roku 2000.	She tested positive for THG and was stripped of five medals won at the 2000 Summer Olympics.	0.241558
Odkedy sa začali robiť dopingové testy boli Tour de France, najstaršie a najprestížnejšie cyklistické preteky, plné škandálov.	The Tour de France, the oldest and most prestigious race in cycling, has been riven by scandal since drug testing was introduced.	0.794495
Napríklad v roku 1998 sa pred začatím pretekov našlo auto plné látok na zlepšenie športovej výkonnosti, ktoré patrilo francúzskemu tímu Festina.	In 1998, for example, a car full of performance- enhancing drugs belonging to the French Festina cycling team was found before the race.	0.273913
Všetci deviati cyklisti Festiny sa priznali, že používali erytropoetín (EPO, hormón, ktorý stimuluje tvorbu červených krviniek, čím zvyšuje vytrvalosť).	All nine Festina riders confessed to using erythropoietin (EPO, a hormone that stimulates red blood cell production and is taken to increase stamina).	0.436047
Po následnom vyšetrovaní bolo zo systematického dopingu podozrivých mnoho ďalších tímov Tour de France, pričom niektoré z pretekov aj odstúpili.	A resulting investigation cast suspicion of systemic doping on many teams of the Tour de France; several withdrew from the race.	0.538925
Američan Floyd Landis sa pôvodne stal víťazom Tour de France v roku 2006, ale po víťazstve v 17. etape boli obidve jeho vzorky moču pozitívne na zakázaný syntetický testosterón, a tak mu víťazstvo odobrali.	American Floyd Landis initially won the 2006 Tour de France, but after his Stage 17 victory, his urine twice tested positive for banned synthetic testosterone and he was stripped of the win.	0.637386
V roku 1996 bol svetovou jednotkou ďalší Američan Lance Armstrong, ktorý v tom istom roku prekonal rakovinu semenníkov.	Another American, Lance Armstrong, was number one in the world in 1996, the same year he recovered from testicular cancer.	0.612877
V roku 2005 po tom, čo po siedmykrát vyhral Tour de France, bol obvinený z dopingu. Vysvitlo, že jeho tímoví kolegovia si pichali EPO, čo iba zosilnilo mieru jeho obvinení.	In 2005, after winning his seventh Tour de France, he was accused of doping; that his teammates had been caught taking EPO gave weight to the accusations.	0.586545
V roku 2012 mu odobrali všetky tituly z Tour de France od roku 1998.	In 2012, he was stripped of his Tour de France titles since 1998.	1.14603
O rok na to sa Armstrong v televíznom rozhovore s Oprah Winfreyovou ku všetkému priznal.	The next year, Armstrong admitted to doping in a televised interview with Oprah Winfrey.	0.896
Floyd Landis, víťaz pretekov Tour de France, počas výsluchu na Pepperdinskej univerzite v roku 2007, kde ho obvinili z dopovania.	Above, Floyd Landis, winner of the 2006 Tour de France, listens during the hearing at Pepperdine University in 2007 at which he was accused of doping.	0.973745
Ako sa Lance Armstrong dokázal väčšinu svojej športovej kariéry vyhýbať dopingovým testom?	How did Lance Armstrong elude drug testing for much of his career?	0.632967
Jedným z jeho riešení bolo jednoducho utekať a schovávať sa kedykoľvek sa dopingoví komisári chystali prísť.	One strategy was simply running away and hiding when drug testers came calling.	0.185294
Profesionálny cyklista vždy musí svoju národnú antidopingovú agentúru upovedomiť o mieste svojho pobytu. ~~~ Pokiaľ udá mesto, v ktorom sa nachádza, nikto mu nebude vyčítať, ak práve nebude k dispozícii.	Professional cyclists must let their national antidoping agencies know of their whereabouts at all times, but as long as they accurately reported the cities they were in, they were not reprimanded for being unavailable.	-0.0112069
Armstrong často dostával varovania, keď sa ho chystali testovať, a tak narýchlo odišiel niekam inam, alebo sa zdržiaval na odľahlých miestach, kde nebolo ľahké ho nájsť.	Armstrong often received advanced warning that he was to be tested and changed his travel plans or stayed in remote locales, which made tracking him down a challenge.	0.511508
Taktiež používal sofistikované metódy, ktorými maril prácu komisárov.	He also used sophisticated techniques to thwart testers.	0.222
Jednou z nich bolo maskovanie nedovolených látok pomocou infúzie fyziologického roztoku, vďaka ktorému sa hodnoty v jeho krvi vrátili do normálu.	In one, drug masking, an infusion of saline was used to return his blood values to normal levels.	0.133333
Okrem toho užíval látky, ktoré boli nevystopovateľné, napr. EPO. ~~~ Pre túto látku v 90. rokoch neexistoval žiaden test.	And he used drugs that were untraceable, such as EPO, for which there was no test in the 1990s, when he began to take it.	-0.00765306
Neskôr test vyvinuli, ale Armstrong prišiel na to, že keď si nebude EPO vpichovať podkožne ale do žily a v malých dávkach, výsledky testov budú negatívne.	When a test was developed, Armstrong found that injecting small doses into a vein rather than subcutaneously produced a negative result.	0.675758
Museli by ste byť výskumníkom z National Institutes of Health [vládny výskumný inštitút Spojených štátov], aby ste porozumeli tomu, ako to spravil.	You'd need to be a researcher at the National Institutes of Health to understand how he did it, says Dr Yesalis.	0.872141
Až tak dôkladne to mal premyslené, hovorí Yesalis.	It was that sophisticated.	0.05
Lance Armstrong rozpráva Oprah Winfreyovej o svojej kontroverznej kariére (14. 1. 2013).	Above, on January 14, 2013, Lance Armstrong speaks to Oprah Winfrey regarding the controversy surrounding his cycling career.	0.873077
Biogenesis of America bola zdravotná klinika, ktorá sa špecializovala na úbytok hmotnosti a hormonálnu substitučnú liečbu. ~~~ Fungovala iba krátky čas v meste Coral Gables na Floride.	Biogenesis of America, a health clinic specializing in weight loss and hormone replacement therapy, operated briefly in Coral Gables, Florida.	0.242484
Písal sa rok 2013 (ten istý rok, čo sa Lance Armstrong ku všetkému priznal Oprah), keď niekoľko hráčov Major League Baseball obvinili z toho, že si obstarávali rastový hormón z kliniky Biogenesis.	In 2013, the same year that Lance Armstrong confessed all to Oprah, a scandal erupted when several Major League Baseball players were accused of obtaining human growth hormone from Biogenesis.	0.876987
Suspendovali trinástich hráčov na 50 a viac zápasov. ~~~ Boli to Alex Rodriguez, Antonio Bastardo, Everth Cabrera, Francisco Cervelli, Nelson Cruz, Fautino de los Santos, Sergio Escalona, Fernando Martínez, Jesús Montero, Jordan Norberto, Jhonny Peralta, César Puello a Jordany Valdespin. ~~~ Išlo o najviac súčasne suspendovaných hráčov v dejinách bejzbalu.	Thirteen players received suspensions of 50 games or more, including Alex Rodriguez, Antonio Bastardo, Everth Cabrera, Francisco Cervelli, Nelson Cruz, Fautino de los Santos, Sergio Escalona, Fernando Martínez, Jesús Montero, Jordan Norberto, Jhonny Peralta, César Puello, and Jordany Valdespin—the most simultaneous suspensions in baseball history.	0.689608
Obranca tímu New York Yankees Alex Rodriguez na tlačovej konferencii pre médiá, zatiaľ čo bol suspendovaný pre údajné užívanie steroidov z kliniky Biogenesis.	Above, New York Yankees third baseman Alex Rodriguez addresses the media in 2013 while facing suspension by Major League Baseball for his alleged use of steroids made by the Biogenesis clinic in Florida.	0.848358
Užívanie dopingových látok je podľa všetkého medzi elitnými športovcami veľmi rozšírené.	By many accounts, drug use in elite athletes is not just common, it's pervasive.	0.251471
Jeden odborník v správe Nezávislej cyklistickej reformnej komisie z roku 2015 odhaduje, že až 90 % profesionálnych cyklistov užíva látky na zvýšenie športovej výkonnosti.	In a 2015 Cycling Independent Reform Commission report, one expert estimated that 90% of professional cyclists take performance-enhancing drugs.	0.400394
V tom istom roku trojnásobnej víťazke bostonského maratónu z Kene Rite Jeptoovej zakázali pretekať na 2 roky po tom, čo odovzdala vzorku pozitívnu na EPO.	That same year, Kenya's Rita Jeptoo, a three-time Boston Marathon champion, was banned from competition for 2 years after testing positive for EPO.	1.7881
V roku 2015 Svetová antidopingová agentúra uverejnila správu, podľa ktorej je v ruskom športe na všetkých úrovniach hlboko zakorenené podvádzanie.	Also in 2015, a report commissioned by World Anti-Doping Agency indicated a deeply rooted culture of cheating at all levels in Russian sport.	0.28
V marci roku 2016 ruská tenisová hviezda Marija Šarapovová neprešla dopingovým testom.	In March 2016, Russian tennis star Maria Sharapova admitted to failing a drug test.	0.278873
Užívala meldónium, ktoré sa používa na liečbu ischémie, ale taktiež zvyšuje vytrvalosť.	She had been taking meldonium, which is used to treat ischemia but can also improve endurance.	0.288312
Zo súťaží ju suspendovali na 2 roky.	She was suspended from competition for 2 years.	4.32823
21. 7. 2016 Medzinárodná asociácia atletických federácií zakázala celému ruskému družstvu ľahkej atletiky štartovať na olympiáde v Riu, a to pre štátom podporované užívanie steroidov.	On July 21, 2016, Russia's entire track and field team was banned by the IAAF from competing in the Rio Olympics for taking state-endorsed steroids.	0.216
Predpokladá sa, že aj iné štáty sponzorujú podobné programy.	Other countries are also believed to sponsor such programs.	0.294231
Hráči tímu New York Yankees, nadhadzovači Roger Clemens a Andy Pettitte. ~~~ V správe z roku 2007 známej ako Mitchell Report boli obvinení z užívania amfetamínov, anabolických steroidov a rastového hormónu (STH).	Above, New York Yankees pitchers Roger Clemens and Andy Pettitte, accused in the 2007 Mitchell Report of taking amphetamines, anabolic steroids, and human growth hormone (HGH).	0.8837
Pettitte sa neskôr priznal, že užíval STH.	Pettitte later admitted to taking HGH.	0.702101
Clemens všetko poprel.	Clemens denied ever taking drugs.	0.921429
Dňa 24. 7., menej ako dva týždne pred začatím OH v Riu, sa Medzinárodný olympijský výbor postavil proti návrhu, podľa ktorého by nikto z ruskej výpravy nesmel na olympiáde v Riu štartovať, a to napriek tomu, že Svetová antidopingová agentúra s istotou potvrdila, že ruská vláda viedla najväčší dopingový program v histórii medzinárodného športu, čo je v úplnom rozpore so športovým duchom, ako napísal denník The New York Times.	On July 24, less than 2 weeks before the start of the Rio Games, the IOC ruled against barring Russia across the board from the Rio Olympics, even though, as the New York Times noted, the World Anti-Doping Agency confirmed beyond a reasonable doubt that the Russian government ran the biggest criminal doping program in the history of international sport, demeaning every notion of what athletic competition stands for.	0.463758
MOV prenechal rozhodnutie o tom, či majú ruskí športovci súťažiť v jednotlivých disciplínach na 28 samostatných športových federáciách.	Instead, the IOC will defer to 28 individual federations that govern each sport regarding whether to let Russian athletes compete in their disciplines.	2.00911
Zatiaľ čo sa Medzinárodná asociácia atletických federácií rozhodla z hier ruské družstvo v ľahkej atletike vylúčiť, mnoho iných športových federácií, vrátane gymnastickej a tenisovej, dovolilo ruským športovcom zúčastniť sa.	While the IAAF has ruled that Russia's track and field team will be banned from Rio, many sports federations, among them gymnastics and tennis, have declared that Russian athletes should be allowed to compete.	0.266102
Ruská vlajka.	Above, the Russian flag.	0.0923077
Yesalis pred Kongresom Spojených štátov svedčil ohľadom legislatívnych záležitostí kontroly zneužívania anabolických steroidov a rastového hormónu športovcami už niekoľkokrát.	Dr Yesalis has testified before Congress multiple times on legislation related to the control of anabolic steroid and growth hormone abuse by athletes.	0.385385
Čo s tým môžeme urobiť?	What can we do about this?	0.27
Absolútne nič, usúdil.	Not a damn thing, he concludes.	0.214286
Nestačí im pozerať sa na to najlepšie na olympijských hrách alebo na akomkoľvek inom športovom podujatí svetového formátu.	It's not enough for them to watch the Olympics or any elite sporting event to see the very best.	0.355363
Chcú vidieť superľudí a nadľudské výkony.	They want bigger-than-life people doing bigger-than-life things.	0.121622
Nechcú sa pozerať na talentovaných športovcov, ktorí vyzerajú ako priemerný chlapík alebo ženská.	They don't want to see an average-looking guy or gal who's a gifted athlete.	0.196875
Chcú neobyčajných ľudí.	They want people who don't look normal.	0.136364
Chcú postavy z marveloviek.	They want characters out of Marvel Comics.	0.156
A doping im to dokáže dať.	Drugs allow that.	0.1875
Obranca tímu New York Jets LaRon Landry, ktorý váži 103 kg a údajne dokáže v tlaku na lavičke vytlačiť 228 kg, pričom patrí k tým menším hráčom v National Football League.	Above, New York Jets safety LaRon Landry, who weighs 226 pounds and can reportedly bench 503 pounds, is one of the smaller guys in the National Football League.	1.10968
Ako vaše internetové návyky znečisťujú ovzdušie.	Why your internet habits are not as clean as you think.	0.286364
Svet internetu nám umožňuje posielať správy, zdieľať obrázky, sťahovať hudbu a vysielať videá jediným kliknutím.		-0.3
Budete prekvapení, ale to, ako sa správate online, má veľký vplyv na životné prostredie. ~~~ Je pravdepodobné, že ste dnes už odpovedali na niekoľko emailov, poslali zopár správ cez Messenger a možno ste si rýchlo niečo vyhľadali na internete.	The internet allows us to send messages, share pictures, download music and stream videos at a touch of a button, but our online habits have a surprising impact on the environment.	0.0330469
V priebehu dňa bezpochyby strávite ešte viac času surfovaním na webe, nahrávaním obrázkov, prehrávaním hudby a vysielaním videí.	It’s probable you’ve already replied to a couple of emails today, sent some chat messages and maybe performed a quick internet search.	0.452538
Každá z týchto činností však so sebou prináša aj svoju obeť. ~~~ Tou je niekoľko gramov oxidu uhličitého.	As the day wears on you will doubtless spend even more time browsing online, uploading images, playing music and streaming video.	-0.0375
Uvoľňujú sa následkom spotreby energie, ktorú vaše zariadenia potrebujú k činnosti a poháňa bezdrôtové siete, na ktoré ste napojení.	Each of these activities you perform online comes with a small cost – a few grams of carbon dioxide are emitted due to the energy needed to run your devices and power the wireless networks you access.	0.319565
Menej očividné, ale azda energicky náročnejšie, sú dátové centrá a rozsiahle servery, ktoré sú oporou internetu a uchovávajú obsah, ktorý navštevujeme.	Less obvious, but perhaps even more energy intensive, are the data centres and vast servers needed to support the internet and store the content we access over it.	0.288636
Napriek tomu, že množstvo energie potrebné na jedno vyhľadanie na internete alebo jeden email je malé, v súčasnosti využíva internet približne 4,1 miliárd ľudí, čo je 53,6 % celkovej populácie.	Although the energy needed for a single internet search or email is small, approximately 4.1 billion people, or 53.6 % of the global population, now use the internet.	0.556773
Zlomky tejto energie a s nimi súvisiace skleníkové plyny, ktoré sa uvoľnia pri každej činnosti na internete, môžu narastať.	Those scraps of energy, and the associated greenhouse gases emitted with each online activity, can add up.	0.250549
Odhaduje sa, že uhlíková stopa našich zariadení, internetu a ich podporných systémov sa podieľajú približne na 3,7 % celosvetových emisií skleníkových plynov.	The carbon footprint of our gadgets, the internet and the systems supporting them account for about 3.7% of global greenhouse emissions, according to some estimates.	0.291304
Mike Hazas, výskumný pracovník Lancasterskej univerzity tvrdí, že ide o podobné množstvo, aké celosvetovo vyprodukuje letecký priemysel .	It is similar to the amount produced by the airline industry globally, explains Mike Hazas, a researcher at Lancaster University.	0.588762
Predpokladá sa, že tieto emisie sa do roku 2025 zdvojnásobia.	And these emissions are predicted to double by 2025.	0.246667
Pri výrobe a sprístupnení digitálnych technológií medzi používateľov po celom svete, je vyprodukovaných približne 1,7 miliárd ton emisií skleníkových plynov. ~~~ Ak by sme toto množstvo rozrátali na jedného internetového používateľa, prišli by sme k záveru, že každý z nás je zodpovedný za tvorbu 414 kilogramov oxidu uhličitého ročne.	If we were to rather crudely divide the 1.7 billion tonnes (1.6 billion tons) of greenhouse gas emissions estimated to be produced in the manufacture and running of digital technologies between all internet users around the world, it means each of us is responsible for 414kg (912lbs) of carbon dioxide a year.	-0.0155769
Avšak, nie je to také jednoduché. ~~~ Táto hodnota je všade vo svete iná.	But things are not that simple – this figure can vary depending where in the world you are.	-0.0375
Používatelia internetu majú v niektorých oblastiach Zeme neprimerane veľkú uhlíkovú stopu.	Internet users in some parts of the globe will have a disproportionately large footprint.	0.284416
Podľa jednej štúdie bol pred 10 rokmi do atmosféry vylúčený ekvivalent 81 kilogramov oxidu uhličitého (CO2), za ktoré bol zodpovedný priemerný austrálsky používateľ internetu.	One study estimated that 10 years ago, the average Australian internet user was responsible for the equivalent of 81kg (179lbs) of carbon dioxide (CO2) being emitted into the atmosphere.	0.408235
Skvalitnenie energetickej účinnosti, úspor z rozsahu a využívanie energie z obnoviteľných zdrojov toto množstvo bezpochyby zníži. ~~~ Je však zrejmé, že za väčšinový podiel internetovej uhlíkovej stopy sú zodpovední ľudia z vyspelých krajín.	Improvements in energy efficiency, economies of scale and use of renewable energy will doubtless have reduced this, but it is clear that people in developed nations still account for the majority of the internet’s carbon footprint.	-0.00913706
(CO2 je jednotka, ktorá vyjadruje množstvo skleníkových plynov, ktoré má taký vplyv na klímu ako kilogram oxidu uhličitého).	(CO2 is a unit used to express the carbon footprint of all greenhouse gases together as if they were all emitted as carbon dioxide).	0.452339
Niektorí ľudia si uvedomili, že svojou internetovou aktivitou poškodzujú planétu a rozhodli sa konať.	For some, the realisation that their online activity is harming the planet has spurred them into taking action.	0.279775
Všetko, čo dokážeme spraviť pre znižovanie emisií CO2, je dôležité. ~~~ Dokonca aj maličkosť akou je naše správanie na internete, hovorí Philippa Gautová, učiteľka v meste Surrey vo Veľkej Británii.	Anything we can do to reduce carbon emissions is important, no matter how small, and that includes how we behave on the internet, says Philippa Gaut, a teacher from Surrey, UK.	0.0227064
Patrí do rýchlo rastúcej skupiny ekologicky uvedomelých spotrebiteľov, ktorí sa snažia znížiť svoj vplyv na životné prostredie online a používaním svojich telefónov.	She is one of a growing number of eco-conscious consumers trying to reduce their environmental impact online and on their phones.	0.477273
Gautová dodáva: Efektívnejšie by bolo, keby každý robil takéto maličkosti.	If everybody made changes, it would have more impact, she adds.	0.233333
Jednou z prekážok pri riešení problému uhlíkovej stopy je, že ľudia sa nevedia zhodnúť na tom, čo by malo byť stredobodom záujmu, aby sa predišlo škodlivému vplyvu našich internetových návykov.	One of the difficulties in working out the carbon footprint of our internet habits is that few people can agree on what they should and should not include.	0.216279
Mali by sa sem zahrnúť aj emisie, ktoré sa vyprodukujú pri výrobe výpočtovej techniky?	Should it include the emissions that come from manufacturing the computing hardware?	0.3
A čo emisie vytvárané zamestnancami a budovami technologických spoločností?	And what about those from the staff and buildings of technology companies?	0.28125
Spochybňujú sa aj hodnoty týkajúce sa prevádzky dátových centier.		-0.3
Veľa z nich využíva energiu z obnoviteľných zdrojov, no stále sa nájdu také, ktoré kupujú tzv. uhlíkovú kompenzáciu, aby zredukovali svoju spotrebu energie.	Even the figures around the running of data centres are disputed – many run on renewable energy, while some companies buy carbon off-sets to clean up their energy use.	0.288889
Zatiaľ čo veľa spoločností poháňa svoje dátové centrá pomocou energie z obnoviteľných zdrojov, stále vo svete nájdeme miesta, kde sú z veľkej časti poháňané spaľovaním fosílnych palív.	While many companies claim to power their data centre’s using renewable energy, in some parts of the world they are still largely powered from the burning of fossil fuels.	0.26875
V USA sú dátové centrá zodpovednéza 2 % celkovej spotreby elektrickej energie v krajine, zatiaľ čo v celosvetovom rozsahu sa podieľajú na spotrebe takmer 200 terawatthodín (TWh).	In the US, data centres are responsible for 2% of the country’s electricity use, while globally they account for just under 200 terawatt Hours (TWh) .	0.346825
Podľa Medzinárodnej telekomunikačnej únie, ktorá je súčasťou Organizácie Spojených národov, však táto hodnota zostala v posledných rokoch aj napriek zvýšenému internetovému prenosu dát a nadmernému zaťaženiu siete stabilná.	According to the United Nation’s International Telecommunications Union, however, this figure has flatlined in recent years despite rising internet traffic and workloads.	0.206
A to najmä z dôvodu zlepšenia energetickej účinnosti a centralizácie dátových centier do obrovských stredísk.	This is largely because of improved energy efficiency and the move to centralise data centres into giant facilities.	0.475
Kým veľa spoločností tvrdí, že poháňa svoje dátové centrá pomocou energie z obnoviteľných zdrojov, stále vo svete nájdeme miesta, kde sú z veľkej časti poháňané spaľovaním fosílnych palív.	But while many companies claim to power their data centre’s using renewable energy, in some parts of the world they are still largely powered from the burning of fossil fuels.	0.269388
Pre spotrebiteľov je náročné vybrať si to pravé dátové centrum.	And it can be difficult for consumers to choose which data centres they want to use.	0.490909
Avšak, mnohí významní poskytovatelia cloudových služieb sa zaviazali, že znížia svoje uhlíkové emisie. ~~~ Jedným z mnohých riešení bolo uchovávanie fotografií, dokumentov a v prípadoch, keď to bolo možné, prevádzkovanie služieb mimo ich serverov.	Many of the major cloud providers, however, have pledged to cut their carbon emissions, so storing photos, documents and running services off their servers where possible is one approach to take.	0.0173302
Ako jednotlivci môžeme uhlíkovú stopu svojich technológií znížiť napríklad tým, že si prestaneme kupovať stále nové a nové príslušenstvo.	As an individual, simply upgrading our equipment less often is one way of cutting the carbon footprint of our digital technology.	0.272727
Množstvo skleníkových plynov, ktoré sa vyprodukuje pri výrobe a preprave týchto zariadení, tvorí výraznú časť emisií z celkovej životnosti konkrétnej elektroniky.	The greenhouse gases emitted while manufacturing and transporting these devices can make up a considerable portion of the lifetime emissions from a piece of electronics.	0.43007
Na základe istej štúdie z Edinburskej univerzity sa zistilo, že predĺženie času používania jediného počítača a monitorovzo štyroch na šesť rokov dokáže predísť vzniku ekvivalentu 190 kilogramov emisií CO2.	One study at the University of Edinburgh found that extending the time you use a single computer and monitors from four to six years could avoid the equivalent of 190kg of carbon emissions.	0.362025
Aby sme znížili svoju digitálnu uhlíkovú stopu, môžeme zmeniť spôsob, akým využívame svoje elektronické zariadenia.	We can also alter the way we use our gadgets to cut our digital carbon footprints.	0.15
Najjednoduchšou cestou je posielať správy ekologickejšie.	One of the easiest ways is to switch they way we send messages.	0.294231
Podľa Mika Berners-Leeho, pracovníka na Lancasterskej univerzite, ktorý sa venuje výskumu uhlíkových stôp, vás asi neprekvapí, že uhlíková stopa emailu sa tiež dramaticky líši. ~~~ A to od 0, 3 gramu za nevyžiadanú poštu (spam) až po 4 gramy CO 2 e za obyčajné správy a 50 gramov CO 2 e za email s fotografiou alebo veľkou prílohou.	Perhaps unsurprisingly, the footprint of an email also varies dramatically, from 0.3 g CO2 for a spam email to 4g (0.14oz) CO2 for a regular email and 50g (1.7oz) CO2 for one with a photo or hefty attachment, according to Mike Berners-Lee, a fellow at Lancaster University who researches carbon footprints.	-0.0105058
Avšak tieto hodnoty platili pred desiatimi rokmi.	These figures, however, were crunched by Berners-Lee 10 years ago.	0.204545
Charlotte Freitagová, expertka na uhlíkové stopy v Small World Consulting spoločnosti založenej Berners-Leem hovorí, že vplyv emailovania sa mohol zvýšiť.	Charlotte Freitag, a carbon footprint expert at Small World Consulting, the company founded by Berners-Lee, says the impact of emailing may have gone up.	0.717121
Myslíme si, že uhlíková stopa jednej správy je v súčasnosti vyššia ako kedysi, a to najmä preto, že ľudia používajú väčšie telefóny, dodáva.	We think the footprint per message might be higher today because of the bigger phones people are using, she says.	0.224211
Na základe starších hodnôt niektorí ľudia odhadli, že ich práca s emailom vyprodukuje 1,6 kilogramu CO2 denne.	Based on the older figures, some people have estimated that their own emails will generate 1.6kg (3.5lb) CO2 in a single day .	0.435088
Sám Berners-Lee vyrátal, že typický komerčný používateľ vytvorí posielaním emailov 135 kilogramov CO2 ročne. Táto hodnota sa rovná 322 kilometrovej jazde rodinným autom.	Berners-Lee himself also calculated that a typical business user creates 135kg (298lbs) CO2 from sending emails every year, which is the equivalent of driving 200 miles in a family car.	0.531757
Nemal by však byť problém tieto hodnoty zredukovať.	But it should also be easy to cut this down.	0.225
Jednoduché vynechanie ďakovných emailov nám dokáže ušetriť nespočetné množstvo emisií CO2.		-0.3
Ak by každý dospelý človek vo Veľkej Británii poslal o jednu zbytočnú ďakovnú správu menej, predišli by sme tak tvorbe 16 433 ton uhlíka ročne.	By simply stopping unnecessary niceties such as thank you emails we could collectively save a lot of carbon emissions.	0.243564
Podľa energetickej spoločnosti OVO je to rovnaké množstvo, ako keby sme z ciest odstránili 3 334 dieselových áut.	If every adult in the UK sent one less thank you email, it could save 16, 433 tonnes of carbon a year – the equivalent to taking 3, 334 diesel cars off the road, according to energy company, OVO.	0.42713
Berners-Lee dodáva: Napriek tomu, že uhlíková stopa emailu nie je obrovská, slúži ako skvelý názorný príklad väčšieho princípu. ~~~ Tento princíp nám hovorí, že odstrániť z nášho života zbytočný odpad je dobré nielen pre našu duševnú pohodu, ale aj pre životné prostredie.	While the carbon footprint of an email isn’t huge, it’s a great illustration of the broader principle that cutting the waste out of our lives is good for our wellbeing and good for the environment, Berners-Lee says.	-0.0142959
Ďalšími spôsobmi, ako zmenšiť svoju digitálnu uhlíkovú stopu, je vymeniť pripájanie príloh za odkazy na súbory, prestať posielať správy viacerým príjemcom a odhlásiť sa z odberu stránok, ktoré už nesledujeme.	Swapping email attachments for links to documents and not sending messages to multiple recipients are another easy way to reduce our digital carbon footprints, as well as unsubscribing from mailing lists we no longer read.	0.285
Hneď ako som sa dozvedel o uhlíkovej stope, ktorú produkuje posielanie emailov, odhlásil som sa z odberu všetkých automaticky generovaných informačných bulletinov. ~~~ Je to desivé, hovorí Gaut.	I unsubscribed from automatically generated newsletters, as when I learned about the carbon footprint from emails, I was horrified, says Gaut.	-0.0243902
Teraz si dávam väčší pozor na to, aké stránky majú prístup k môjmu emailu. ~~~ Pomohlo mi to uvedomiť si, aký veľký dosah môže mať taká bežná vec.	Now, I’m careful not to send out my email to new websites… it’s made me consider the impact more.	0.0428571
Podľa odhadov služby Cleanfox, ktorá sa zaoberá ochranou pred nežiadúcou poštou, priemerný používateľ dostane 2 850 nevyžiadaných správ ročne len kvôli predplatnému stránok.	According to estimates by antispam service Cleanfox, the average user receives 2, 850 unwanted emails every year from subscriptions, which are responsible for 28.5kg (63lbs) CO2.	0.546053
Toto množstvo je zodpovedná za 28,5 kilogramu CO2.		-0.3
Ak by každý dospelý človek vo Veľkej Británii poslal o jednu zbytočnú ďakovnú správu menej, predišli by sme tak tvorbe 16 433 ton uhlíka ročne. ~~~ Je to rovnaké množstvo, ako keby sme z ciest odstránili 3 334 dieselových áut.	If every adult in the UK sent one less thank you email, it could save 16, 433 tonnes of carbon a year – the equivalent to taking 3, 334 diesel cars off the road.	0.0568182
Posielanie SMS správ je zrejme najekologickejšia alternatíva ako zostať v spojení s ľuďmi, pretože každá správa vytvorí iba 0,014 gramov CO2.	Choosing to send an SMS text message is the perhaps the most environmentally-friendly alternative as a way of staying in touch because each text generates just 0.014g of CO2.	0.511252
Príspevok na Twitteri má uhlíkovú stopu 0,2 gramu CO2 (aj keď táto informácia nebola Twitterom potvrdená), avšak Freitag odhaduje, že posielanie správ prostredníctvom súkromných četovacích aplikácií, akými sú WhatsApp alebo Messenger od Facebooku, je len o niečo menej uhlíkovo náročné ako posielanie emailov. ~~~ Tieto hodnoty sa odvíjajú od toho, čo posielate.	A tweet is estimated to have a footprint of 0.2g CO2 (although Twitter did not respond to requests to confirm this figure) while sending a message via a private messaging app such as WhatsApp or FacebookMessenger is estimated by Freitag to be only slightly less carbon intensive than sending an email.	0.0927489
Či už súto animované obrázky GIF, smajlíky alebo obrázky, všetky majú oveľa väčšiu uhlíkovú stopu ako čistý text.	Again this can depend on what you are sending – gifs, emojis and images have a greater footprint than plain text.	0.44832
Freitag tvrdí, že jednominútový telefonický rozhovor má len o niečo väčšiu stopu než posielanie SMS-iek. ~~~ V porovnaní s tým má videokonferencia oveľa väčšiu uhlíkovú stopu.	The carbon footprint of making a one-minute mobile phone call is a little higher than sending a text, according to Freitag, but making video calls over the internet is much higher.	-0.001
Každá minca má však dve strany, preto je dôležité vedieť, kedy je ekologickejšie necestovať na stretnutia autom.	But it is important to remember where it replaces travel to reach meetings, it can be far better for the environment.	0.296907
Rovnaká štúdia dokázala, že videokonferenčný hovor vyprodukuje iba 7 % z celkových emisií osobného stretnutia.	The same study found the video conferencing produced just 7% of the emissions of meeting in person.	0.253571
Podľa ďalšej štúdie je jazda autom vo vzdialenosti menšej ako 20 kilometrov zodpovedná za oveľa väčšie znečistenie ovzdušia ako videokonferencia.	Another study found the impact of a car ride exceeds the impact of a video conference at less than 20km.	0.156977
Vyhľadávanie na internete je ďalšia riziková oblasť.	Internet searching is another tricky area.	0.228947
Podľa údajov zverejnených spoločnosťou Google malo pred desiatimi rokmi každé jedno vyhľadávanie uhlíkovú stopu 0,2 gramov CO2.	A decade ago, each internet search had a footprint of 0.2g CO2, according to figures released by Google.	0.218182
V súčasnosti Google využíva na zníženie uhlíkovej stopy svojich operácií kombináciu energie z obnoviteľných zdrojov a uhlíkovej kompenzácie. ~~~ Na druhej strane Microsoft, ktorý je majiteľom internetového vyhľadávača Bing, sa zaviazal, že do roku 2030 sa stane uhlíkovo negatívnym. ~~~ Momentálne pracujú na tom, aby zistili, či je táto uhlíková stopa v súčasnosti vyššia alebo nižšia.	Today, Google uses a mixture of renewable energy and carbon offsetting to reduce the carbon footprint of its operations, while Microsoft, which owns the Bing search engine, has promised to become carbon negative by 2030, and efforts are underway to investigate whether this footprint is now higher or lower.	-0.0589383
Avšak, podľa údajov Googlu priemerný používateľ jeho služieb, a teda niekto, kto si vyhľadá 25 položiek denne, pozrie si 60 minút videí na YouTube, má účet na Gmaili a používa niektoré ďalšie súvisiace služby, vyprodukuje menej ako 8 gramov CO2 denne.	According to Google’s own figures, however, an average user of its services – someone who performs 25 searches each day, watches 60 minutes of YouTube, has a Gmail account and accesses some of its other services – produces less than 8g (0.28oz) CO2 a day.	0.728571
Novšie internetové vyhľadávače sa už od začiatku snažia odlíšiť od ostatných ako zelenšie alternatívy.	Newer search engines, however, are attempting to set themselves apart as greener options from the outset.	0.296667
Dobrým príkladom je Ecosia.		-0.3
Tento internetový vyhľadávač tvrdí, že za každých 45 vyhľadaní zasadí jeden strom.	Ecosia, for example, says it will plant a tree for every 45 searches it performs.	2.82081
Takáto forma uhlíkovej kompenzácie môže pomôcť odstrániť uhlík z atmosféry. ~~~ Avšak, úspech takýchto projektov závisí od toho, ako dlho tieto stromy budú rásť a čo sa s nimi stane, keď ich zotnú.	This sort of carbon offsetting can help to remove carbon from the atmosphere , but the success of these projects often depends on how long the trees grow for and what happens to them when they are chopped down.	-0.00727273
Bez ohľadu na to, aký internetový vyhľadávač si vyberiete, vyhľadávanie informácií na webe je udržateľnejšie ako vyhľadávanie v knihách.	Regardless of the search engine you choose, using the web to find information is more sustainable than browsing in books.	0.253398
V skutočnosti má kniha v brožovanej väzbe uhlíkovú stopu približne 1 kilogramu CO2, zatiaľ čo víkendové vydanie novín sa podieľa na 0,3 až 4,1 kilogramu CO2. ~~~ Preto môžeme tvrdiť, že čítanie správ na internete je ekologickejšia voľba než zahĺbiť sa do papiera.	In fact, a paperback’s carbon footprint is around 1kg (2.2lbs) CO2, while a weekend newspaper accounts for between 0.3kg (10oz) and 4.1kg (9lbs) CO2 making reading the news online more environmentally friendly than poring over a paper.	-0.01575
Dobrou správou je, že za celý život môžete prečítať ešte veľa kníh, a to presne 2 300. ~~~ Rovnaká uhlíková stopa je cenou za to, že sa letecky dostanete z Londýna do Hong Kongu. A preto nemusíte mať výčitky prečítať si najnovší bestseller.	But you could still read a lifetime of paperbacks – 2, 300 to be precise – for the same carbon footprint as a flight from London to Hong Kong, so don’t feel too guilty for reading the next best seller.	0.0254837
(Viac sa dočítate v článku Ako znížiť vplyv vašich letov na životné prostredie.)	(Read more about how to reduce the impact your flights have on the environment.)	0.295588
Ľudia, ktorých zlákali kryptomeny, by sa tiež mali poriadne zamyslieť nad tým, aký vplyv na životné prostredie majú tieto peňažné transakcie.	Those who have been tempted by cryptocurrencies might also want to think carefully about the environmental impact of the transactions they conduct.	0.424069
Obrovské množstvá výpočtovej kapacity sú potrebné na tzv. proof of work algoritmus, ktorý potvrdzuje transakcie v distribuovanej databáze transakcií spoločnosti Blockchain.	Vast amounts of computing power are needed for the so-called proof of work algorithm that is used to validate transactions on Blockchain's distributed ledger system.	0.685851
V rámci štúdie sa zverejnil odhad, že bitcoin ako taký je zodpovedný za približne 22 miliónov ton emisií oxidu uhličitého ročne, čo je viac ako celková uhlíková stopa Jordánska.	One recent study estimated that BitCoin alone is responsible for around 22m tonnes of carbon dioxide emissions every year – greater than all the carbon footprint of the whole of Jordan.	0.288
Pozeranie online videí tvorí najväčšiu časť internetového prenosu vo svete, a to 60 %, a vytvorí 300 miliónov ton oxidu uhličitého ročne. ~~~ Podľa francúzskej neziskovej organizácie The Shift Project je to približne 1 % celosvetových emisií.	Watching online videos accounts for the biggest chunk of the world's internet traffic – 60% – and generates 300m tonnes of carbon dioxide a year, which is roughly 1% of global emissions, according to French think tank, The Shift Project.	0.190376
Ak si zapnete televízor, aby ste na ňom mohli pozerať Netflix, približne polovica energie bude napájať televízor a druhá polovica bude napájať Netflix, hovorí Mike Hazas z Lancasterskej univerzity.	If you flip on your television to watch Netflix, around half the power goes into powering the TV and half the energy goes into powering Netflix, says Lancaster University’s Mike Hazas.	0.570968
Napriek tomu niektorí odborníci tvrdia, že energia, potrebná na uchovávanie a vysielanie videí, je menšia ako oveľa viac koncentrované výpočtové aktivity vykonávané dátovými centrami.	Some experts, however, insist that the energy needed to store and stream videos is less than more intensive computational activities performed by data centres.	0.247445
Určité množstvo znečistenia klímy spôsobené činnosťou na internete pochádza z vyhľadávania pornografického obsahu.		-0.3
Pornografia tvorí tretinu videoprenosu pričom vyprodukuje rovnaké množstvo oxidu uhličitého ako Belgicko ročne.	Some of the climate pollution that comes from internet use also comes from some rather dirty browsing.	0.255172
Služby video na požiadanie, akými sú napríklad Amazon Prime a Netflix, sa podieľajú na ďalšej tretine tohto znečistenia.	Pornography accounts for a third of video streaming traffic , generating as much carbon dioxide as Belgium in a year.	0.600638
Posledná tretina znečisťujúceho videoprenosu prislúcha pozeraniu videí na YouTube a videoklipov na sociálnych sieťach.	On-demand video services such as Amazon Prime and Netflix account for another third while the final third of the video streaming carbon footprint includes watching YouTube and clips on social media.	0.321698
Netflix tvrdí, že jeho celosvetová spotreba energie dosiahla 451 000 megawatthodín ročne, čo je dostatok energie na napájanie 37 000 domácností. ~~~ Táto spoločnosť však nezaháľa a chce nakúpiť certifikáty pre energiu z obnoviteľných zdrojov a kompenzačné kredity, aby mohla odškodniť akékoľvek množstvo energie pochádzajúce zo zdrojov fosílnych palív.	Netflix says its total global energy consumption reached 451, 000 megawatt hours per year, which is enough to power 37, 000 homes , but insists it purchases renewable energy certificates and carbon offsets to compensate for any energy that comes from fossil fuel sources.	0.0797455
Vysielanie a sťahovanie hudby má tiež svoj vplyv.	Streaming and downloading music also has an impact.	0.286047
Výskumný pracovník Univerzity vo východnomLondýne a hlavný vedec projektu Eureca financovaného Európskou komisiou Rabih Bashroush vyrátal, že 5 miliárd prehraní dosiahnuté jediným hudobným klipom, a to hitom z roku 2017 s názvom Despacito, spotreboval rovnaké množstvo elektriny ako Čad, Guinejsko-bissauská republika, Somálsko, Sierra Leone a Stredoafrická republika dokopy za jediný rok.	Rabih Bashroush, a researcher at the University of East London and lead scientist at the European Commission-funded Eureca project, calculated that five billion plays clocked up by just one music video – the hit 2017 song Despacito – consumed as much electricity as Chad, Guinea-Bissau, Somalia, Sierra Leone and the Central African Republic put together in a single year.	0.680037
Bashroush dodáva: Celkové emisie za vysielanie tejto pesničky môžu byť viac ako 250 000 ton oxidu uhličitého.	The total emissions for streaming that song could be over 250, 000 tonnes of carbon dioxide, he says.	0.434902
Avšak Hazas zdôraznil, že niektoré zobrazenia na YouTube sú neúmyselné.	However, Hazas points out that some YouTube views are unintentional.	0.830455
Štúdia, ktorú viedla jeho kolegyňa Kelly Widdicksová, sa zaoberala návykmi v oblasti pozerania videí a zistila, že niektorí diváci používajú YouTube ako šum pozadia a niekedy dokonca pri ňom zaspávajú, pričom mimovoľne produkujú uhlík.	A study led by his colleague Kelly Widdicks analysed streaming habits and found that some viewers use YouTube as background noise, and sometimes even fall asleep, generating carbon for no gain.	0.416159
Obmedziť takéto používanie alebo zastaviť videá, ktoré boli neúmyselne spustené v otvorenom prehliadači, keď ich nepozeráte, by mohlo pomôcť znížiť vašu uhlíkovú stopu.	Cutting back on these uses or stopping video from playing unintentionally on an open browser when you are not watching, could help keep your carbon footprint down.	0.280435
Pohrať sa trochu s nastaveniami automatického prehrávania a prepnúť vysoké rozlíšenie na nižšie rozlíšenie, keď to nie je potrebné, tiež dokáže zázraky.	Fiddling with autoplay settings and switching from high definition to a lower resolution when it’s not necessary can also make a difference.	0.53087
Hazas tvrdí, že najefektívnejší spôsob, ako si vychutnať vašu obľúbenú reláciu je počkať, kým ju bude vysielať pozemská digitálna televízia. ~~~ Ďalším spôsobom, ako ochrániť našu klímu, je vysielanie videí radšej cez wi-fi než cez mobilnú sieť.	Hazas says the most efficient way to see your favourite programme is by waiting for it to be on terrestrial TV, or choosing to stream it over wi-fi rather than on a mobile network can also make a difference.	0.0370168
Keď ste na telefóne cez mobilnú sieť, je to asi dvakrát viac energicky náročné ako používanie wi-fi. Najlepšie by bolo počkať s pozeraním YouTube videí, až kým prídete domov, dodáva.	Using a phone over a mobile network is at least twice as energy intensive than using it over wi-fi, so if you can wait until you get home to watch YouTube that’s best, he adds.	0.470471
Jedným z najzábavnejších spôsobov, ako byť environmentálne prospešný, je pozerať filmy a televíziu v jednom.	And, one of the most enjoyable ways to be more environmentally friendly is to watch films and TV together.	0.279775
Celkovo je audio menej problematické, hovorí Hazas, pretože vysielanie zvukového signálu je menej energeticky a tiež uhlíkovo náročné ako zdieľanie obrázkov.	On the whole, audio is less problematic, says Hazas, as streaming audio is less energy and carbon intensive than streaming images.	0.499754
Výskumníci z Univerzity v Osle však zistili, že počúvanie hudby nikdy nemalo taký environmentálny vplyv ako teraz. ~~~ Uhlíková stopa sťahovania skladieb do MP3 prehrávačov dosahuje od 200 do 350 tisíc ton CO2, a to len v Spojených štátoch.	But researchers at the University of Oslo found that environmental impact of listening to music has never been higher, with a footprint of 200,000-350,000 tonnes of CO2 in the US alone for downloading tracks onto MP3 players.	0.0751337
Tiež sa domnievajú, že emisie streamovacích služieb môžu byť ešte vyššie.	It’s thought emissions for streaming services may be even higher.	0.263158
Odhliadnuc od toho, zmenu k lepšiemu dokáže spraviť aj obmedzenie množstva vypočutí danej skladby.	However, the number of times you listen to a piece of music can make a difference.	0.220588
Kúpa fyzického CD alebo platne je výhodná vtedy, keď daný album budete opakovane počúvať. ~~~ Ak však budete danú skladbu počúvať menej ako 27-krát za život, tak streamovanie je určite lepšia voľba.	Buying a physical CD or record can be better if you listen to the same album repeatedly, but if you only listen to a piece of music less than 27 times over your lifetime, then streaming can be better.	0.0324675
(Viac sa o uhlíkovej stope streamovania hudby dočítate tu.)	(Read more about the carbon footprint of streaming music.)	0.294118
Rovnako sa aj environmentálne náklady na sťahovanie videohier považujú za vyššie ako výroba a distribúcia blu-ray diskov do obchodov.	Similarly, the environmental cost of downloading video games is thought to be higher than producing and distributing Blu-Ray disks from shops.	0.281897
Pri prvom pokuse o zmapovanie spotreby energie pri hraní videohier v USA sa zistilo, že vytvára 24 megaton oxidu uhličitého ročne.	The first attempt to map the energy use of gaming in the US found it produces 24 megatonnes of carbon dioxide a year.	1.75312
Výskumníci z Kalifornskej univerzity, ktorí sa podieľali na tejto štúdii stanovili, že americkí gejmeri spotrebujú 2,4 % svojej domácej elektriny, a teda 32 terawatthodín energie ročne, čo je viac ako spotrebujú mrazničky a práčky.	Researchers behind the study at the University of California found US gamers use 2.4% of their household electricity – 32 terawatt hours of energy every year – which is more than freezers or washing machines.	1.20171
Ďalej poukázali na to, že streamovanie videohier využíva oveľa viac energie. ~~~ Uhlíková stopa videohier sa môže zhoršovať, keďže viac a viac ľudí si osvojuje hry, v ktorých je výpočtová aktivita vykonávaná skôr na diaľku než na jednotlivých konzolách, akou je napríklad Stadia od Googlu.	They also showed that streaming games uses more energy, so gaming carbon emissions may worsen as more people adopt games where the computational work is being done remotely rather than on individual consoles, such as with devices like Google’s Stadia.	-0.0225352
Hazas to však vidí ružovo.	But Hazas is more optimistic.	0.76087
Uhlíková stopa hrania hier medzi dvomi a viacerými hráčmi, ako napríklad Fortnite, nie je až taká zlá, vysvetľuje.	The carbon footprint of playing multiplayer games like Fortnite isn’t too bad, he says.	0.208
Sú navrhnuté tak, aby boli prispôsobivé a nevyžadovali také množstvo dátového prenosu.	They are designed to be responsive so they don’t require too much data traffic.	0.259701
Zoberte si napríklad viditeľnosť hráča na mape, alebo fakt, že niekto práve vystrelil. ~~~ Ani jedna z týchto skutočností nevyžaduje veľa dát k prenosu.	For example, you get a position of a character on a map, or the fact someone’s shooting, but it doesn’t take too much data to communicate that.	-0.0139831
Druhou stranou mince je fakt, že aktualizácia hier je uhlíkovo náročnejšia.	However, updating games is more carbon intensive.	0.15
Strategické hry ako Fortnite alebo Call of Duty vyžadujú veľké množstvo aktualizácií, takže sa kvôli ich sťahovaniu raz za pár týždňov pozeráme na gigabajty prenesených dát.	Flagship games like Fortnite or Call of Duty require lots of updates so you're looking at gigabytes every couple of weeks for downloads, which add new features.	0.713333
S každou takouto aktualizáciou hra získava nové funkcie.		-0.3
Ak patríte k ľuďom, ktorí radi trávia čas na sociálnych sieťach, máme pre vás dobré správy.	For those who enjoy flicking through their social media, there is some good news.	0.265217
Je to zrejme tá najmenej uhlíkovo nebezpečná forma digitálnej zábavy.	It is arguably the least carbon intensive form of digital entertainment.	0.290164
Podľa správy o udržateľnosti, ktorú zverejnil Facebook, ročná uhlíková stopa jedného používateľa je 299 gramov CO2, čo je menej, ako uvariť si vodu na jeden čaj.	According to Facebook’s sustainability report, a user’s annual carbon footprint is 299g CO2, which is less than boiling the water for a pot of tea.	0.383933
No, ak zoberieme do úvahy fakt, že túto platformu využíva viac ako 1 miliarda používateľov, tak už hovoríme o desiatkach litrov čaju.	But if you consider the platform has more than one billion users, that’s a lot of pots of tea.	0.15974
Jednou z možností, ako šetriť uhlík, je zablokovať niektoré funkcie sociálnych sietí a ostatných aplikácií.	It’s possible to save carbon by disabling some features for social media and other apps.	0.224
Zistili sme, že aktualizácie a automatická záloha v službe cloud tvorí 10 % celkového prenosu mobilných zariadení, tvrdí Hazas.	We've found that app updates and automatic cloud backups are about 10% of traffic from mobile phones, says Hazas.	0.55625
To znamená, že ak vypnete nepotrebné zálohovanie súborov a automatické aktualizácie, táto spotreba sa zníži.	So, switching off unnecessary cloud backups and switching off automatic downloads for app updates are good things to do.	0.274737
Tento problém je však väčší ako my. Potrebné sú tiež zmeny v rámci priemyslu, a teda zabezpečenie zníženia uhlíkových emisií, dodáva Elizabeth Jardimová, vedúca podniková aktivistka environmentálnej kampane organizácie Greenpeace.	But while changes in our personal online behaviour will only take us so far, there also needs to be change within the industry to ensure that carbon emissions can be reduced, says Elizabeth Jardim, a senior corporate campaigner at environmental campaign group Greenpeace.	0.548738
Predpokladá sa, že do roku 2040 budú emisie skleníkových plynov IT priemyslu tvoriť 14 % celkových emisií. ~~~ V dôsledku toho Medzinárodná telekomunikačná únia, patriaca pod OSN, stanovila tomuto sektoru cieľ, aby v priebehu najbližších 10 rokov zredukoval svoje emisie o 45 %.	The IT industry’s greenhouse gas emissions are predicted to reach 14% of global emissions by 2040 but at the same time the UN's International Telecommunication's Union has set the industry the target of reducing its emissions by 45% over the next decade.	-0.0154206
Je potrebné zabezpečiť, aby spoločnosti, ktoré vytvárajú internet, išli príkladom a postupne vymieňali fosílne palivá za energie z obnoviteľných zdrojov, hovorí Jardimová.	It’s more important to make sure the companies building the internet are switching to renewable and phasing out fossil fuels, says Jardim.	0.216102
Až vtedy budeme môcť vyhľadávať bez pocitu viny.	That's when searching will be more guilt free.	0.285
Predstavme si planétu Zem bez vírusov.	Let’s imagine planet Earth without viruses.	0.255882
Mávneme prútikom a všetky zmiznú.	We wave a wand, and they all disappear.	0.77
Vírus besnoty je zrazu preč.	The rabies virus is suddenly gone.	0.24
Vírus detskej obrny je preč.	The polio virus is gone.	0.242857
Nesmierne smrteľný vírus eboly je preč.	The gruesomely lethal Ebola virus is gone.	0.282857
Vírus osýpok, mumpsu a rôzne nákazy sú preč.	The measles virus, the mumps virus, and the various influenzas are gone.	0.110526
Množstvo ľudského utrpenia a smrti klesne.	Vast reductions of human misery and death.	0.291892
HIV zmizne, AIDS katastrofa sa nikdy nestala.	HIV is gone, and so the AIDS catastrophe never happened.	0.99
Vírusy nipah, hendra, machupo a sin nombre sú preč, napriek chaosu, ktorý spôsobili.	Nipah and Hendra and Machupo and Sin Nombre are gone — never mind their records of ugly mayhem.	0.275342
Horúčka dengue zmizla.	Dengue, gone.	0.115385
Všetky rotavírusy sú preč, veľké šťastie pre státisíce detí z rozvojových krajín, ktoré na tieto vírusy umierajú každoročne.	All the rotaviruses, gone, a great me rcy to children in developing countries who die by the hundreds of thousands each year.	0.291429
Zika vírus je preč.	Zika virus, gone.	1.03125
Vírus žltej horúčky je preč.	Yellow fever virus, gone.	0.273913
Herpes B, prenášaný niektorými opicami, a pri prenose na človeka často smrteľný, je preč.	Herpes B, carried by some monkeys, often fatal when passed to humans, gone.	0.667634
Už nikto netrpí ovčími kiahňami, hepatitídou, pásovým oparom a ani obyčajnou chrípkou.	Nobody suffers anymore from chicken pox, hepatitis, shingles, or even the common cold.	0.296
Ovčie kiahne, zástupcovia osýpok?	Variola, the agent of smallpox?	0.267857
Ten vírus bol vo voľnej prírode vyhubený do roku 1977, teraz zmizne aj z prísne strážených mrazničiek, kde sú uložené posledné vzorky.	That virus was eradicated in the wild by 1977, but now it vanishes from the high - security freezers where the last spooky samples are stored.	0.419908
Vírus SARS z roku 2003, alarm, ktorý ako už teraz vieme, signalizoval modernú pandemickú éru, je preč.	The SARS virus of 2003, the alarm that we now know signaled the modern pandemic era, gone.	0.585333
A samozrejme, zákerný SARS-CoV-2 vírus, pôvodca COVIDU 19, zradný, nebezpečný, a veľmi prenosný je preč.	And of course the nefarious SARS-CoV-2 virus, cause of COVID-19 and so bewilderingly variable in its effects, so tricky, so dangerous, so very transmissible, is gone.	0.319368
Cítite sa lepšie?	Do you feel better?	0.28125
Necíťte sa.	Don’t.	0.128571
Takýto scenár je nejasnejší, než si myslíte.	This scenario is more equivocal than you think.	0.284615
Faktom je, že žijeme vo svete vírusov – vírusov ktoré sú neuveriteľne rozmanité, rozšírené všade okolo nás.	The fact is, we live in a world of viruses — viruses that are unfathomably diverse, immeasurably abundant.	0.293333
Samotné oceány môžu obsahovať viac vírusových častíc ako hviezdy v pozorovateľnom vesmíre.	The oceans alone may contain more viral particles than stars in the observable universe.	0.284211
Cicavce môžu prenášať prinajmenšom 320 000 rôznych druhov vírusov.	Mammals may carry at least 320, 000 different species of viruses.	0.583929
Keď pridáte vírusy napádajúce necicavčie zvieratá, rastliny, suchozemské baktérie a každého možného hostiteľa, celkový počet sa rovná . . . množstvám.	When you add the viruses infecting nonmammalian animals, plants, terrestrial bacteria, and every other possible host, the total comes to … lots.	0.283065
A za veľkými množstvami sa skrývajú veľké následky. Mnohé z týchto vírusov prinášajú životu na Zemi, vrátane ľudského života, viac osohu ako škody.	And beyond the big numbers are big consequences: Many of those viruses bring adaptive benefits, not harms, to life on Earth, including human life.	0.295161
Bez nich by sme nemohli žiť.	We couldn’t continue without them.	0.2125
Bez nich by sme sa nevyvinuli z pôvodnej formy života.	We wouldn’t have arisen from the primordial muck without them.	0.247826
Existujú dve dĺžky DNA, ktoré pochádzajú z vírusov a teraz sú súčasťou genómov ľudí a ďalších primátov, bez ktorých by – prekvapivý fakt – nebolo možné otehotnieť.	There are two lengths of DNA that originated from viruses and now reside in the genomes of humans and other primates, for instance, without which — an astonishing fact — pregnancy would be impossible.	0.234783
Existuje vírusová DNA uhniezdená medzi génmi suchozemských zvierat, ktorá pomáha baliť a ukladať spomienky – ešte prekvapivejšie – do drobných proteínových bubliniek, je to ohromujúce.	There’s viral DNA, nestled among the genes of terrestrial animals, that helps package and store memories — more astonishment — in tiny protein bubbles.	0.225581
Ďalšie gény, kooptované z vírusov, prispievajú k rastu embryí, regulujú imunitný systém, odolávajú rakovine – to všetko sú dôležité javy, ktorým iba teraz začíname rozumieť.	Still other genes co-opted from viruses contribute to the growth of embryos, regulate immune systems, resist cancer — important effects only now beginning to be understood.	0.411331
Ukázalo sa, že vírusy zohrali dôležitú úlohu pri spúšťaní dôležitých evolučných zmien.	Viruses, it turns out, have played crucial roles in triggering major evolutionary transitions.	0.272368
Ak by ste zlikvidovali všetky vírusy, ako v našom myšlienkovom experimente, obrovská biologická rozmanitosť, ktorá zdobí našu planétu, by sa zrútila ako krásny drevený domček, v ktorom by ani klinec nezostal na mieste.	Eliminate all viruses, as in our thought experiment, and the immense biological diversity gracing our planet would collapse like a beautiful wooden house with every nail abruptly removed.	0.251553
Potápač pri plávajúcom žralokovi v Akváriu Tichého oceánu v Long Beach v Kalifornii ukazuje obrázok bakteriofága, je to druh vírusu napádajúci baktériu.	As a zebra shark cruises by, a diver at Aquarium of the Pacific in Long Beach, California, displays an image of a bacteriophage, a type of virus that infects bacteria.	0.414526
Baktériofágy sú neškodné pre rastliny a zvieratá a nesmierne dôležité pre zdravý morský ekosystém.	Harmless to plants and animals, bacteriophages are critical for healthy marine ecosystems.	0.2775
Oceány na Zemi sa takýmito a inými vírusmi hemžia.	The Earth’s oceans teem with these and other viruses.	0.27907
Akváriá Tropical Reef Habitat a Coral Garden obsahujú 1 389 874 litrov vody a približne 5,32 biliárd vírusov.	The aquarium’s Tropical Reef Habitat and Soft Coral Garden hold 367, 166 gallons of water, with an estimated 5.32 quadrillion viruses.	1.01851
Ak by boli zoradené vedľa seba, tieto vírusy by Zem obišli takmer osemkrát.	If lined up side by side, those viruses would circle the Earth almost eight times.	0.490848
Alexandru Rae Santorovú, doktorandku pracujúcu s Jedom Fuhrmanom, profesorom na Univerzite v Južnej Kalifornie sme poprosili, aby spočítala vírusy v Tichomorskom akváriu Tropical Reef Habitat a v Soft Coral Garden.	To count viruses in the Aquarium of the Pacific’s Tropical Reef Habitat and Soft Coral Garden, we enlisted Alexandra Rae Santora, a doctoral student working with Jed Fuhrman, a professor at the University of Southern California.	0.964516
Prefiltrovala vzorku cez 0,02 mikrónový filter, ktorý zachytáva baktérie a vírusy.	She ran a sample through a 0.02-micron filter, which catches bacteria and viruses.	0.791549
Použila farbivo na DNA, aby boli viditeľné pod epifluorescenčným mikroskopom.	She used a DNA-binding stain to make them visible under an epifluorescence microscope.	0.273913
Väčšie organizmy sú baktérie, menšie bodky sú vírusy.	The larger organisms are bacteria; the dots are viruses.	0.287234
Pomocou počítacej mriežky určila počet vírusov v zornom poli.	With a counting grid, she determined the number of viruses in the field of view.	0.227778
Vďaka poznaniu veľkosti filtra a objemu vody mohla vypočítať populáciu na liter.	Knowing the filter size and the volume of water allowed her to calculate the population per gallon.	0.24
Áno, vírus je parazit, občas je však ten parazitizmus podobnejší symbióze, vzájomnej závislosti, z ktorej ťaží hosť aj hostiteľ.	A virus is a parasite, yes, but sometimes that parasitism is more like symbiosis, mutual dependence that profits both visitor and host.	0.289189
Vírus je ako oheň, v žiadnom prípade nie je ani úplne dobrý, ani úplne zlý; môže priniesť úžitok aj skazu.	Like fire, viruses are a phenomenon that’s neither in all cases good nor in all cases bad; they can deliver advantage or destruction.	0.218182
Všetko záleží: záleží na víruse, na situácii, na vášom uhle pohľadu.	Everything depends: depends on the virus, on the situation, on your point of reference.	0.218644
Sú padlými anjelmi evolúcie, ohromné a hrozivé.	They are the dark angels of evolution, terrific and terrible.	0.221429
Preto sú zaujímavé.	That’s what makes them so interesting.	0.0333333
Aby sme dokázali oceniť rozmanitosť vírusov, musíme začať od základov s tým, čo sú a čo nie.	To appreciate the multifariousness of viruses, you need to start with the basics of what they are and what they are not.	0.21039
Je jednoduchšie povedať, čo nie sú.	It’s easier to say what they are not.	0.3
Nie sú to žijúce bunky.	They are not living cells.	0.255
Bunka, ktorá sa zhromažďuje do obrovských množstiev, aby vytvorila moje alebo vaše telo alebo telo chobotnice či prvosienky, obsahuje prepracované mechanizmy na tvorbu proteínov, zhromažďovanie energie a vykonávanie iných špecializovaných funkcií, v závislosti od toho, či ide o svalovú bunku, o bunku v dužine rastliny alebo o neurón.	A cell, of the sort assembled in great number to make up your body or mine or the body of an octopus or a primrose, contains elaborate machinery for building proteins, packaging energy, and performing other specialized functions — depending on whether that cell happens to be a muscle cell or a xylem cell or a neuron.	0.331567
Aj baktéria je bunka s podobnými vlastnosťami, hoci je oveľa jednoduchšia.	A bacterium is also a cell, with similar attributes, though much simpler.	0.290476
Vírus nie je nič z toho.	A virus is none of this.	0.3
Určiť, čo je vírus, bolo také komplikované, že jeho definície sa za posledných 120 rokov neustále menili.	Saying just what a virus is has been complicated enough that definitions have changed over the past 120 - some years.	2.10667
