Naresova výprava bola poslednou významnou expedíciou, ktorú financovala Veľká Británia.	Nares’s mission would be the last major one sponsored by Great Britain.	0.211475
Posádka arktickej výpravy, ktorú viedol George Nares, narába s pílou na ľad.	Members of the Arctic expedition led by George Nares operate an ice-cutting saw.	0.517133
V pozadí je loď Alert obklopená ľadovými kryhami.	In the background is the ship Alert, surrounded by pack ice.	0.244186
Rytina z konca 19. storočia.	Late 19th-century engraving.	0.276
Posádka polárnej výpravy Georga Naresa v rokoch 1875 – 1876 používala na vybudovanie dokov pre ich dve lode píly na ľad.	The crew of George Nares’s 1875-76 polar expedition used ice saws for carving out docks for their two ships.	0.267033
Aj napriek tomu ľadové kryhy rýchlo plavidlá uväzňovali. Člen posádky lode Alert Albert Hastings Markham si zapísal: "Veľký plávajúci ľadovec narazil do lode a vytlačil ju do výšky poldruha metra.	Even so, the pack ice could quickly entrap the vessels, as an Alert crew member, Albert Hastings Markham, recorded: "A large floe-berg pressed violently against the vessel lifting the stern out of the water to a height of about five feet.	0.63174
Na ten zvuk škrípajúcich trámov a skuvíňajúceho dreva nikdy nezabudnem."	The noise of the cracking of the beams and the groaning of the timbers was a sound that once heard will never be forgotten."	0.394602
V roku 1881 sa pokúsila dosiahnuť Severný pól ďalšia významná americká expedícia s vedeckým zameraním.	In 1881 another major American scientific expedition set out to capture the North Pole.	2.444
Viedol ju prvý poručík Adolphus Greely z Piateho pluku kavalérie Spojených štátov. Cieľom expedície Lady Franklin bolo založiť meteorologickú stanicu v rámci projektu Medzinárodný polárny rok (MPR).	Led by 1st Lt. Adolphus Greely of the Fifth United States Cavalry, the Lady Franklin Bay expedition aimed to establish a weather station as part of the first International Polar Year (IPY).	0.702156
Spolupráca začala v roku 1879, keď pri vedeckom výskume spojilo sily dvanásť krajín.	The collaboration came about in 1879 as 12 nations agreed to join forces in the scientific study of the Arctic.	0.217808
Cieľom expedície nebolo pre Spojené štáty iba zbierať vedecké poznatky, zároveň sa chceli dostať ďalej než Briti, ktorí vtedy držali rekord.	The United States’ purpose of the expedition was not only to collect scientific data, but also to claim the "farthest north” record held by the British.	0.282645
Napriek vysokým očakávaniam sa Greelyho expedícia skončila tragicky.	Despite high hopes for Greely’s mission, the results were tragic.	0.273684
Prežilo iba sedem z pôvodných dvadsiatich piatich členov expedície vrátane Greelyho.	Only seven of the expedition’s original 25 members, including Greely, survived.	0.278571
Nedostatočná príprava v kombinácii s drsným počasím spôsobila, že dodanie nevyhnutných zásob a potravín pre posádku sa oneskorilo. Z týchto dôvodov museli zostať na Ellesmerovom ostrove celé tri ročné obdobia a trpeli hladom, únavou a zimou. ~~~ Spojeným štátom sa podarilo prelomiť rekord.	Poor planning combined with harsh weather delayed the delivery of critical supplies and rations for the team, who were left for three seasons on Ellesmere Island to endure starvation, fatigue, and exposure.	-0.0264205
Dostali sa ďalej než ostatné expedície, ale stálo ich to príliš veľa.	The United States did achieve the record of farthest north, but at a great cost.	0.259322
Rytina zachytáva pochmúrnu atmosféru v stane poručíka Adolphusa Greelyho na Ellesmerovom ostrove, ktorá ohromila záchrannú skupinu po ich príchode v júni 1884.	An engraving depicts the grim scene inside Lt. Adolphus Greely's tent on Ellesmere Island that astonished the relief party when they arrived in June 1884.	0.412114
Adolphus Greely po svojej záchrane v roku 1884 údajne povedal: "Sme tu, umierame ako chlapi.	When Adolphus Greely was rescued in 1884, he reportedly said, "Here we are, dying like men.	0.667208
Dosiahli sme to, na čo sme sem prišli – zdolať rekord."	Did what I came to do—beat the record.”	0.181818
Z pôvodných dvadsiatich piatich členov prežilo iba sedem.	Of the original 25 members, only seven had survived the mission.	0.276471
Čoskoro sa začali šíriť zvesti o strašných podmienkach, v ktorých ich našli. ~~~ Nechýbali ani fámy o kanibalizme.	Rumors circulated about the grim conditions in which the men were found, including claims of cannibalism.	-0.00989011
Vedenie novín New York Herald sa nenechalo zastrašiť katastrofálnym výsledkom Greelyho misie.	Undeterred by the disaster of Greely’s mission, the New York Herald decided to sponsor its own expedition to the North Pole.	0.91279
Rozhodli sa financovať svoju vlastnú expedíciu na Severný pól. ~~~ V roku 1879 pod vedením Georga De Longa vplávala loď Jeannette cez Beringov prieliv do Arktídy. ~~~ Dúfali, že zo severného Tichého oceánu ich bude poháňať teplý morský prúd Kuroshio.	In 1879 the Jeannette, commanded by George De Long, entered the Arctic through the Bering Strait with the hope of being carried along by the warm Kuroshio ocean current from the North Pacific.	0.507117
De Long však nedbal na odporúčania rybárov, ktorí v tejto oblasti pracovali a z vlastnej skúsenosti vedeli, že prúd nebude dostatočne silný na to, aby loď poháňal.	But De Long had not heeded the advice of whalers who worked in the area and who knew from experience that the current would not be strong enough to carry the ship through.	0.509938
Ako loď Jeannette postupovala na sever, zasekla sa v ľade a o dva roky na to sa potopila.	As the ship advanced, the Jeannette became locked in ice and sank two years later.	0.470109
Bádatelia museli ťahať záchranné člny rozsiahlou pustatinou, až kým neprišli k otvorenému moru.	The expeditioners were forced to drag their lifeboats across a vast wasteland until they found open water.	0.275
Na jeseň 1881 sa im napokon podarilo dostať sa na Sibír, ale túto zničujúcu cestu prežila iba tretina posádky.	They eventually reached the coast of Siberia in the autumn of 1881, but only a third of the crew survived the devastating journey.	0.248387
Posádka lode Jeannette opustila zaseknuté plavidlo, aby vyhľadala pomoc až po dvoch rokoch.	Trapped in ice, the Jeannette was stuck for two years before her crew abandoned ship to seek rescue.	0.499286
Rytina z roku 1882.	1882 engraving.	0.26
O tri roky neskôr sa vrak lode Jeannette prekvapivo objavil na pobreží Grónska.	Amazingly, three years later, wreckage from the Jeannette had drifted to the coast of Greenland.	0.448109
Nórsky vedec a prieskumník Fridtjof Nansen vďaka nemu utvoril teóriu o existencii morského toku, ktorý sa mal tiahnuť cez celý Severný ľadový oceán.	Norwegian scientist and explorer Fridtjof Nansen used this finding to theorize the existence of a marine current that ran across the entire Arctic Ocean.	0.665551
Podľa jeho výpočtov sa mohla loď uväznená v rovnakej oblasti, kde sa potopila Jeannette, preplaviť cez celú Arktídu.	By his reckoning, if a ship was caught by the ice in the same area that the Jeannette sank, it could cross the entire Arctic.	0.294
Napokon by vyšla na druhom konci, čo by znamenalo, že prešla cez Severný pól.	It would eventually exit at the other end, having passed across the North Pole.	0.290769
Nansen sa rozhodol overiť si svoju teóriu.	Nansen decided to test his theory.	0.658571
Postavil loď s novým kýlovým dizajnom, ktorá bola v arktických vodách schopná dobre odolávať ľadu.	He built a ship named Fram ("forward”) with a new keel design, capable of holding fast against the ice in Arctic waters.	0.247059
Pomenoval ju Fram ("Vpred"). ~~~ Chcel ju nechať zapadnúť v ľade, odkiaľ by ju tok vody odniesol až k Severnému pólu.	The ship would be allowed to become embedded in ice, and Nansen believed the current would then carry it to the pole.	0
Vyplával v roku 1893 s malou posádkou dvanástich mužov.	He set out in 1893 with a small crew of 12.	3.47647
Spočiatku bolo všetko v poriadku.		-0.3
Loď odolávala ľadu.	At first all went well.	0.266667
Avšak asi po roku plavby si Nansen uvedomil, že jeho plán ho možno predsa len neprivedie k Severnému pólu.	The ship was able to withstand the pressure of the ice in the water.	0.123214
V marci 1895 sa rozhodol, že sa na pól vydá na lyžiach a saniach. ~~~ Spolu s kolegom Hjalmarom Johansenom vytvorili nový rekord.	However, after about a year adrift, the explorer saw that his water route might not take him to the North Pole after all.	-0.0105
Aj napriek krutým podmienkam na Zemi Františka Jozefa sa dostali ďalej ako ich predchodcovia.	Nansen decided to strike for the pole by skis and by sledges in March 1895.	0.208065
Napokon si museli postaviť prístrešok a prezimovať na ostrove, ktorý je dnes známy ako Jacksonov ostrov.	He and teammate Hjalmar Johansen were able to establish a new farthest north record while facing harsh conditions as they moved across Franz Josef Land.	0.346471
Svoj názov dostal na počesť britského polárneho prieskumníka Fredericka Jacksona, ktorý v roku 1896 zachránil Nansena a Johansena a priviedol ich späť do Nórska.	They were forced to build a shelter and overwinter at what is now called Jackson Island, named in honor of British polar explorer Frederick Jackson, the man who found Nansen and Johansen and brought them back to Norway in 1896.	0.312086
Medzitým sa zvyšok posádky lode Fram nechal unášať ľadovými kryhami Arktídy. ~~~ Chceli zistiť, či je Nansenova teória správna.	Meanwhile, still dedicated to testing Nansen’s theory, the Fram and the rest of her crew remained caught in the pack ice that was drifting across the Arctic.	-0.0205224
Otto Sverdrup prevzal velenie a dohliadal na to, aby vedecké pozorovania pokračovali aj počas pomalej plavby.	Otto Sverdrup commanded the ship and made sure that scientific observations continued as the Fram slowly moved.	0.649783
V auguste 1896 sa konečne dostali na otvorené more a podarilo sa im vrátiť sa do Nórska, čím potvrdili Nansenovu teóriu.	In August 1896 the ship finally found open water and was able to sail back to Norway, proving Nansen’s theory correct.	1.79394
Menej úspešná, ale o nič menej nápaditá, bola expedícia balónom, ktorú v roku 1897 zorganizoval švédsky prieskumník Salomon Andrée.	Less successful but no less imaginative was a balloon expedition attempted by Swedish explorer Salomon Andrée in 1897.	0.422601
Andrée veril, že by sa na Severný pól mohol dostať skôr vzduchom než vodou.	Andrée believed he could achieve the pole by air rather than by sea.	0.696992
Spolu s Nilsom Strindbergom a Knutom Fraenkelom vzlietli 11. júla 1897 z nórskych Špicbergov.	He and Nils Strindberg and Knut Fraenkel set out from Spitsbergen, Norway, on July 11, 1897.	0.288462
Balón sa po troch dňoch zrútil. ~~~ Trojica pád prežila, ale čoskoro zahynula v neúprosných arktických podmienkach.	The balloon crashed three days into the trip; the three men survived the initial landing but perished in the unforgiving conditions on land.	-0.030303
Európske expedície pokračovali, no bez úspechov.	European expeditions for the North Pole continued with no success.	0.633117
Niektorým sa podarilo dosiahnuť nový rekord, tak ako napríklad talianskej výprave, ktorú viedol princ Luigi Amedeo. ~~~ So svojím kapitánom Umbertom Cagnim prišli ďalej ako Nansen, ale na Severný pól sa nedostali.	Some managed to push a little farther north, like the Italian mission led by Prince Luigi Amedeo, with his captain Umberto Cagni managing to travel a bit farther north than Nansen, but did not achieve the North Pole.	0.0865686
Jedným z nich bol aj Robert E. Peary, ktorý v období medzi rokmi 1886 až 1909 podnikol do Arktídy osem výprav.	Among them was Robert E. Peary, who made eight trips to the Arctic between 1886 and 1909.	0.897748
Ďalším nádejným americkým moreplavcom bol Frederick A. Cook, ktorý v rokoch 1891 – 1892 slúžil v Pearyho výprave ako lekár.	Another American striver was Frederick A. Cook, who served in 1891-92 as physician on Peary’s Arctic mission.	0.764894
Cook pokračoval v bádaní severných oblastí Zeme, až napokon v roku 1907 podnikol na Severný pól vlastnú výpravu.	Cook continued to explore Earth’s northern regions, eventually striking out on his own for the North Pole in 1907.	0.45477
Jeho bývalí druhovia sa stali jeho konkurentmi, každý sa snažil získať cenu pre seba.	The two former comrades had become competitors, each one trying to capture the prize.	0.3
Peary a Henson verili, že 6. apríla 1909 dorazili na Severný pól.	On April 6, 1909, Peary and Henson believed they reached the North Pole.	0.728811
Zemepisnú šírku vedel v celej posádke vypočítavať iba Peary a mnoho vedcov ich spochybnilo. ~~~ Rýchlosť ich návratu vyvolala ďalšie otázniky.	Of all the team, only Peary knew how to make the latitude calculations, and many researchers have called them into question.	0.0506329
Cookova výprava v roku 1907 odštartovala pomerne pompézne.	The speed with which they returned prompted further doubt.	0.294118
Škuner John R. Bradley, ktorý vyplával z Massachusettského prístavu, mal namierené do Grónska, kde mal stráviť zimu v eskimáckej osade Annoatok, približne 1 100 kilometrov od štartu.	Cook’s mission began with little fanfare in 1907 when his schooner, the John R. Bradley, departed from Massachusetts for Greenland, where he would spend the winter at Annoatok, an Inuit settlement some 700 miles away.	0.676979
Vo februári 1908 odtiaľ odišiel a vybral sa hľadať Severný pól.	In February 1908 he set off in search of the North Pole.	2.99783
Dvaja Eskimáci Etukishook a Ahwelah sprevádzali Cooka celou cestou na sever. ~~~ Cook 21. apríla 1908 vyhlásil, že sa dostal na 90° zemepisnej šírky.	Two Inuit guides, Etukishook and Ahwelah, accompanied Cook all the way north to where he claimed he reached 90° north on April 21, 1908.	0.109211
Peary sa v lete 1908 vydal na Severný pól loďou Roosevelt. ~~~ V tom čase sa ho snažil dosiahnuť už skoro dvadsať rokov.	Peary had been trying to claim the North Pole for nearly two decades by the time he set out in summer 1908 aboard the Roosevelt.	1.45357
Svoju výpravu začal s veľkou skupinou, ale v priebehu niekoľkých mesiacov v nej zostali len Matthew Henson – veterán z Pearyho expedícií – a štyria eskimácki sprievodcovia.	He started his journey with a large group, but winnowed it down over several months to just Matthew Henson, a veteran of Peary’s expeditions, and four Inuit guides.	0.49472
Pearyho skupina si myslela, že 6. apríla 1909 dosiahla Severný pól.	On April 6, 1909, Peary’s party believed they had reached the North Pole.	0.27931
Na jeseň 1909 súperiace noviny písali o prvenstve obidvoch mužov, čím vyvolali ostré diskusie.	In fall 1909 competing newspapers trumpeted each man’s claim to the discovery, and a red-hot controversy was born.	2.44146
Cookove tvrdenia podrobne preskúmali a napokon ich vyhlásili za nepotvrdené.	Cook’s account came under great scrutiny and was pronounced unproven.	0.265574
Národná zemepisná spoločnosť potvrdila správnosť Pearyho dokumentov a uznala, že sa naozaj dostal na Severný pól.	The National Geographic Society, after examining Peary’s papers, proclaimed that Peary had indeed reached the North Pole.	0.278788
Cookovo meno upadlo, zatiaľ čo Peary si užíval slávu.	Cook’s reputation diminished while Peary’s soared.	0.3
Peary a Cook medzi sebou bojujú o prvenstvo na Severnom póle. Titulná strana parížskeho časopisu Le Petit Journal z roku 1909.	Peary and Cook fight over their claims of having arrived first at the North Pole cover of a Parisian publication Le Petit Journal 1909.	1.23772
V 80.-tych rokoch minulého storočia Národná zemepisná spoločnosť prehodnotila Pearyho dokumenty a zistila, že sa na Severný pól nedostal.	In the 1980s the National Geographic Society reevaluated Peary’s documents and found that he had not achieved the North Pole.	0.263551
Iní experti tvrdia, že prvým bol Henson, a nie Peary.	Other experts argue that Henson was actually the first to the pole, not Peary.	0.432727
Cookove tvrdenia ostávajú záhadou; jeho dokumenty sa stratili a už sa nikdy nenašli.	Cook’s account remains a mystery; his supporting documents went missing and have never been found.	0.464971
V nasledujúcich desaťročiach bol Severný pól na dosah vďaka lietadlám.	In the decades ahead, powered flight finally brought the pole within reach.	0.285484
Prvá oficiálna výprava, ktorá vstúpila na 90° zemepisnej šírky, bola sovietska posádka. ~~~ Vysadili ju priamo na mieste v roku 1948.	The first confirmed expedition to set foot at 90° north was a Soviet crew, airlifted directly to the spot in 1948.	0.0869636
Zdalo sa však, že bádatelia zanevreli na suchozemský prístup. ~~~ Zmenilo sa to až v 60.-tych rokoch 20. storočia, keď Ralph Plaisted, poisťovací agent z Minnesoty, úspešne zavŕšil prvú suchozemskú výpravu na Severný pól. Dostal sa naň na snežnom skútri.	But the land approach seemed abandoned until the 1960s when Ralph Plaisted—an insurance man from Minnesota—successfully headed the first surface conquest of the pole, riding on a snowmobile, and arriving on April 19, 1968.	0.0202621
O rok neskôr sa britský prieskumník Wally Herbert stal prvým človekom, ktorý došiel k Severnému pólu pešo v rámci veľkolepej, vyše 6 100 kilometrovej plavby Severným ľadovým oceánom.	A year later, British explorer Wally Herbert became the first, confirmed person to walk to the pole as part of an epic, 3, 800-mile crossing of the Arctic Ocean.	0.457643
Príprava Ralph Plaisted nastupuje do lietadla v Montreale počas príprav na suchozemské dobytie Severného pólu.	SETTING OUT Ralph Plaisted boards a plane at Montreal in an early phase of his overland conquest of the North Pole.	0.671875
Jeho tím sa dostal na Severný pól na snežných skútroch na jar v roku 1968.	His team would reach the pole by snowmobile in the spring of 1968.	0.481558
Medzi extázou a vytriezvením vám bude váš milenec pripomínať narkomana.	From ecstasy to withdrawal, the lover resembles an addict.	0.229412
Ako sa dozviete o skutkoch vykonaných v mene lásky?	When we want to read of the deeds that are done for love, whither do we turn?	0.177273
Stačí si vyhľadať rubriku pod názvom Vraždy.	To the murder column.	-0.0157895
George Bernard Shaw	George Bernard Shaw	2.55
George Bernard Shaw spoznal silu romantickej lásky a náklonnosti na vlastnej koži.	George Bernard Shaw knew the power of romantic love and attachment.	0.977586
Romantická láska a náklonnosť sú podľa neho závislosťami. ~~~ Keď sa ľuďom vo vzťahu darí, hovoríme o (úžasne) pozitívnej závislosti, a keď vzťah stroskotáva, hovoríme o (zničujúcej) negatívnej závislosti.	Both, I will maintain, are addictions—wonderful addictions when the relationship is going well; horribly negative addictions when the partnership breaks down.	-0.0168
Tieto dve závislosti lásky sa vyvíjajú už veľmi dlho. ~~~ Začalo to asi pred 3,2 miliónmi rokov, keď Lucy so svojimi príbuznými a priateľmi blúdili po pastvinách východnej Afriky.	Moreover, these love addictions evolved a long time ago, as Lucy and her relatives and friends roamed the grass of east Africa some 3. 2 million years ago.	0.113942
Vezmite si romantickú lásku.	Take romantic love.	0.166667
Veď aj spokojný milenec má všetky vlastnosti narkomana.	Even a happy lover shows all of the characteristics of an addict.	0.263265
Aj láskou posadnutí muži a ženy túžia po emocionálnom a fyzickom spojení s milovanou osobou.	Foremost, besotted men and women crave emotional and physical union with their beloved.	0.288158
Táto túžba je súčasťou všetkých závislostí.	This craving is a central component of all addictions.	0.238462
Pri pomyslení na objekt svojho záujmu milenci tiež pociťujú nával vzrušenia, čo je forma istej intoxikácie.	Lovers also feel a rush of exhilaration when thinking about him or her, a form of intoxication.	0.25125
Čím viac ich posadnutosť naberá na sile, tým viac sa milenec snaží nadviazať spojenie s milovanou osobou.	As their obsession builds, the lover seeks to interact with the beloved more and more, known in addiction literature as intensification.	0.21
V literatúre, ktorá sa zaoberá drogovými závislosťami a ich prevenciou, sa tento stav označuje ako intenzifikácia.	They also think obsessively about their beloved, a form of intrusive thinking fundamental to drug dependence.	0.460681
Obsesívne premýšľajú o milovanej osobe, čo je porovnateľné s dotieravými myšlienkami drogovo závislých.		-0.3
Milenci vidia realitu skreslene a svoje priority a každodenný život prispôsobujú milovanej osobe. Často siahajú po nevhodných, nebezpečných a extrémnych riešeniach, len aby ohromili toho druhého, alebo aby s ním zostali v kontakte.	Lovers also distort reality, change their priorities and daily habits to accommodate the beloved, and often do inappropriate, dangerous, or extreme things to remain in contact with or impress this special other.	0.268508
Osobnosť človeka sa môže zmeniť. ~~~ Tento jav je známy ako afektívna porucha.	Even one’s personality can change, known as affect disturbance.”	-0.0236842
Mnohí beznádejne zamilovaní sú skutočne ochotní obetovať sa v prospech svojej lásky, dokonca by pre milovaného človeka zomreli.	Indeed, many smitten humans are willing to sacrifice for their sweetheart, even die for him or her.	0.203571
Tak ako narkoman trpí, keď nemá prístup k drogám, aj milenca sužuje, ak je odlúčený od milovanej osoby. ~~~ V oboch prípadoch ide o separačnú úzkosť.	And like addicts who suffer when they can’t get their drug, the lover suffers when apart from the beloved— separation anxiety.”	-0.0222222
Skutočný problém sa dostaví po odmietnutí.		-0.3
Väčšina opustených mužov a žien pociťuje príznaky, ktoré sú podobné abstinenčným príznakom.	Trouble really starts, however, when a lover is rejected.	0.414
Ide hlavne o námietky, záchvaty plaču, letargiu, úzkosť, poruchy spánku (príliš veľa alebo príliš málo spánku), stratu chuti do jedla alebo prejedanie sa, podráždenosť a pocit neustálej samoty.	Most abandoned men and women experience the common signs of drug withdrawal, including protest, crying spells, lethargy, anxiety, sleep disturbances (sleeping way too much or way too little), loss of appetite or binge eating, irritability, and chronic loneliness.	0.192216
Milenci sa môžu stať závislými tak ako drogovo závislí.	Lovers also relapse the way addicts do.	0.176471
Ešte dlho po ukončení vzťahu v nich môžu isté udalosti, ľudia, miesta, piesne alebo iné vonkajšie podnety súvisiace s rozchodom vyvolať nepríjemné spomienky.	Long after the relationship is over, events, people, places, songs, or other external cues associated with the abandoning partner can trigger memories.	0.28855
Spustia novú lavínu túžby, znepokojivé myšlienky, neustálu potrebu volania si, písania si alebo náhodného stretnutia.	This sparks a new round of craving, intrusive thinking, compulsive calling, writing, or showing up—all in hopes of rekindling the romance.	0.256731
To všetko v nádeji, že sa románik opäť oživí. ~~~ Láska sa neustále spája s prejavmi všetkých závislostí. ~~~ Niektorí psychológovia prišli k záveru, že romantická láska sa môže teoreticky stať závislosťou.	Because romantic love is regularly associated with a suite of traits linked with all addictions, several psychologists have come to believe that romantic love can potentially become an addiction.	-0.124444
Myslím si, že romantická láska je závislosťou. ~~~ Ako som už spomenula, je to závislosť v najlepšom zmysle slova, keď je láska opätovaná, netoxická a primeraná. ~~~ Ak sú pocity romantickej lásky nevhodné, jedovaté, neopätované alebo s úplnou platnosťou odmietnuté, je to závislosť zničujúca.	I think romantic love is an addiction—as I have mentioned, a positive addiction when one’s love is reciprocated, nontoxic, and appropriate; and a disastrously negative addiction when one’s feelings of romantic love are inappropriate, poisonous, unreciprocated, or formally rejected.	-0.118357
Ak počiatočná myšlienka nie je úplne absurdná, potom tu nie je žiadna nádej, povedal údajne Einstein.	If at first the idea is not absurd, then there is no hope for it,” Einstein reportedly said.	0.256579
Len málo vysokoškolských pracovníkov a laikov považuje túto romantickú lásku za závislosť. Domnievajú sa, že všetky závislosti sú chorobné a škodlivé.	Few academics and laymen regard romantic love as an addiction—because they believe that all addictions are pathological and harmful.	0.258261
Údaje však túto hypotézu nepotvrdzujú.	Data do not support this notion, however.	0.291429
Keď neurovedci Andreas Bartels a Semir Zeki porovnávali myšlienky šťastne zamilovaných ľudí s euforickými myšlienkami drogovo závislých, ktorí práve dostali dávku kokaínu alebo iného opiátu, v systéme odmeny mozgu sa aktivovalo mnoho podobných oblastí.	When neuroscientists Andreas Bartels and Semir Zeki compared the brains of happily-in-love participants with the brains of euphoric addicts who had just injected cocaine or opioids, many of the same regions in the brain’s reward system became active.	0.634446
Keď moji kolegovia znovu analyzovali zistené dáta z pozorovania 17-tich šťastne zamilovaných mužov a žien, objavili aktivitu v nucleus accumbens - v oblasti mozgu, ktorá je spojená so všetkými závislosťami, vrátane túžby po heroíne, kokaíne, nikotíne, alkohole, amfetamínoch, opiátoch ale aj túžby po hazardných hrách, sexe a jedle (ešte nepublikované údaje).	Moreover, when my colleagues reanalyzed our data on 17 men and women who were happily in love, we found activity in the nucleus accumbens (unpublished data), a brain region linked with all of the addictions—including the cravings for heroin, cocaine, nicotine, alcohol, amphetamines, opioids, and even gambling, sex, and food.	0.441938
Muži a ženy, ktorí sú v láske šťastní a bezpodmieneční, sú na svojich partneroch závislí.	Men and women who are intensely and happily in love are addicted to their partner.	0.269565
Moja kolegyňa, s ktorou skúmame mozog, neurovedkyňa Lucy Brownová tvrdí, že romantická láska je vlastne prirodzená závislosť, normálny, trochu pozmenený stav, ktorý zažívajú všetci ľudia.	So, my brain-scanning partner, neuroscientist Lucy Brown, has proposed that romantic love is a natural addiction, a normal altered state” experienced by almost all humans.	0.382952
Romantická príťažlivosť sa spája s niekoľkými psychologickými, behaviorálnymi a fyziologickými vlastnosťami.	Romantic attraction is now associated with a suite of psychological, behavioral, and physiological traits.	0.534043
Rozbor tohto šialenstva sa začal zhromažďovaním údajov, ktoré sa spomínajú v publikácii Láska a limerencia: skúsenosť s láskou (z originálu Love and Limerence) od Dorothy Tennovovej.	Data collection largely began with the now classic dissection of this madness, found in Love and Limerence, by Dorothy Tennov.	0.589683
Tennovová vytvorila približne 200 výrokov na tému romantická láska. ~~~ Požiadala 400 mužov a žien z Bridgeportskej univerzity a jej okolia v štáte Connecticut, aby na otázky odpovedali slovami áno alebo nie.	Tennov devised approximately 200 statements about romantic love and asked 400 men and women at and around the University of Bridgeport, Connecticut, to respond with true” or false” reactions.	0.118545
Dotazníky vyplnili stovky ďalších osôb.	Hundreds of additional individuals answered subsequent versions of her questionnaire.	-0.0416667
Z ich odpovedí, rovnako aj denníkov a iných osobných záznamov, Tennovová identifikovala charakteristiky, ktoré sú spoločné pre stav byť zamilovaný, ktorý nazvala limerenciou.	From their responses, as well as their diaries and other personal accounts, Tennov identified a constellation of characteristics common to this condition of being in love, ” a state she called limerence.”	0.383824
Prvým rozhodujúcim aspektom romantickej lásky je jej vznik, teda okamih, kedy váš partner začne pre vás znamenať niečo viac.	The first dramatic aspect of romantic love is its inception, the moment when another person begins to take on special meaning.	0.3
Začínate sa (zámerne) sústreďovať na danú osobu. ~~~ Vedci hovoria o prvom náznaku záujmu.	”You start to focus intently on him or her, a state known to scientists as salience.	-0.015
Môže ísť o dlhoročného kamaráta, ktorého vidíte v inom svetle alebo o niekoho cudzieho.	”It could be an old friend seen in a new perspective or a complete stranger.	0.242857
Ako však povedal jeden z Tennovovej probandov: Zmenil sa celý môj život.	But as one of Tennov’s informants put it, My whole world had been transformed.	0.280645
Všetka moja pozornosť sa upriamila na môj nový objekt záujmu, na Marilyn.	It had a new center and that center was Marilyn.	0.400227
Romantická láska sa ďalej rozvíja podľa konkrétneho vzorca.	Romantic love then develops in a characteristic pattern, beginning with intrusive thinking.	0.141509
Všetko to začína nepokojnou mysľou. ~~~ Myšlienky o objekte vášho záujmu zaplavujú vašu myseľ.	Thoughts of the love object” begin to invade your mind.	0.179688
V ušiach vám stále rezonujú slová, ktoré povedal.		-0.3
Predstavujete si jej úsmev, pripomínate si rôzne odpovede, jedinečné okamihy, dvojzmyselné významy slov a vychutnávate si to.	A certain thing he said rings in your ear; you see her smile, recall a comment, a special moment, an innuendo—and relish it.	0.446278
Zaujíma vás, čo si objekt vášho záujmu myslí o knihe, ktorú čítate, o filme, ktorý ste videli alebo o probléme vo vašej práci.	You wonder what your beloved would think of the book you are reading, the movie you just saw, or the problem you are facing at the office.	0.277143
A každý zlomok sekundy, ktorý ste spolu prežili, si znova prehrávate a skúmate vo vašej mysli.	And every tiny segment of the time the two of you have spent together acquires weight and becomes material for review.	0.22875
Nikdy nezabudnem na ten pocit, keď som prvýkrát uvidela výsledky.	I will never forget the moment I first saw the results.	0.228261
Mala som pocit, že vyskočím do neba.	I felt like jumping in the sky.	0.242308
Najskôr sa tieto predstavy objavujú ako snívanie počas dňa.	At first these intrusive reveries may occur irregularly.	0.288
Niektorí tvrdia, že keď posadnutosť naberie na sile, dokážu 85 až 100 percent svojho času nepretržite rozmýšľať o objekte svojho záujmu. ~~~ A sú zbláznení do jediného jednotlivca.	But many said that, as the obsession grew, they spent from 85 to almost 100 percent of their days and nights in sustained mental attentiveness, doting on this single individual.	0.845338
Fixovaním sa na jednu osobu milenci strácajú schopnosť sústrediť sa na iné veci, ako napríklad na každodenné povinnosti, prácu, školu a ľahko sa rozptyľujú.	Indeed, along with this fixation, lovers lose some ability to focus on other things, such as daily tasks, work, and school; they become easily distracted.	0.29313
Dokonca sa začnú zameriavať na triviálne povahové črty zbožňovaného jednotlivca. ~~~ Tieto vlastnosti následne zveličujú, čo môžeme nazvať procesom kryštalizácie.	Moreover, they begin to focus on the most trivial aspects of the adored one and aggrandize these traits in a process called crystallization.	-0.0302521
Kryštalizácia je odlišná od idealizácie v tom, že šialene zamilovaná osoba vníma slabé stránky svojho idola.	Crystallization is distinct from idealization in that the infatuated person does indeed perceive the weaknesses of his or her idol.	0.239362
Väčšina osôb, ktoré Tennovová pozorovala, dokázala spísať zoznam zlyhaní milovanej osoby.	In fact, most of Tennov’s participants could list the faults of their beloved.	0.241791
Jednoducho si tieto nedostatky nevšímali, alebo presvedčili sami seba o tom, že išlo o jedinečné a neodolateľné defekty.	But they simply cast these flaws aside or convinced themselves that these defects were unique and charming.	0.26087
Chaucer hovorí: Láska je slepá.	As Chaucer said, love is blynd.	0.788889
Tennovovej šialene zamilovaní respondenti poukázali počas fantazírovania na tri dominantné pocity: túžba, nádej a neistota.	Paramount in the daydreams of Tennov’s infatuated informants were three overriding sensations: craving, hope, and uncertainty.	0.294545
Ak osoba, ktorú milujete, reaguje pozitívne, zbláznený partner si bude tieto vzácne fragmenty prehrávať v mysli niekoľko dní.	If the cherished person gave the slightest positive response, the besotted partner would replay these precious fragments in reverie for days.	0.422115
Ak jedna alebo druhá strana pokus o zblíženie odmietne, z neistoty sa môže stať zúfalstvo a nevšímavosť.	If he or she rebuffed one’s overtures, uncertainty might turn to despair and listlessness instead.	0.285882
Milenec sa bude bezcieľne potulovať a premýšľať, až kým sa mu nepodarí ospravedlniť svoj neúspech a nenájde odpoveď na otázku.	The lover would moon about, brooding until he or she had managed to explain away this setback and renew the quest.	0.258947
Ústredným podnetom impulzívneho konania je nepriazeň osudu a sociálne bariéry. ~~~ Tieto faktory môžu posilniť romantickú vášeň a žiadostivosť. Ide o fenomén, ktorý som nazvala frustrácia z príťažlivosti.	Key incendiaries are adversity and social barriers; these heighten romantic passion and craving—a phenomenon I christened frustration attraction.”	-0.0339623
Základným spúšťačom úzkosti a extázy je nikdy nekončiaci sa strach.	And underlying all of this angst and ecstasy is unmitigated fear.	0.283929
28-ročný vodič kamiónu popísal podobné pocity ako väčšina respondentov: Skoro som vyskočil z kože, povedal.	A 28-year-old truck driver summed up what most informants felt: I’d be jumpy out of my head,” he said.	0.268235
Bolo to niečo ako tréma, akoby som kráčal na pódium pred dav ľudí.	It was like what you might call stage fright, like going up in front of an audience.	0.223636
Pri stlačení zvončeka sa mi triasli ruky.	My hand would be shaking when I rang the doorbell.	0.25
Keď som jej volal, pulz v spánkoch bol tak silný, že som nepočul ani vyzváňací tón.	When I called her on the phone, I felt like I could hear the pulse in my temple louder than the ringing of the phone.”	0.186957
Zvýšené množstvo energie (tzv. hypománia) je taktiež jedným z hlavných ukazovateľov romantickej lásky.	Intense energy (hypomania) is another central trait of romantic love.	0.152459
Pobláznený milenec sa chveje, bledne, zažíva návaly horúčavy, celkovú slabosť, zdrvujúci pocit trápnosti, koktanie a pociťuje reakcie, ktoré sú podmienené sympatickým nervovým systémom vrátane potenia, tzv. motýlikov v žalúdku, búšenia srdca, porúch prijímania potravy alebo problémov so zaspávaním.	Smitten lovers report trembling, pallor, flushing, a general weakness, overwhelming sensations of awkwardness and stammering, as well as one or more sympathetic nervous system reactions, including sweating, butterflies in the stomach, a pounding heart, and difficulty eating or sleeping.	0.361323
Niektorí ľudia majú dokonca pocit, že prišli o väčšinu základných schopností a zručností.	Some even feel a loss of their most basic faculties and skills.	0.38926
Francúzsky románopisec 19. storočia Stendhal tento pocit dokonale opísal.	Stendhal, the 19th-century French novelist, described this feeling perfectly.	0.281818
Spomenul si na popoludnie, kedy sa prechádzal so svojou milou a napísal: Vždy, keď som podal Léonore ruku, mal som pocit, že spadnem a musel som premýšľať, ako správne chodiť.	Recalling the afternoons, he went strolling with his sweetheart, he wrote, Whenever I gave my arm to Léonore, I always felt I was about to fall, and I had to think how to walk.	0.29375
Ďalšími ústrednými pocitmi romantickej vášne sú plachosť, dychtivé očakávanie, strach z odmietnutia, túžba po reciprocite a intenzívna motivácia získať si výnimočného človeka.	Shyness, anticipation, fear of rejection, longing for reciprocity, and intense motivation to win this special person are other central sensations of romantic passion.	0.27931
Milenci môžu byť často žiarliví, v snahe ochrániť začínajúce partnerstvo.	Lovers can also become easily jealous.	0.0264706
Niektorí zachádzajú do extrémov, čo je medzi zvieracími behavioristami známe ako ochrana partnera.	Some even go to extremes to protect the budding partnership, known to animal behaviorists as mate guarding.	0.282759
Ľudia, ktorých Tennovová pozorovala, zažívali predovšetkým pocit bezmocnosti a dojem, že ich posadnutosť bola iracionálna, mimovoľná, neplánovaná, nekontrolovateľná.	Above all, Tennov’s participants expressed the feeling of helplessness, the sense that this obsession was irrational, involuntary, unplanned, uncontrollable.	0.280714
Ja si skôr myslím, že náklonnosť k Emily je pudovou záležitosťou. ~~~ Ide o inštinktívne konanie, ktoré nie je ovládané voľou alebo logickosťou.	As a business executive in his early 50s wrote about an office crush, I am advancing toward the thesis that this attraction for Emily is a kind of biological, instinct-like action that is not under voluntary or logical.	-0.075
To mi udáva smer.	It directs me.	0.253846
Snažím sa tomu odolať, nenechať sa ovplyvňovať a využiť to napr. pri sexe, poprieť to, užiť si to a áno dofrasa, prinútiť ju reagovať!	I try desperately to argue with it, to limit its influence, to channel it (into sex, for example), to deny it, to enjoy it, and, yes, dammit, to make her respond!	0.48375
Aj keď viem, že Emily a ja nemáme absolútne žiadnu šancu na spoločný život, som posadnutý myšlienkou na ňu, uviedol 50-ročný obchodný manažér na tému kancelárske aféry.	Even though I know that Emily and I have absolutely no chance of making a life together, the thought of her is an obsession.	0.419412
Zdá sa, že romantická láska je súborom intenzívnych emócií, ktoré pripomínajú jazdu na horskej dráhe (zhora nadol) a pohyb kyvadla, pričom sa tieto emócie prejavia iba u jedného človeka a jeho rozmary vás môžu dohnať k zničeniu všetkého okolo vás vrátane pracovných príležitostí, vašej rodiny a vzťahu s vašimi priateľmi.	”Romantic love, it seems, is a panoply of intense emotions, rollercoastering from high to low, hinged to the pendulum of a single being whose whims command you to the detriment of everything around you—including work, family, and friends.	0.348401
Táto mimovoľná spleť myšlienok, pocitov a motivácie iba čiastočne súvisí so sexom.	And this involuntary mosaic of thoughts, feelings, and motivations is only partially related to sex.	0.2375
Tennovovej šialene zamilovaní respondenti túžia mať s milovanou osobou sex.	Tennov’s infatuated lovers yearned to have sex with their beloved.	0.253448
Ale ich žiadostivosť zatieňuje oveľa hlbšia túžba.	But their lust was overshadowed by a far deeper craving.	0.28
Chceli by svojim milovaným zavolať, napísať, pozvať ich von, ale predovšetkým opätovať ich vášeň.	They wanted their beloved to call, write, invite them out, and, above all, reciprocate their passion.	0.292941
Sexuálnu túžbu prekonáva emocionálna väzba medzi šialene zamilovanými mužmi a ženami.	For infatuated men and women, emotional union trumps sexual desire.	0.213559
V skutočnosti 95 percent žien a 91 percent mužov, ktorých Tennovová pozorovala negovalo výrok: Najlepšie na láske je sex.	In fact, 95 percent of Tennov’s female informants and 91 percent of her male subjects rejected the statement The best thing about love is sex.”	2.35385
Tieto pocity sa môžu objaviť v každom veku.	Moreover, these feelings can erupt at any age.	0.275676
Zistila som to, keď som zostavila môj vlastný dotazník na tému romantická láska a zozbierala údaje od 437 Američanov a 402 Japoncov.	I discovered this when I designed my own questionnaire on romantic love and collected data on 437 Americans and 402 Japanese.	1.91938
Ľudia starší ako 45 rokov a osoby mladšie ako 25 rokov nepreukázali žiadne významné štatistické rozdiely v 82 percentách otázok.	People over age 45 and those under 25 showed no significant statistical differences on 82 percent of the queries.	2.20625
Intenzívne pocity romantickej lásky sa zvyčajne vyskytujú v puberte.	Intense feelings of romantic love generally first occur around puberty.	0.290164
Ale aj malé deti môžu zažiť pocit zaľúbenia alebo detskú lásku.	But even young children can experience a crush” or puppy love.	0.29434
Najmladší zaľúbený človek, ktorého som stretla bol 2 a pol ročný chlapec.	The youngest love-struck person I ever met was a 2-and-a-half-year-old boy.	0.535714
Vždy, keď malé dievčatko prišlo do jeho domu na akože rande, sedel vedľa nej a hladkal ju po vlasoch. ~~~ Po jej odchode mal asi dvojhodinové depresie.	Every time a particular little girl came to his home for a playdate, he just sat beside her and stroked her hair; after she departed, he became depressed for about two hours.	-0.0228
Ona bola jedinečná a on bol (ňou) posadnutý.	She was special; he was obsessed.	0.206897
Láska zraňuje:	LOVE HURTS:	0.218182
Ilustrácia zo Stendhalovho románu Červený a čierny (z fran. originálu Le Rouge et le Noir), ktorá opisuje milostný trojuholník z roku 1830 počas Francúzskej revolúcie.	An illustration from Stendhal’s novel Le Rouge et le Noir, which features a love triangle set during the 1830 French Revolution.	2.38549
Hlavná postava románu - Julien Sorel - bol popravený gilotínou.	Its protagonist, Julien Sorel, is guillotined.	0.635714
Z časopisu Culture club	Culture Club	1.075
V roku 1996 som pracovala na projekte, ktorého cieľom bolo zistiť, čo sa deje v mozgu, keď sa človek bezpodmienečne a šialene zamiluje.	In 1996, I embarked on a project to establish what happens in the brain when you fall deeply, madly in love.	0.352094
Najskôr som naplánovala experiment.	First, I planned the experiment.	0.858621
Zozbierala som údaje o aktivite mozgu (pomocou funkčnej magnetickej rezonancie alebo fMRI) počas toho, ako šialene zamilovaní respondenti plnili dve samostatné úlohy: pozerali by sa na fotografiu milovanej osoby a sledovali by fotografiu človeka, ktorý by v respondentoch nevyvolal žiadne pozitívne alebo negatívne emócie.	I would collect data on brain activity (using functional magnetic resonance imaging, or fMRI) as love-smitten participants performed two separate tasks: gazing at a photograph of their beloved and looking at a photograph of someone who generated no positive or negative feelings in them.	0.390476
Pri pozeraní sa na fotografiu s milovanou osobou a na neutrálnu fotografiu by respondenti vykonávali činnosť, ktorá by ich rozptyľovala.	Between eyeing the positive and neutral photos, they would perform a distraction task.	0.342286
V tomto prípade by som na obrazovke premietala väčšie číslo (napríklad 6 137) a poprosila respondentov, aby od tohto čísla začali počítať odzadu z pamäti v inkrementoch po sedem (ide o kladné alebo záporné číslo, o ktoré dané číslo zväčšujeme).	In this case, I would cast a large number on the screen (like 6, 137) and ask participants to mentally count backward from this number in increments of seven.	0.328244
Myslela som si, že keď budú vystavení stimulom pripomínajúcim ich milovaných a neutrálnym podnetom, že ich myseľ sa zbaví silných emócií.	This, I hoped, would cleanse the brain of strong emotions between exposure to the beloved and exposure to the neutral stimulus.	0.272222
Potom by som porovnala mozgové aktivity, počas všetkých troch situácií.	Then I would compare the brain activity that occurred under all three conditions.	0.266667
Moja hypotéza?	My hypothesis?	0.3
Domnievala som sa, že nájdem zvýšenú aktivitu v tej časti mozgovej siete, ktorá vytvára dopamín, prírodný stimulant. ~~~ Táto oblasť mozgu generuje energiu, eufóriu, túžbu, sústredenosť a motiváciu, hlavné črty romantickej lásky.	Foremost, I suspected I would find elevated activity in the brain’s networks for dopamine, a natural stimulant—because this brain system generates energy, euphoria, craving, focus, and motivation, some of the core traits of romantic love.	-0.00530303
Taktiež som predpokladala, že vyššie množstvo neurochemického noradrenalínu v mozgu môže prispieť k šialenstvu, pretože daný neurotransmiter má za následok sústredenie sa a motiváciu, ale aj niektoré z telesných prejavov romantickej lásky. ~~~ Ide napríklad o motýliky v žalúdku, roztrasené kolená a sucho v ústach.	I also posited that the closely related neurochemical norepinephrine might contribute to this madness, because this neurotransmitter produces focus and motivation too, as well as some of the bodily responses of romantic love such as butterflies in the stomach, wobbly knees, and a dry mouth.	0.0315433
Myslela som si, že nízka aktivita v oblasti, v ktorej sa vytvára serotonín, môže vytvoriť dotieravé a obsedantné myšlienky spojené s romantickou vášňou.	And I thought low activity in the serotonin system might create the intrusive, obsessive thinking of romantic passion.	0.214706
Nakoniec som čakala, že do hry vstúpi mnoho ďalších neurochemických systémov, ktoré vyvolávajú rozličné emócie, pohnútky, myšlienkové pochody a sú výsledkom poznávacej činnosti a správania typického pre romantickú lásku.	Last, I expected that many other neurochemical systems might be involved—together producing the range of emotions, motivations, cognitions, and behaviors common to romantic love.	0.228846
Ale stavila som hlavne na dopamín.	But my bets were on dopamine.	0.24
Odmietnutí milenci sú stále šialene zamilovaní a lipnú na partnerovi, ktorý ich zavrhol.	These discarded lovers are still madly in love with and deeply attached to their rejecting partner.	0.268831
Trpia fyzicky aj duševne.	They are in physical and mental pain.	0.182609
Potom som s Brownom, psychológom Artom Aronom a s inými zoskenovala mozog ďalším 17-tim milencom. ~~~ Išlo o 10 žien a 7 mužov, ktorí boli šialene a šťastne zamilovaní po dobu v priemere 7,4 mesiaca.	Then, with Brown, psychologist Art Aron, and others, I put 17 new lovers into the brain scanner: 10 women and seven men who had been madly and happily in love for an average of 7.4 months.	-0.0107143
Stála som v tmavom laboratóriu na pôde Lekárskej fakulty Alberta Einsteina.	I was standing in a darkened lab at the Albert Einstein College of Medicine.	0.290625
Bolo to ešte pred tým, ako som rozpoznala aj tie najmenšie zhluky, ktoré vykazovali aktivitu vo ventrálnej tegmentálnej oblasti alebo VTA, teda oblasti mesencefalonu, tiež známeho ako stredný mozog.	Before my eyes were scans showing blobs of activity in the ventral tegmental area, or VTA, a tiny factory near the base of the brain that makes dopamine and sends this natural stimulant to many brain regions.	0.496491
Ide o malú továreň v blízkosti spodnej časti mozgu, ktorá vyrába dopamín a týmto prírodným stimulantom zásobí aj iné oblasti v mozgu.		-0.3
Zároveň sme zaznamenali aktivitu v iných častiach mozgu, ale oblasť VTA bola veľmi dôležitá.	We found activity in many other brain regions, but the VTA was particularly important.	0.475676
Je súčasťou systému odmeny mozgu, mozgovej siete, ktorá generuje pocit nedostatku, chuť hľadať, túžbu, energiu, sústredenie a motiváciu.	This factory is part of the brain’s reward system, the brain network that generates wanting, seeking, craving, energy, focus, and motivation.	0.295
Fičia na prírodnom amfetamíne.	They are high on natural speed.	0.288889
Muži cítia túto vášeň rovnako intenzívne ako ženy.	And men feel this passion just as powerfully as women.	0.286364
V tejto súvislosti Tennovová vzhľadom na viac než 800 respondentov vyhodnotila, že muži aj ženy zažili intenzívnu vášeň v takmer rovnakom percentuálnom pomere.	Tennov wrote of her more than 800 informants that men and women experienced this intense passion in roughly equal proportions.	1.7881
S mojimi kolegami sme tento predpoklad potvrdili.	My colleagues and I have now confirmed this.	0.252632
V našej štúdii zameranej na mladých šťastných milencov s pomocou fMRI muži preukázali rovnakú aktivitu v oblasti VTA a iných nervových dráhach súvisiacich s romantickou vášňou ako ženy.	In our fMRI study of young happy lovers, men showed just as much activity in the VTA and other neural pathways for romantic passion as women did.	0.416786
Navyše pri opakovaní experimentu so skenovaním mozgu v Číne miestni respondenti zaznamenali rovnakú aktivitu vo VTA a v oblasti, v ktorej sa vytvára dopamín. ~~~ V tomto prípade hovoríme o neurochemických dráhach plných potrieb.	Moreover, when my colleagues re-did this brain scanning experiment in China, their Chinese participants showed just as much activity in the VTA and other dopamine pathways—the neurochemical pathways for wanting.	0.00666667
Takmer každý človek na tejto Zemi pociťuje rovnakú vášeň.	Almost everyone on earth feels this passion.	0.215385
Keďže VTA leží v blízkosti primitívnych oblastí mozgu, ktoré sú prepojené s pocitmi hladu a smädu, uvedomila som si, že romantická láska je u ľudí základnou hnacou silou.	In fact, because the VTA lies near primitive brain regions associated with thirst and hunger, I came to realize that romantic love is a basic human drive.	0.479402
Môj kolega Brown, ktorý má na starosti röntgenové snímanie mozgu, pridal zaujímavú myšlienku. ~~~ Romantická láska je podľa neho rovnako dôležitým mechanizmom na prežitie ako uspokojiť smäd.	My brain-scanning partner Brown has added to this perspective, saying that romantic love is a survival mechanism as crucial as the craving for water.	-0.0437008
Táto hnacia sila, tento mechanizmus dôležitý na prežitie, je tiež závislosťou.	This drive, this survival mechanism, is also an addiction.	0.194118
Avšak nie sme jediné bytosti, ktoré zdedili chémiu lásky.	Moreover, we are not the only creatures that have inherited the chemistry of love.	0.18
Keď samica hraboša prérijného začne prejavovať záujem o samca toho istého druhu, v niektorej z častí odmeňovania mozgu sa zvýši hladina dopamínu o 50 percent.	When a female prairie vole begins to express attraction to a male vole, she experiences a 50 percent increase of dopamine activity in parts of this reward system.	1.56701
Zvýšenie dopamínu v mozgu spôsobí, že aj samec ovce bude v očiach samice atraktívnejší.	An increase of dopamine in the brain is also associated with mate attraction in female sheep.	0.284
Nervový mechanizmus súvisiaci s príťažlivosťou sa vyvinul u mnohých druhov vtákov a cicavcov tak, aby jednotlivcom umožnil uprednostniť a zamerať sa na konkrétnych páriacich sa partneroch, čím sa ušetrí drahocenný čas a energia pri dvorení.	Hence, this neural mechanism for attraction must have evolved in many species of birds and mammals—to enable individuals to prefer and focus on specific mating partners, thereby conserving valuable courtship time and energy.	0.278238
U väčšiny druhov však príťažlivosť trvá krátko a môže ísť o minúty, hodiny, dni alebo týždne.	In most species, however, this attraction is brief, lasting only minutes, hours, days, or weeks.	0.28481
Intenzívna romantická láska v ranom štádiu môže u ľudí trvať oveľa dlhšie.	In humans, intense, early-stage romantic love can last much longer.	0.274576
Táto skúsenosť je vždy iná.	There is always variation in this experience, however.	0
Základná činnosť dopamínu (ako aj noradrenalínu a serotonínu) sa u každého líši. Teoreticky môžu zmeniť priebeh zamilovania a pretrvávania vo vzťahu.	Baseline activities of dopamine (as well as norepinephrine and serotonin) vary from one person to the next—potentially altering one’s proclivity to fall in love and stay in love.	0.249231
Ľúbostný pomer však môžu ovplyvniť aj iné mozgové systémy.	But other brain systems can also affect romance.	0.235714
Napríklad ľudia, ktorí tvrdia, že nikdy necítili romantickú lásku trpia hypopituitarizmom, zriedkavým ochorením, pri ktorom zlyhanie hypofýzy spôsobuje hormonálne problémy a tzv. neschopnosť vidieť lásku. ~~~ Títo muži a ženy vedú normálny život.	For example, some of those who report they have never felt romantic love suffer from hypopituitarism, a rare disease in which the pituitary malfunctions, causing hormonal problems and love blindness.	0.0489204
Niektorí z nich sa vzali len kvôli tomu, aby im niekto robil spoločnosť, zvláštne však je, že zlomené srdce je pre nich ako záhada z mytológie.	These men and women lead normal lives; some marry for companionship; but that rapture, that heartache, is mythology to them.	0.263208
Schizofrénia, Parkinsonova choroba a ďalšie ochorenia taktiež dokážu zmeniť činnosť dopamínu.	Moreover, schizophrenia, Parkinson’s disease, and other ailments alter dopamine pathways.	0.288889
Tak ako každá závislosť, aj romantická láska môže spôsobiť zmätok v našich životoch, najmä keď máme za sebou rozchod.	Like any addiction, romantic love can cause havoc in our lives—particularly when we’ve been dumped.	0.251163
Aby sme sa dozvedeli viac o nervových systémoch, ktorých aktivácia súvisí s odmietnutím, spolu s mojimi kolegami sme použili fMRI a pozorovali sme 10 žien a 5 mužov, ktorí nedávno zažili rozchod.	To learn more about the neural systems associated with rejection in love, my colleagues and I used fMRI to study 10 women and five men who had recently been dumped.	0.429578
Priemerná doba od prvotného odmietnutia bola 63 dní.	The average length of time since the initial rejection was 63 days.	3.89493
Všetci respondenti dosiahli v teste, ktorý sa zaoberal intenzitou vášnivej lásky, vysoké skóre. ~~~ Išlo o (subjektívne) zodpovedaný dotazník, ktorý meria intenzitu romantických pocitov.	All participants scored high on the Passionate Love Scale, a self-report questionnaire that measures the intensity of romantic feelings.	-0.0554622
Všetci povedali, že strávili viac ako 85 percent bdenia premýšľaním o osobe, ktorá ich odmietla.	All said that they spent more than 85 percent of their waking hours thinking of the person who rejected them.	2.52108
A všetci túžili po tom, aby sa partner, ktorý ich opustil, vrátil.	And all yearned for their abandoning partner to return.	0.25
Výsledky boli ohromujúce.	The results were stunning.	0.3
K aktivácii mozgu došlo v niekoľkých oblastiach systému odmeňovania mozgu.	Brain activations occurred in several regions of the reward system.	0.264407
Aktívne boli oblasti VTA spojené s pocitmi intenzívnej romantickej lásky, ventrálne pallidum spojené s pocitmi silnej náklonnosti, insulárny kortex a predná cingulárna kôra, s ktorými sa spája bolesť, úzkosť a utrpenie prepojené s fyzickou bolesťou a nucleus accumbens a orbitofrontálny/prefrontálny kortex, teda mozgové oblasti, ktoré vyhodnocujú, čo človek získal a stratil, rovnako ako jeho túžby a závislosti.	Included were regions of the VTA associated with feelings of intense romantic love; the ventral pallidum, associated with feelings of deep attachment; the insular cortex and the anterior cingulate, associated with physical pain, anxiety, and the distress associated with physical pain; and the nucleus accumbens and orbitofrontal/prefrontal cortex, brain regions associated with assessing one’s gains and losses—as well as craving and addiction.	0.432547
Najdôležitejšia pre našu štúdiu bola korelácia oblastí mozgu, ktoré analyzujú túžbu u drogovo závislých na kokaíne a iných drogách.	Most relevant to our story, activity in several of these brain regions has been correlated with the craving of cocaine addicts and other drugs.	0.281579
Stručne povedané, podľa našich údajov zo skenovania mozgu, sú títo odmietnutí milenci stále šialene zamilovaní a lipnú na partnerovi, ktorý ich zavrhol.	In short, as our brain scanning data show, these discarded lovers are still madly in love with and deeply attached to their rejecting partner.	0.27
Rovnako ako myš, ktorá posadnuto behá v koliesku (pre hlodavce), aj oni sú posadnutí premýšľaním nad tým, čo stratili.	Like a mouse on a treadmill, they are obsessively ruminating on what they’ve lost.	0.167143
Zamilovaný človek túži po stretnutí s milujúcou osobou, ktorá ho zavrhla, alebo skôr so svojou závislosťou.	And they are craving reunion with their rejecting beloved—addiction.	0.142623
Len málo z nás nespozná lásku.	Few of us get out of love alive.	0.3
V jednej americkej univerzitnej komunite 93 percent mužov aj žien uviedlo, že ich odvrhol niekto, koho vášnivo milovali a 95 percent uviedlo, že odmietli niekoho, kto sa do nich skutočne zamiloval.	In one American college community, 93 percent of both sexes reported that they had been spurned by someone they passionately loved, while 95 percent reported that they had rejected someone who was deeply in love with them.	1.57857
A to môže byť iba jedno zo sklamaní.	And this can be just the first disappointment.	0.2
Mnohí môžu dostať kopačky počas života aj viackrát.	Many may get dumped again in later life.	0.202941
Na trajektórii opúšťania sa a zotavovania sa existuje určitý vzorec.	There is a pattern to this trajectory of abandonment and recovery.	0.556938
Počas prvej fázy, tzv. protestnej, opustený milenec neoblomne pracuje na tom, aby znovu získal náklonnosť partnera, ktorý ho opustil.	During the first stage, the protest phase, the deserted lover works obsessively to regain the abandoning partner’s affection.	0.280734
