Bolo to po prvý raz, čo Gaglianová a jej kolegovia dokázali, že rastliny je možné vycvičiť rovnakým jednoduchým spôsobom ako psy.	For the first time, Gagliano and her colleagues showed that you can train plants the same basic way you can train dogs.	0.266667
Zatiaľ čo Pavlovove psy sa naučili, že zvonenie na zvonček znamená príchod potravy, Gaglianovej tím bol schopný vycvičiť záhradný hrášok tak, že si vedeli ventilátor spojiť so svetlom.	While Pavlov’s mutts learned that the ring of a bell meant food was coming, Gagliano’s team taught the garden peas to associate a fan with light.	0.208264
Tím vedcov umiestnil sadenice hrachu pod bludisko vytvorené z potrubných rozvodov. ~~~ Zakaždým, keď prišiel na rázcestie sa hrášok musel rozhodnúť, či rásť doprava alebo doľava.	The researchers placed seedlings under a maze made out of plumbing pipes; the growing pea had to make a choice each time it hit a fork in the road whether to go left or right.	-0.0116197
Prvé tri dni boli venované tréningu.	The first three days were devoted to training.	0.225
Gaglianová učila jednu skupinu hrachu, že keď ventilátor fúka z jednej strany bludiska, bude za ním nasledovať modré svetlo, ktoré hrach vyhľadáva.	Gagliano taught one group of peas that if a fan blew at them from a certain part of the maze, a blue light (something all peas crave) would follow.	0.2825
Druhá skupina sadeníc bola vycvičená tak, že ak ventilátor fúka z jednej strany bludiska, modré svetlo sa objaví na tej druhej.	Another group of seedlings was trained that when the fan blew, the light would appear in the opposite corridor.	0.255319
U tretej skupiny, ktorá slúžila ako kontrola, nebola vytvorená žiadna asociácia medzi ventilátorom a svetlom.	For the third group, acting as a control, there was no association between the fan and the light.	0.431944
No a hrášok to pochopil.	And the little pea plants learned.	0.171429
V závislosti od toho, čo sme s nimi robili, rastliny presne vedeli, čo ten ventilátor znamená, vraví Gaglianová.		-0.3
Experimenty založené na princípe bludiska sa zvyčajne vykonávajú so zvieratami.	Depending on the treatment, the plants knew exactly what the fan meant, Gagliano says.	0.287324
Štandardným predpokladom u nich je, že sa budú správať náhodne. ~~~ Preto Gaglianová a jej kolegovia očakávali rovnaký výsledok.	Based on maze studies involving animals, the typical subjects for this type of experiment, Gagliano and colleagues expected the peas to grow randomly, which is the standard research assumption — for animals.	-0.0913636
Vo svojej pôvodnej verzii však nevzali do úvahy to, že hrach dodržiava svoj vlastný systém, a preto sa vždy bude ťahať za svetlom.	Their initial model didn’t take into account that peas have their own system and will always grow toward light.	0.252128
Zo začiatku mi správanie hrachu pripadalo len ako náhodné rozhodovanie medzi dvomi dostupnými možnosťami. ~~~ Väčšina vedcov by to videla rovnako.	Until I saw my peas doing their thing, the standard, hypothetical assumption of 50/50 random choice was all I could see, and what most scientists would see because of our own learned conditioning, funny enough, says Gagliano.	-0.0761905
Iróniou však je, že k takémuto uvažovaniu sme sa zase vycvičili my sami.	The peas taught me how to see beyond my own training and conditioned assumptions.	0.474941
No potom som si všimla, že hrášok robil presne to, čo má, tvrdí Gaglianová, naučil ma nepozerať sa na veci len z jednej zaužívanej perspektívy.		-0.3
Gaglianovej experiment publikovaný v online časopise Scientific Reports koncom roka 2016 ukázal nie len to, že rastliny sú schopné vytvárať si asociácie, čo je už samo o sebe obdivuhodné, ale aj to, že ľudia dokážu rastliny ľahko podceňovať.	For Gagliano, that particular experiment, published in Scientific Reports in late 2016, showed not only that plants can learn by association — which is astounding in itself — but also how easily humans underestimate plants.	0.442982
Nevšímame si ich, tvrdí Gaglianová.	We are plant blind, she says.	0.216
Charles Darwin vytvoril v roku 1880 teóriu, že rastliny disponujú špeciálnymi bunkami podobnými mozgu, ktoré slúžia na spracovanie informácií a na rozhodovanie kadiaľ rásť.	In 1880, Charles Darwin theorized that plants have special cells devoted to processing information and making decisions about root growth, similar to a brain.	0.629118
Avšak až v 90.-tych rokoch začal František Baluška, rastlinný neurobiológ z univerzity v Bonne, túto teóriu dokazovať.	Yet it was only in the 1990s that Frantisek Baluska, a plant cell biologist at the University of Bonn in Germany, began proving Darwin’s theory.	0.247573
Baluška priznáva, že ani jeho rastliny kedysi nezaujímali.	Baluska admits that he was once plant blind, too.	0.228571
Už na začiatku svojej kariéry sa ale domnieval, že skupina buniek nachádzajúcich sa v koreňoch rastlín by mohla hrať dôležitú úlohu.	Early in his career, he suspected that a group of cells in the plant roots could be important.	0.165385
Avšak až o niekoľko rokov neskôr sa mu spolu s kolegami podarilo zistiť, že tieto bunky sú skutočne akýmsi operačným strediskom.	Only years later would he and colleagues discover the cells were actually a kind of command center.	0.210714
Tieto bunky sa špecializujú na prijímanie a spracovávanie informácií z prostredia, vďaka čomu vedia dať koreňu pokyn kadiaľ rásť.	These cells are highly specialized for sampling and processing information and then directing the root growth, he says.	0.273786
A sú veľmi podobné našim neurónom.	And they are very similar to our neurons.	0.25
To, že rastliny majú svoj mozog v pôde dáva do istej miery dokonalý zmysel.	In a way, it makes perfect sense that plants would have their brains in the soil.	0.280952
V pôde sa nežije ľahko.	Soil is a tough place to be.	0.255
Pre koreň je ťažké nájsť v nej výživné látky.	It’s a very difficult task for the root to find nutrition there, Baluska says.	0.0789474
Neustále musí analyzovať prinajmenšom 20 fyzikálnych parametrov ako sú napríklad teplota, vlhkosť alebo obsah ťažkých kovov v pôde.	At least 20 physical parameters — such as temperature, humidity or levels of heavy metals — are continuously sampled and analyzed.	2.02603
A všetky tieto informácie musí rastlina nejako spracovať a porovnať, aby sa dokázala správne rozhodnúť, ktorým smerom bude rásť, tvrdí Baluška.	And all this information has to be then somehow processed and compared to make the right decision about which way to grow.	0.235294
Myslí si, že telo rastliny by sme mali považovať za podobné tomu nášmu, len hore nohami. Hlavu majú zasadenú v pôde, zatiaľ čo ich opačná časť spolu s pohlavnými orgánmi, teda kvetmi, vytŕča nad zemou.	He believes we should think of plants as having a body plan not so unlike our own, just upside down, with their heads buried in the ground and their backsides and sexual organs, such as flowers, sticking into the air.	0.280357
Možno to vyzerá ako znepokojujúci obraz, no Darwin mal o rastlinách podobnú predstavu.	It may be a disturbing thing to picture, but Darwin had a similar mental image of plants.	0.724517
Bez ohľadu na to, kde sa tento mozog nachádza - aj keď je stále otázne, či sa vôbec dá hovoriť o mozgu - existuje množstvo behaviorálnych štúdií, ktoré dokazujú, že rastliny sú omnoho múdrejšie než by sme predpokladali.	No matter where the brains of plants might be located — if they exist at all, that is, since the idea remains controversial — plenty of behavioral studies show they are far more brainy than we tend to assume.	0.278947
Tak napríklad, rastliny nezabúdajú.	For one, they remember stuff.	0.219231
Možno sa nenahnevajú, ak ich zabudnete poliať, no váš prehrešok si zrejme uchovajú v pamäti.	If you don’t water your houseplants, they may not get angry, but they might commit your misdeed to memory.	0.262025
Na to, aby mohli túto pamäť preskúmať vedia vedci na svojich pokusných králikoch vyvolať čosi, čo sa nazýva stres zo sucha.	To study this memory, scientists can evoke what’s called a drought stress in their leafy subjects.	0.228571
V jednej štúdii z roku 2015 vedci odobrali z pôdy vzorku trojtýždňovej arábkovky Thalovej (bylina príbuzná kapuste a horčici).	In one 2015 study, researchers took 3-week-old specimens of Arabidopsis thaliana (a relative of cabbage and mustard) out of the soil.	1.93624
Filtračným papierom jej osušili korene a tieto sadenice potom nechali dve hodiny schnúť.	They patted all the water off their roots with filter paper and left the seedlings to dry for up to two hours.	0.249351
Takéto zaobchádzanie sa nepáči žiadnej rastline, čoho následkom bol stres.	That kind of treatment is something no plant likes — hence the stress.	0.264407
Keď ich o niečo neskôr vrátili do vody, sadenice tomuto novému prostrediu nedôverovali a správali sa tak, akoby očakávali ďalšie obdobie sucha. ~~~ Póry na ich listoch zostali čiastočne stiahnuté, aby obmedzili príjem vody a tiež stratu vlhkosti pre prípad, že by opäť nastalo sucho.	Later, when the young seedlings were put back into water, they didn’t trust the newfound abundance and behaved as if they were ready for another period of drought: The pores on their leaves remained partially closed, limiting drinking, but also limiting moisture loss in case of another dry spell.	-0.00690377
V roku 2014 si Gaglianová na výskum pamäte zvolila iný druh rastliny: citlivku obyčajnú, ktorá je známa svojou citlivosťou na dotyk.	In 2014, Gagliano chose a different species to study plant memory: Mimosa pudica, famed for its sensitivity to touch.	0.261
Už len pri letmom kontakte s rukou sa list citlivky takmer okamžite stiahne.	If you brush a leaf of a mimosa with your fingers, it will fold almost instantly.	0.290769
So svojimi kolegami z univerzity v Západnej Austrálii a univerzity vo Florencii v Taliansku však s rastlinami spravili niečo omnoho radikálnejšie než len pohladili ich listy. ~~~ Púšťali ich z výšky na zem.	She and her colleagues from the University of Western Australia and University of Firenze in Italy did something more radical to the mimosa plants than stroking their leaves: They dropped them from heights.	-0.000862069
Vedci ich nechali spadnúť z výšky pätnástich centimetrov, čo je dostatočná vzdialenosť na to, aby stiahli listy.	The researchers let them fall 6 inches, far enough to cause the plants to fold their leaves.	0.222078
Stalo sa to po prvom, po druhom, aj po treťom páde.	It happened after the first drop, and the second, and the third.	0.214286
No na štvrtý raz sa už citlivka svoje listy príliš nepokúšala stiahnuť.	But by the fourth go, the mimosa leaves weren’t as eager to close.	0.267273
Po 60 pádoch už rastliny tento zážitok ignorovali úplne.	After 60 falls, the plants completely ignored the experience.	3.56939
Dokonca aj po mesiaci si stále pamätali, že takýto pád je pre nich neškodný a vôbec sa nesnažili listy sťahovať.	Even a month later, they still remembered that being dropped was harmless and would not bother to fold their leaves.	0.430091
Keď vedci prudko zatriasli kvetináčom citlivky, namiesto pádu z výšky rastlina okamžite stiahla listy, aby sa ochránila pred nebezpečenstvom. To dokazuje, že ľahostajnosť u rastliny nespôsobila únava.	But if the scientists vigorously shook the mimosa pots instead of dropping them, the plants rapidly closed their leaves to protect themselves from danger, showing it was not just simple fatigue that made them indifferent to the fall.	0.262286
Bola to pamäť.	It was memory.	0.3
Zvyčajná reakcia na tento experiment je, že veď ‘rastliny predsa nemajú mozog, tak ako je možné, že také niečo vedia robiť?‘ Pravdou však zostáva, že to vedia.	The typical reaction to this experiment is, ‘But plants have no brains, so how can they do it?’Gagliano says, But let’s look the other way round — they do it.	0.505055
Takže otázka by skôr mala znieť ‘Ako to robia?‘ tvrdí Galianová.	So the question should rather be, ‘How do they do it?’	0.233333
Vedci na túto otázku zatiaľ nedokážu odpovedať, avšak uvažujú nad niekoľkými možnými dôvodmi.	Researchers can’t answer that question yet, but a few possibilities are emerging.	0.253521
Jedným z nich napríklad je, že kolísanie hladiny vápnika v rastlinných bunkách zanecháva stopy stresu podobným spôsobom, ako keď sa u zvierat ukladajú spomienky do dlhodobej pamäte.	It could be, for example, that fluctuations in calcium levels in plant cells leave imprints of stress in a way that’s similar to how long-term memories are formed in animals.	0.279452
Ďalšie štúdie napovedajú, že pamäť rastlín by mohla byť epigenetického charakteru.	Other studies hint that memory in plants may be epigenetic in nature.	0.228814
Myši napríklad dokážu zdediť obavy svojich rodičov vďaka zmenám v exprimácii ich génov bez toho, aby sa zmenila samotná DNA.	Mice, for example, can inherit fearful memories from their parents through changes in how their genes are expressed, without any changes to the DNA itself.	0.226415
To isté by mohlo platiť aj u rastlín.	The same may hold true for plants.	0.27931
V roku 2015 skupina kanadských vedcov uverejnila výsledky experimentu uskutočnenom na rastline Brassica rapa trilocularis príbuznej okrúhlici, ktorá sa pestuje v Indii pre semená bohaté na olej.	In 2015, a group of Canadian scientists published the results of an experiment on Indian colza plants, relatives of turnips that are cultivated in India for their oil-rich seeds.	0.264238
Vedci opakovane vystavovali 2-týždňové sadenice extrémne vysokým teplotám nad 40°C.	The researchers repeatedly exposed 2-week-old seedlings to extreme heat — about a scorching 107 degrees Fahrenheit.	0.196
Následne nechali tieto rastliny, ktoré boli vystavené stresu, aby v pokoji rástli a rozmnožovali sa v príjemnej teplote 22 °C.	Afterward, they allowed the stressed plants to grow peacefully and reproduce in a comfortable 71.6 degrees Fahrenheit.	0.452104
Pri testovaní tkaniva nasledujúcej generácie sa však ukázalo, že ich génová expresia bola odlišná - jasný znak epigenetickej pamäte - napriek tomu, že ony samy neboli nikdy vystavené podobným horúčavám.	But when the tissues of the next generation were tested, they had differentially expressed genes — clear signs of epigenetic memory — even though they themselves had never experienced a hot spell.	0.285542
Debaty medzi rastlinami.	Plant Chat.	-0.0272727
Tak ako ľudia, aj rastliny majú veľa možností ako sa dozvedieť, čo sa odohráva v ich okolí.	Just like humans, plants have many ways of figuring outwhat’s happening in their environment.	0.280263
A ak sa aj niekedy nedokážu spoľahnúť na svoje skúsenosti, stále sa môžu porozprávať s ostatnými, aby zistili, ako sa veci majú pomocou mykoríznej siete, teda podzemného systému, ktorý spája korene rastlín a vedie signály cez vzájomne pospletané telá húb.	And if they can’t rely on their memories to compare experiences, they can always chat with others to find out what’s going on through the mycorrhizal network, an underground system that connects roots of plants and conducts signals through interwoven bodies of fungi.	0.287558
Sú to priame potrubia, ktoré spájajú rastliny ako telefónna šnúra, vraví Suzanne Simardová, ekologička s lesným zameraním z Univerzity Britskej Kolumbie, ktorá študuje mykorízne prepojenia.	These are direct pipelines from plant to plant, like a telephone wire, says Suzanne Simard, a forest ecologist at the University of British Columbia who studies mycorrhizal networks.	0.511538
Prvú štúdiu, ktorá jasne ukazuje, že rastliny sa skutočne dohovárajú pomocou tejto podzemnej siete, vykonali v roku 2013 vedci zo Spojeného kráľovstva.	The first study to clearly show plants do indeed talk through that underground network was done in 2013 by scientists based in the United Kingdom.	1.71527
Bôb záhradný rozdelili do troch skupín.	They took fava bean plants and divided them into three groups.	0.145714
Jedna skupina mala úlohu vysielača - tá bola pokrytá hladnými voškami, ktoré mali požuť listy týchto rastlín a tým ich zničiť.	Some were chosen as broadcasters — they were covered in hungry aphids that would munch on the unlucky plants, destroying them.	0.3
Druhá skupina bôbu bola bez vošiek, ale bola napojená na prvú skupinu pomocou podzemnej siete.	A second group of beans was aphid-free, but connected to the plants under attack via the root network.	0.281481
A posledná skupina, slúžiaca ako kontrola, bola taktiež bez vošiek, ale aj bez telefónneho spojenia, oddelená od zvyšných dvoch skupín.	And the third, the control group, was aphid-free but also separate from the other groups, unplugged from the soil telephone system.	0.286607
Rastliny napadnuté voškami boli schopné vysielaním chemických zlúčenín prostredníctvom mykoríznej siete upozorniť druhú skupinu na blížiaci sa útok hmyzu.	By sending out chemical compounds via the mycorrhizal network, the broadcasters warned the second group of plants of impending insect attack.	0.263115
Tieto rastliny začali produkovať chemikálie na odpudenie vošiek.	Those plants began producing aphid-repellent chemicals.	0.258824
Avšak rastliny, ktoré zostali bez spojenia, si neboli vedomé nebezpečenstva a nezačali produkovať žiadnu špecifickú ochranu pred voškami.	But the unplugged plants remained unaware of the danger and did not produce the specific aphid defense.	0.1875
Vedci už dlhú dobu vedeli o tom, že rastliny medzi sebou dokážu komunikovať vypúšťaním prchavých zložiek do vzduchu. ~~~ Najnovšie štúdie však ukazujú, že aj podzemný systém koreňov a húb zvaný mykorízna sieť dokáže prenášať impulzy z jednej rastliny na druhú.	Researchers have long known plants can communicate with each other through the release of volatile compounds in the air; studies have now shown an underground system of roots and fungi, called the mycorrhizal network, can also carry signals from one plant to the next.	-0.00409091
Na to, aby vedci zistili, či bôb skutočne komunikuje prostredníctvom koreňov, zabalili všetky tri skupiny rastlín do igelitových vriec, čím im zabránili v komunikácii pomocou chemikálií prenášaných vzduchom - jedným zo spôsobov, ako si rastliny vymieňajú informácie.	To test whether the fava plants were truly communicating through the roots, the researchers covered all three groups of plants in polyester bags, preventing them from talking via airborne chemicals — another way plants can exchange information.	0.268421
Keď budete najbližšie v lese, zhlboka sa nadýchnite a ovoňajte vzduch.	The next time you go to a forest, Simard says, take a deep breath and sniff the air.	0.515574
To, čo zacítite bude jazyk stromov, tvrdí Simardová.	What you are smelling is the language of trees.	0.255
Veľká časť prchavých látok, ktoré rastliny vypúšťajú pri komunikácii, majú svoju arómu. ~~~ Vďaka tomu sme schopní zachytiť niektoré ich konverzácie.	We can tune in to some of their conversations, because many of the volatile compounds that plants use in communication have odors, she says.	-0.0139831
Známa štúdia z roku 1983 hovorí o tom, že po napadnutí niektorých stromov ich susedia začali produkovať viac fenolov a trieslovín, ktoré sú prirodzeným repelentom hmyzu, akoby oni sami boli terčom útoku.	In a classic 1983 study, when leaves of some trees were damaged, their healthy neighbors emitted more phenolics and tannins — their natural insect repellents — in response, as if they themselves were under an attack.	1.3753
Logickou otázkou teda je, či rastliny skutočne navzájom komunikujú, alebo len špehujú, čo robia ostatní.	The obvious question is whether the plants are really talking, or if they’re just eavesdropping on what is happening with the others.	0.227473
Ak však rastlina, ktorú práve požiera hmyz vypúšťa obranné chemikálie a tie neskôr zachytí ďalšia rastlina, to ešte nemusí znamenať, že sa tým snažila varovať ostatných.	After all, if a plant being devoured by an insect is emitting defensive chemicals that are later detected by another plant, it doesn’t necessarily mean the first plant had any intention of warning others.	0.355249
Izraelskí vedci však tieto pochybnosti vyjasnili pozorovaním záhradného hráška pri spúšťaní poplachu o príchode obdobia sucha.	But scientists from Israel recently put such doubts to rest by studying how garden peas raise a drought alarm.	0.23871
Rastlina, ktorá je vystavená stresu z dôvodu nedostatku vody začne produkovať chemikálie, ktoré zachytia susediace rastliny.	A plant stressed by lack of water will emit chemicals that its neighbors detect.	0.114706
Tie na varovanie reagujú tým, že zatvoria svoje prieduchy - malé otvory na listoch - aby spomalili proces straty vlhkosti.	These plants react to the warning by closing their stomata — tiny openings on their leaves — to slow down moisture loss.	0.288
No tu táto komunikačná reťaz možnej hrozby nekončí.	But the chain of threat communication doesn’t end there.	0.273333
Aj keď samotné rastliny neboli vystavené stresu, tie, ktoré obdržali varovanie začnú vysielať signály o nastávajúcom období sucha vzdialenejším rastlinám.	The plants that have been warned, even though not stressed themselves, will start sending signals about the impending drought to those farther away, encouraging them to prepare for the hard times.	0.231618
Tým im dajú najavo, že sa majú pripraviť na ťažké časy.	And the reason they do it is not necessarily altruistic.	0.286957
Dôvod ich konania nemusí byť úplne nezištný. ~~~ Ak sa napríklad hrášok obráni pred suchom, dokáže sa potom lepšie obrániť aj proti škodcom. Tie ho napádajú, keď je oslabený.	In the case of peas, for example, being less vulnerable to drought also means being less vulnerable to pests, which attack when plants are weakened.	-0.0252
Je teda menej pravdepodobné, že požierači listov prídu tam, kde je hrášok zdravý.	If all the neighbors are healthy, they are less likely to attract leaf-munching visitors to the area.	0.231429
Každý sa má tak lepšie.	Everyone is better off.	0.285
Informácie sa priamo posielajú od jednej rastliny k druhej, na základe čoho menia svoje správanie, vraví Simardová.	Information is being sent from one plant to another, directly, and it changes their behavior, Simard says.	0.27033
Ľudia vypúšťajú vzduch cez hlasivky, a tak vydávajú zvuk.	We humans push air through our vocal cords and out comes sound.	0.282
U rastlín to nie je o vzduchu a hlasivkách, ale o uhlíkových zlúčeninách, ktoré uvoľňujú do vzduchu.	With plants it’s not air over vocal cords, but carbon compounds released into the air.	0.250685
Toto je ich jazyk.	It’s a language, too.	0.24375
A zdá sa, že tak ako ľudia, ani rastliny nehovoria tou istou rečou.	And just like humans, it appears not all plants speak the same language.	0.273214
Odlišní jedinci uvoľňujú do vzduchu odlišné prchavé látky - slová. Tie sa pospájajú do niečoho, čo vedci nazývajú signatúrou, ktorá by sa dala prirovnať vete.	Different individuals release different volatile compounds — words — into the air, which combine into what scientists call a signature — the equivalent of a sentence.	0.284444
Príbuzné rastliny majú podobný jazyk a o to ľahšie medzi sebou komunikujú.	The more related the plants are, the more similar their language, and the easier it is for them to communicate.	0.394832
Pokusy na paline z roku 2014 ukázali, že niektoré rastliny hovoria jazykom, v ktorom dominujú gáfrové zlúčeniny, zatiaľ čo iné uvoľňujú viac tujónu, čo je zhodou okolností tá istá chemikália, ktorá má pri požití absintu spôsobovať halucinácie.	Experiments in 2014 on sagebrush showed some plants spoke a language dominated by camphor compounds, while others emitted more thujone, coincidentally the same chemical suspected to be responsible for the hallucinogenic effects of absinthe.	1.24286
Tie paliny, ktoré komunikovali použitím podobných slov prenášaných vzduchom vedeli lepšie varovať ostatných pred príchodom hladných škodcov.	Those sagebrush plants that communicated using similar airborne words were better at warning each other about the arrival of hungry pests.	0.284874
Rastliny navyše svoj jazyk dedia po rodičoch, takže používanie toho istého nárečia im pomáha rozoznávať ostatných príbuzných.	What’s more, plants inherit their language from parents — so speaking the same dialect helps them also recognize relatives.	0.288679
Rodinné putá	Figuring Out The Family Tree	-0.025
Je veľmi pravdepodobné, že rastlina strávi svoj život obklopená rodinou, v dobrom aj v zlom.	If you are a plant, there is a good chance you’ll spend your life surrounded by your family, for better or for worse.	0.235443
Rastlina má dva dôvody, prečo rozoznávať príbuzných, vraví Susan Dudleyová, biologička z Univerzity McMaster v Ontáriu.	For a plant, there are two reasons to recognize a relative, says Susan Dudley, plant biologist at McMaster University in Ontario.	0.638655
Prvým dôvodom je nevytvárať spoločné potomstvo, a tým druhým je úžitok zo vzťahu.	One is to avoid mating with them, and the other is to benefit from the relationship.	0.3
Konkurencia niečo stojí.	Competition can be costly.	0.286957
Takže komu budú veriť?	So whom do you trust?	0.266667
S príbuznými majú spoločné gény, takže istým spôsobom je ich úspech úspechom všetkých.	Your relatives share your genes, so in a way their success is your success.	0.242857
Je to v podstate rodinkárstvo.	It’s basically nepotism.	0.247826
V jednom zo svojich pokusov Dudleyová vystavila arábkovku thalovú chemikáliám, ktoré pochádzali z koreňov jej súrodenca.	In one of Dudley’s experiments, Arabidopsis thaliana plants sampled chemicals coming from the roots of their siblings.	0.291262
Po tom, ako ich arábkovka spracovala, zabránila rastu vlastných koreňov, aby tak nechala viac priestoru pre iných. ~~~ To nespravila, keď výlučky pochádzali od cudzej rastliny.	Once exposed to these signatures, they restrained the growth of their own roots to leave more resources for others, something they didn’t do if the secretions came from strangers.	-0.000993377
Rastliny tiež dokážu rozoznávať svojich príbuzných podľa tvaru tela, ktoré je často podobné ich vlastnému.	Plants are also capable of recognizing their relatives by their body shape — which tends to be similar to their own.	0.287097
V niekoľkých experimentoch z roku 2014 argentínski biológovia vypestovali arábkovku thalovú (áno, vedci majú túto rastlinu skutočne radi) vo viacerých kvetináčoch.	In a series of experiments published in 2014, Argentinian biologists grew young Arabidopsis thaliana(yes, scientists really like that plant) in rows of pots.	0.282353
Ich tím vytvoril rastlinám rôzne podmienky. V prvom prípade sadenice jednoducho položili k príbuzným a cudzím rastlinám.	The team used many different setups: In some, the seedlings were simply placed between either relatives or strangers.	0.288119
V druhom prípade medzi ne umiestnili umelohmotné farebné filtre.	In other setups, the researchers positioned plastic light filters between the plants.	0.205263
No a v tom treťom využili geneticky modifikované rastliny, ktorým chýbali niektoré fotoreceptory.	And in yet others, they used genetically modified plants that lacked some sensory light receptors.	0.296471
Po analýze všetkých údajov mohli vedci povedať, že sadenice sa vedeli rozpoznať na základe tvaru tela. ~~~ Ich fotoreceptory dokázali zachytiť modrú a červenú farbu, dokonca aj takú, ktorá sa nachádza až na konci viditeľného spektra.	After analyzing all the data, the researchers were able to establish that the seedlings recognized each other by body shape: The plants’ light receptors could sense different patterns of red to far-red light and blue light visible around and reflected off of the other seedlings, creating a profile of each plant.	-0.05
Tieto farby boli viditeľné okolo ostatných sadeníc, odrážali sa od nich a tým vytvorili obrysy týchto rastlín.	Think of it in broad terms, the way you can pick out a friend walking toward you in a crowd, even if the light is in your eyes and you can’t see her facial features.	0.349825
Je to takmer ako keď vidíte známeho stáť v dave. Napriek tomu, že vám svetlo svieti do očí a vy nevidíte jeho tvár, dokážete ho spoznať.	For the seedlings, if a similarly shaped relative was detected, nepotism kicked in: The plant would grow its leaves away from the family member to avoid shading it.	0.452579
Ak sadenice rozpoznali rastlinu s podobným tvarom, začali držať spolu. Nasmerovali rast svojich listov na tú stranu, aby nimi netienili príbuznej rastline.	In addition to talking to each other, recognizing relatives and remembering stressful events, some plants can even count.	0.214286
Okrem toho, že rastliny medzi sebou vedia komunikovať, rozpoznávať príbuzných a pamätať si stresové situácie, niektoré dokonca vedia aj rátať.	Take the Venus’ flytrap, a carnivorous plant native to the wetlands of the Carolinas.	0.290411
Vezmime si napríklad mucholapku, mäsožravú rastlinu, ktorej prirodzeným prostredím sú mokrade v štáte Južná Karolína.		-0.3
Keď priletí mucha do pasce, listy rastliny sa zatvoria a tá následne začne tráviť svoju korisť.	When a fly lands inside the trap, the leaves shut, and the plant begins to digest its prey.	0.452471
Experimenty publikované v roku 2016 preukázali, že rastlina ráta, koľkokrát sa korisť dotkne receptorových chĺpkov nachádzajúcich sa na vonkajšej časti pasce, aby si overila, že to, čo chytila sa hýbe a teda je to niečo, čo sa bude dať zjesť.	Experiments published in 2016 showed the plant counts how many times the victim touches sensory hairs on the outer surface of the trap, initially to confirm the catch is something that moves, and therefore edible.	1.26
Jeden, dva a pasca sa zaklapne.	One, two, and the trap shuts.	0.276
Tri, štyri, päť a rastlina začína produkovať tráviace šťavy.	Three, four, five, and digestive juices start flowing.	0.26875
Je to jednoduchý proces, no je až prekvapivo podobný tomu, ktorý sa odohráva v mozgu zvierat. Podráždením chĺpkov sa vysiela elektrický impulz, alebo aj 'akčný potenciál', u zvierat známy ako nervový impulz.	The mechanism is simple, but strikingly reminiscent of what’s going on in the brains of animals: Touching the sensory hairs fires electrical messages, or action potentials — known as nerve impulses in animals.	0.298305
Podľa toho, koľkokrát boli chĺpky citlivé na pohyb podráždené, vie rastlina posúdiť, či sa do pasce zachytil len nejaký zbytočný predmet, alebo to bola živá korisť, vraví Sönke Scherzer, elektrofyziológ z Univerzity Júliusa-Maximiliána v nemeckom Würzburgu a spoluautor štúdie.	The plant can judge, by simply counting the number of action potentials spreading over the trap, whether useless dead material has landed inside it or if useful animal prey has been caught, says Sönke Scherzer, an electrophysiologist at the University of Würzburg in Germany, and one of the study’s co-authors.	0.4225
Toto počítanie sa spája s istou formou pamäte, pretože rastlina si aspoň na určitý čas musí zapamätať, koľkokrát sa akčný potenciál vyvolal.	Counting also includes some kind of memory, since the plant must remember — at least for a certain time interval — how many action potentials have been evoked before.	0.2525
Ak sa rastliny dokážu učiť, počítať a spoznávať príbuzných, môžeme o nich povedať, že skutočne premýšľajú?	If plants can learn, count and recognize family, can we say they actually think?	0.194118
Že sú inteligentné?	That they are intelligent?	0.2
Majú vedomie?	Conscious?	0.245455
Odpoveď z veľkej časti záleží na našej definícii pojmov ako inteligencia alebo poznanie.	How you answer these questions depends largely on your definition of concepts such as intelligence or cognition.	0.222078
Avšak spôsob, akým sa dívame na rastliny, sa mení.	Yet the way we view plants is changing.	0.209091
Pred niekoľkými rokmi nebolo možné v uznávaných odborných časopisoch použiť výraz ‘správanie rastlín‘, no tento pojem už viac nepôsobí kontroverzne, vraví Baluška.	A few years ago you couldn’t use the term plant behavior in accepted journals, but now the concept of plant behavior is not controversial anymore, says Baluska.	0.282222
Gaglianová si myslí, že mnohí ľudia rastlinám príliš nevenujú pozornosť, a preto im ani nezvyknú pripisovať schopnosť premýšľať. ~~~ Ak v konaní rastlín nechcete nikdy vidieť úmysel, tak ho ani neuvidíte.	Gagliano believes we tend not to credit plants with intelligence simply out of habit, because most of us remain plant blind: If you want to see plants as something that can never do anything purposefully, she says, that’s what you are going to see.	-0.0275862
[Tento článok sa pôvodne v tlači objavil pod názvom Chytré rastliny.]	[This article originally appeared in print as Smarty Plants.]	0.266667
		0.3
