Po prepuknutí rezignácie, respektíve zúfalstva, sa milenec vzdáva nádeje a skĺza do depresie.	As resignation/despair sets in, the lover gives up hope and slips into depression.	0.253521
Obidva prípady sú spojené so systémom dopamínu v mozgu.	Both are linked with the dopamine system in the brain.	0.286957
Mám podozrenie, že oba prípady boli hlboko zakorenené do mysle hominínov skôr, ako sa Lucy zamilovala a možno aj stratila milovanú osobu.	And I suspect that both were deeply embedded in the hominin mind by the time Lucy was loving, perhaps even losing a beloved, long ago.	0.544653
Keď milenci narazia vo svojich romantických pocitoch na prekážku, ich vášeň sa zintenzívni a nastane to, čo nazývam frustrácia z príťažlivosti.	When lovers encounter barriers to their romantic feelings, their passion intensifies—what I call frustration-attraction.	0.255556
Nepriazeň osudu posilňuje pocity romantickej lásky.	Adversity heightens feelings of romantic love.	0.264286
Tento jav je zakorenený v mozgu.	This phenomenon is rooted in the brain.	0.235714
Ak sa odmena oneskorí, neuróny dopamínového systému v mozgu pokračujú vo svojej činnosti a udržiavajú pocity intenzívnej romantickej lásky.	When a reward is delayed in coming, neurons of the brain’s dopamine system continue their activity—sustaining one’s feelings of intense romantic love.	0.430328
Vtedy za začína závislosť.	Addiction has set in.	0.221053
Aj keď romantická láska nie je zdraviu škodlivá, je spojená s intenzívnou túžbou a úzkosťou.	Even when romantic love isn’t harmful, it is associated with intense craving and anxiety.	0.292208
Stres zvyšuje množstvo dopamínu v tele.	Stress elevates this dopamine response.	0.291429
Keď cicavce po prvýkrát zažijú prudké zvýšenie stresu, ich telo na to reaguje zvýšenou aktivitou centrálneho dopamínu a norepinefrínu a nasleduje potlačenie centrálneho serotonínu, známeho ako odpoveď na stresovú situáciu.	When mammals first experience severe stress, among their bodily reactions is an increase in the activity of central dopamine and norepinephrine and a suppression of central serotonin, known as the stress response.	0.378741
Odmietnutí milenci môžu tiež trpieť frustračnou agresiou, čo psychológovia nazývajú hnev v dôsledku opúšťania sa.	Rejected lovers can also suffer from frustration-aggression, what psychologists call abandonment rage.”	0.277419
Aj keď odmietnutý partner odchádza so súcitom a rešpektuje záväzky danej osoby v priateľskej alebo partnerskej atmosfére, mnoho opustených ľudí osciluje medzi stavom zlomeného srdca a zúrivosti. Ide o ďalšiu reakciu neurálnych korelátov.	Even when a rejecting partner departs with compassion and graciously honors his or her responsibilities as a friend or co-parent, many abandoned people oscillate between heartbreak and fury—another response with neural correlates.	0.563727
Primárny systém hnevu je úzko prepojený s centrami v prefrontálnej kôre, ktoré anticipujú odmenu.	The primary rage system is closely connected to centers in the prefrontal cortex that anticipate rewards.	0.278824
Keď si človek začne uvedomovať, že očakávaná odmena je v ohrození, dokonca nedosiahnuteľná, oblasti prefrontálnej kôry stimulujú amygdalu a sú spúšťačom hnevu, vlastnosti, ktorá vyvíja tlak na srdce, zvyšuje krvný tlak a oslabuje imunitný systém.	So as a person begins to realize that an expected reward is in jeopardy, even unattainable, these regions of the prefrontal cortex stimulate the amygdala and trigger rage, a trait that stresses the heart, raises blood pressure, and suppresses the immune system.	0.455399
Táto výbušná reakcia z dôvodu nenaplnených očakávaní je známa aj u iných cicavcov.	This rage response to unfulfilled expectations is well known in other mammals.	0.286765
Ak napríklad pohladkáme mačku, pradie.	When a cat is petted, for example, it purrs.	0.282857
Ak ju prestaneme hladkať, môže nás aj uhryznúť.	When this pleasurable stimulation is withdrawn, it sometimes bites.	0.160976
Romantická vášeň a tzv. hnev v dôsledku opúšťania sa majú veľa spoločného.	Indeed, romantic passion and abandonment rage have much in common.	0.268966
Obe spája telesné a duševné vzrušenie. Výsledkom môžu byť obsedantné myšlienky, cieľavedome zameraná pozornosť, motivácia, cielené správanie a obe sú spúšťačom intenzívnych túžob, buď s cieľom nastoliť harmóniu, alebo sa pomstiť milencovi, ktorý ich odmieta.	Both are associated with bodily and mental arousal; both produce obsessive thinking, focused attention, motivation, and goal-directed behaviors; and both cause intense yearning—either for union with or retaliation against the rejecting lover.	0.281604
Pocity romantickej lásky a hnevu môžu pôsobiť súčasne.	Moreover, these feelings of romantic love and rage can act in tandem.	0.23125
Bruce Ellis a Neil Malamuth pri pozorovaní 124 párov, ktoré spolu chodia, zistili, že každý druh informácie vyvolá iné prejavy romantickej lásky a hnevu alebo rozrušenia.	In a study of 124 dating couples, Bruce Ellis and Neil Malamuth reported that romantic love and anger/upset” react to different kinds of information.	2.17512
Intenzita hnevu prípadne rozrušenia môže u milenca kolísať v závislosti od udalostí, ktoré maria ciele milenca, akými sú napríklad nevera partnera, nedostatok emocionálnej odovzdanosti alebo odmietnutie.	The lover’s level of anger/upset oscillates in response to events that undermine the lover’s goals, such as a mate’s infidelity, lack of emotional commitment, or rejection.	0.237162
Pocity romantickej lásky milenca sa menia aj v závislosti od udalostí, ktoré podporujú ciele milenca, ako napríklad viditeľná sociálna podpora partnera počas výletov s príbuznými a priateľmi alebo bezprostredné prejavy lásky a vernosti.	The lover’s feelings of romantic love fluctuate in response to events that advance the lover’s goals, such as a partner’s visible social support during outings with relatives and friends, or a direct declaration of love and fidelity.	0.465865
Romantická láska a hnev alebo rozrušenie môžu prebiehať súčasne, čo môže zvýšiť závislosť na partnerovi aj po odmietnutí.	Thus, romantic love and anger/upset can operate concurrently, adding intensity to one’s rejection addiction.	0.271875
Túto protestnú reakciu sme museli zdediť, pretože vychádza zo základného mechanizmu cicavcov, ktorý sa spustí po porušení akéhokoľvek druhu spoločenskej pripútanosti.	We must have inherited this protest response, for it stems from a basic mammalian mechanism that gets triggered when any kind of social attachment is ruptured.	0.273333
Vezmime si napríklad malé psíča.	Take the puppy.	-0.0214286
Ak by sme ho vzali matke a dali ho do kuchyne, okamžite začne chodiť z miesta na miesto, zúfalo skákať na dvere, štekať a kňučať na znak protestu.	When it is removed from mother and put into the kitchen by itself, it immediately begins to pace, frantically leaping at the door, barking and whining in protest.	0.363448
Izolované malé potkany vydávajú nepretržité vzlyky s vyššou intenzitou ako dokáže vnímať ľudské ucho.	Isolated baby rats emit ceaseless ultrasonic cries; they hardly sleep because their brain arousal is so intense.	0.273034
Dokonca pre vzrušenie v mozgu, ktoré je veľmi intenzívne, nedokážu ani spať.		-0.3
Účelom tohto protestu je zvýšiť ostražitosť a podnietiť opustené stvorenie, aby protestovalo, hľadalo a volalo o pomoc.	The purpose of this protest: to increase alertness and stimulate an abandoned creature to object, search, and call for help.	0.294231
Námietky, odpoveď na stresovú situáciu, frustrácia z príťažlivosti, hnev v dôsledku opúšťania sa, túžba, abstinenčné príznaky, toto všetko zohráva úlohu na celom svete pri zločinoch, ktoré sú motivované vášňou.	Protest, the stress response, frustration-attraction, abandonment rage, craving, withdrawal symptoms: All play a role in the worldwide incidence of crimes of passion.	0.223973
Rovnako ako všetky závislosti, aj romantická láska môže viesť k násiliu.	Like all addictions, romantic love can lead to violence.	0.214286
Avšak nakoniec to opustený milenec vzdá.	Eventually, however, the abandoned lover gives up.	0.225
On alebo ona prestane prenasledovať milovanú osobu, následne sa dostane do druhej typickej fázy romantického odmietnutia - rezignácie alebo zúfalstva.	He or she stops the pursuit of the beloved, ushering in the second general phase of romantic rejection, resignation/despair.	0.229907
Počas tejto fázy odmietnutý človek prepadne pocitom letargie, skleslosti, melanchólie a depresie, čo je známe ako zúfalá reakcia organizmu.	During this stage, the rejected one slips into feelings of lethargy, despondency, melancholy, and depression, known as the despair response.	0.3
Pri pozorovaní 114 mužov a žien, ktorých partner opustil počas posledných ôsmich týždňov sa ukázalo, že 40 percent z nich zažilo tzv. klinicky merateľnú depresiu.	In a study of 114 men and women who had been rejected by a partner within the past eight weeks, 40 percent experienced clinically measurable depression.	2.00499
Niektorí milenci so zlomeným srdcom dokonca zomrú na následky infarktu alebo mŕtvice, ktoré boli výsledkom depresií.	Some broken- hearted lovers even die from heart attacks or strokes caused by their depression.	0.222222
Iní spáchajú aj samovraždu.	Others commit suicide.	0.242857
Odmietnutí milenci pociťujú smútok aj počas protestnej fázy. Keď zmizne všetka nádej, môže sa stupňovať.	Surely most rejected lovers feel this sadness during the protest phase as well, but it’s likely to escalate as all hope vanishes.	0.240659
Toto zúfalstvo je prepojené s niekoľkými mozgovými dráhami.	This despair has been associated with several brain networks.	0.29434
Pravdepodobne sú aktívne aj dopamínové dráhy.	Yet, once again, dopamine circuits are most likely involved.	0.212195
Keď odmietnutý partner dospeje k presvedčeniu, že odmenu nikdy nedostane, bunky produkujúce v systéme odmeny mozgu dopamín, znižujú aktivitu a vyvolávajú letargiu, skleslosť a depresiu.	As the rejected partner comes to believe that the reward will never come, dopamine-producing cells in the reward system of the brain decrease their activity, producing lethargy, despondency, and depression.	0.385755
Krátkodobý stres zvyšuje produkciu dopamínu a norepinefrínu.	Short-term stress escalates the production of dopamine and norepinephrine.	0.234545
Dlhodobý stres potláča aktivitu týchto neurochemikálií a naopak spôsobuje depresiu.	Long-term stress suppresses the activity of these neurochemicals, producing depression instead.	0.256
Mnoho odborníkov definuje závislosť ako patologickú, problematickú poruchu.	Many professionals define addiction as a pathological, problematic disorder.	0.3
Keďže romantická láska je vzhľadom na rôzne okolnosti pozitívnou skúsenosťou, výskumníci nechcú oficiálne klasifikovať romantickú lásku ako závislosť.	And because romantic love is a positive experience under many circumstances, researchers remain largely unwilling to officially categorize romantic love as an addiction.	0.268657
Pokiaľ ide o vzorce správania a mechanizmy v mozgu, závislosť na láske je však rovnako reálna ako ktorákoľvek iná závislosť.	But love addiction is just as real as any other addiction, in terms of its behavior patterns and brain mechanisms.	0.26875
Aj keď romantická láska nie je zdraviu škodlivá, je spojená s intenzívnou túžbou a úzkosťou a dokáže prinútiť milenca uveriť, povedať a urobiť nebezpečné a nevhodné veci.	Even when romantic love isn’t harmful, it is associated with intense craving and anxiety and can impel the lover to believe, say, and do dangerous and inappropriate things.	0.297931
Okrem toho, všetky formy užívania návykových látok vrátane alkoholu, opiátov, kokaínu, amfetamínu, marihuany a tabaku (ako aj závislosť na jedle, hazardných hrách a sexe, ktoré nespadajú do kategórie závislostína návykových látkach) okamžite spustia niekoľko rovnakých systémov odmeňovania, ktoré sú zároveň aktívne pri šťastne zamilovaných mužoch a ženách, ako aj medzi odmietnutými jedincami.	Moreover, all forms of substance abuse, including alcohol, opioids, cocaine, amphetamines, cannabis, and tobacco (as well as the non-substance addictions to food, gambling, and sex) activate several of the same reward pathways that are activated among men and women who are happily in love, as well as those rejected in love.	0.226087
Na rozdiel od všetkých ostatných závislostí, ktoré trápia iba percento populácie, sa určitá forma závislosti na láske vyskytne takmer u každého človeka v určitom okamihu jeho života.	Unlike all other addictions, however, which afflict only a percentage of the population, some form of love addiction is likely to occur to almost every human being at some point during the life course.	0.27707
Najnovšie zistenia tvrdia, že romantická láska by mala byť považovaná za závislosť, aj keď nie je oficiálne zaradená medzi závislosťami.	Modern data suggest that romantic love should be treated as an addiction, regardless of its lack of official diagnostic classification as an addiction.	0.269492
Zviera v človeku sa môže prebudiť pri návale emócií, ktoré striedavo ustupujú a vzplanú na základe telesného rytmu. ~~~ Predkovia to údajne objavili, keď prvýkrát zostúpili z afrických stromov na zem. Postupne našli správny rytmus vzťahu, ktorý bol v súlade s ich prirodzeným rozmnožovacím cyklom. Boli to 3 až 4 roky.	The human animal seems driven by a tide of feelings that ebb and flow to an internal beat, a rhythm that emerged when our ancestors first descended from the trees of Africa and developed a tempo to their relationships that was in synchrony with their natural breeding cycle—three to four years.	0.0648657
Systém mozgu, ktorý produkuje dopamín, vazopresín, oxytocín a iné neurochemikálie pravdepodobne zosúladí tento rytmus, keď sa človek zamiluje. Rytmus sa zmení, keď človek začne cítiť silnú náklonnosť a harmóniu doslova vesmírnych rozmerov. Potom nastane tzv. stav znecitlivenosti alebo preťaženia, ktorý vedie k ľahostajnosti alebo vnútornému nepokoju. Pomaly ničí lásku a vedie k odlúčeniu, utrpeniu, ktoré môže spustiť matku všetkých závislostí, závislosť na partnerovi.	Perhaps the brain’s systems for dopamine, vasopressin, oxytocin, and other neurochemicals orchestrate this rhythm, escalating when you fall in love, changing as you begin to feel deep attachment and cosmic union, then eventually becoming desensitized or overloaded, leading to indifference or restlessness that slowly eats your love and leads to separation—a hardship that can trigger the mother of all addictions, addiction to a mate.	0.316312
Helen Fisherová je biologickou antropologičkou a vedeckou pracovníčkou na Kinseyho inštitúte.	Dr. Helen Fisher is a biological anthropologist and senior research fellow at The Kinsey Institute.	0.792857
Napísala päť medzinárodne uznávaných (a celosvetovonajpredávanejších) kníh o láske a osobnosti. ~~~ V súčasnosti je hlavnou vedeckou poradkyňou agentúry Match.com.	She has written five internationally best-selling books on love and personality and is currently Chief Scientific Advisor to Match.com.	0.00614035
Úryvok z knihy Anatómia lásky: Prirodzená história párenia, manželstva a prečo sme Stray © 2016 Helen Fisherová, vydané vydavateľstvom Z angl. Love Is Like Cocaine preložila DB W. W. Norton 1. februára 2016	Excerpted from the book Anatomy of Love: A Natural History of Mating, Marriage, and Why We Stray © 2016 by Helen Fisher, published by W. W. Norton on Feb. 1, 2016.	0.864459
Pre účely tejto štúdie podstúpilo echo-planárne zobrazovanie 52 osôb, pričom išlo o rodených pravákov (P), rodených ľavákov (Ľ) a osoby, ktoré boli v mladom veku nútené preučiť sa z prirodzene dominantnej ľavej ruky na ruku pravú.	Echo-planar MR imaging was performed in 52 subjects: consistent right- handers (RH), consistent left-handers (LH), and subjects who had been forced at an early age to switch their left-hand preferences toward the right side.	1.23661
Snímanie prebiehalo počas toho, ako participanti vykonávali buď jednoduché pohybové úlohy (ohýbanie ukazováka), alebo komplexné úlohy (postupné vyvíjanie tlaku na palec).	The scanning was performed during simple (flexion/extension of the index finger) and complex (successive finger-thumb opposition) tasks.	0.22562
Participanti vykonávali činnosti preferovanou aj nepreferovanou rukou.	Subjects performed the tasks using both the preferred and non-preferred hand.	0.286154
U pravákov sme zaznamenali všeobecnú prevahu v aktivácii ľavej hemisféry v porovnaní s hemisférou pravou.	In righthanders, there was a general predominance of left-hemisphere activation relative to right hemisphere activation.	0.251087
U ľavákov bol model aktivácie opačný.	In lefthanders this pattern was reversed.	0.263636
U preučených osôb sme takúto objemovú asymetriu nezaznamenali.	The switched subjects showed no such volumetric asymmetry.	0.276923
Zvýšenie náročnosti pohybovej aktivity viedlo k zvýšenej aktivácii stále aktivovaných oblastí a navyše k následnej aktivácii ipsilaterálnej hemisféry k hemisfére kontralaterálnej.	Increasing levels of complexity of motor activity resulted in an increase in the volume of consistently activated areas and the involvement of the ipsilateral in addition to contralateral activations.	0.275625
U pravákov aj ľavákov aktivovali pohyby vykonávané ich preferovanou rukou prevažne kontralaterálnu hemisféru mozgu, zatiaľ čo pohyby nepreferovanej ruky viedli k pomerne vyváženejšej aktivácii oboch hemisfér s väčším zapojením ipsilaterálnych aktivácií.	In both right- and left-handers, movements of the preferred hand activated mainly the contralateral hemisphere, whereas movements of the non-preferred hand resulted in a more balanced pattern of activation in the two hemispheres, indicating greater involvement of the ipsilateral activations.	0.259821
Táto štúdia dokazuje, že u ľavákov aj pravákov je preferovaná ruka z väčšej časti riadená kontralaterálnou hemisférou, zatiaľ čo nepreferovaná ruka je riadená oboma hemisférami.	Overall, this study shows that in both left- and right-handed subjects, the preferred hand is controlled mainly by the hemisphere contralateral to that hand, whereas the non-preferred hand is controlled by both hemispheres.	0.225974
Preučení jednotlivci zdieľajú určité vlastnosti motorickej kontroly s ľavákmi aj pravákmi.	The switched individuals share features of both left-handers and right-handers regarding their motor control architectures.	0.192593
Kľúčové slová: ľaváctvo, motorická kontrola, fMRI (funkčná magnetická rezonancia), plasticita mozgu, funkčná asymetria hemisfér	Key words: left-handedness, motor control, fMRI, brain plasticity, hemispheric asymmetry	0.16875
Preferencia jednej z rúk je najvýraznejším prejavom asymetrie mozgu u človeka.	Hand preference is the most prominent behavioral expression of brain asymmetry in man.	0.273913
Väčšina populácie (približne 90 %) uprednostňuje pri každodenných činnostiach pravú ruku.	The majority (approximately 90%) of the human population is righthanded.	0.225
Aj napriek dlhotrvajúcemu výskumu, ktorý sa zaoberá problémom neurobiologického pôvodu preferencie ruky a tiež presvedčeniu, že bezprostredne súvisí s funkčnou asymetriou mozgu (Grabowská et al. , 1994), neurálne koreláty pri preferencii ruky sú stále predmetom diskusie.	Despite a long history of research on the neurobiological origin of handedness and common believe that it is strongly linked to the brain asymmetry (Grabowska et al. 1994), the neural correlates of hand preferences are still a matter of debate.	0.579179
Pokroky v technikách funkčného neurozobrazovania umožňujú priame meranie kortikálnej reprezentácie pohybov.	The advances in functional neuroimaging techniques have allowed the cortical representation of movements to be measured directly.	0.25102
Štúdie o neuro-zobrazovaní, ktoré sa zameriavali na mozgové koreláty pri preferencii jednej z rúk, pripísali túto behaviorálnu asymetriu funkčnej asymetrii hemisfér v kôrových oblastiach riadiacich motorické funkcie.	The neuroimaging studies that have focused on the brain correlates of hand preference have attributed this behavioral asymmetry to hemispheric lateralization of the cortical areas controlling motor function.	0.283425
Títo autori však majú odlišné názory na špecifické prejavy rozdielov, ktoré sa týkajú preferencie ruky.	There is, however, a lack of consistency in these authors’ opinions as to the specific manifestation of handedness- related differences.	0.206667
Tieto rozdiely sa vyskytli v lokalizácii, objeme či množstve aktivovaných oblastí v oboch hemisférach a tiež v špecifickej prítomnosti ipsilaterálnej aktivácie pri motorickej kontrole preferovanej a nepreferovanej ruky.	Such differences have been found either in the localization, the volumes or the number of activated areas in the two hemispheres or in the specific presence of ipsilateral activation in the motor control of the preferred vs. non-preferred hand.	0.278238
Navyše, model ipsilaterálnej aktivácie sa zdá byť závislý od takých faktorov, ako je napríklad komplexnosť pohybu.	Moreover, this ipsilateral activation pattern seems to be dependent on such features as movement complexity.	0.284211
FMRI štúdia Solodkina a kol. (2001) zistila, že počas sekvenčného pohybu prstom mali ľaváci tendenciu aktivovať asociačné oblasti kôry vo väčšej miere a množstve a preukazovali menšiu lateralizáciu než praváci.	In their fMRI study Solodkin and coauthors (2001) found that, during the performance of a sequential finger movement task, left-handers tended to activate larger volumes in a greater number of association cortices and showed less lateralization than did righthanders.	0.511202
Nasledujúca práca rovnakých autorov odhalila väčšiu aktiváciu v ľavej premotorickej kôrovej oblasti pri používani oboch rúk u pravákov, čo naznačilo všeobecnú dominanciu ľavej hemisféry pri motorických funkciách. U ľavákov sa preukázala aktivácia prevažne v premotorickej kôrovej oblasti kontralaterálnej k práve pohybujúcej sa ruke, čo nenaznačilo takúto asymetriu (Hluštík et al. , 2002).	A subsequent report by the same authors revealed that right-handers had greater activation in the left premotor area for either hand, indicating a general dominance of the left hemisphere in motor function, whereas the left-handed group showed a predominance of activation in the premotor cortex contralateral to the moving hand (either left or right), indicating no such asymmetry (Hlustik et al. 2002).	0.466282
Volkman a kol. (1998) v magnetoencefalografickej štúdii a Dassonville a iní (1997) v fMRI štúdii pomocou podobných porovnaní však dokázali, že použitie preferovanej ruky u pravákov aj ľavákov súviselo s väčšou aktiváciou kontralaterálnej motorickej kôrovej oblasti.	However, similar comparisons performed by Volkman and colleagues (1998) in a magnetoencephalographic study and by Dassonville and others (1997) in an fMRI study revealed that, in both right- and left-handers, the use of the preferred hand was associated with a greater volume of activation in the contralateral motor cortex.	0.807827
Viaceré štúdie sa zamerali výhradne na problematiku ipsilateránej aktivácie, a to na základe zistenia, že u pravákov je ipsilaterálna aktivácia charakteristická pre pohyb nepreferovanej (ľavej) ruky ako protiklad k pohybom ruky preferovanej.	Several papers have specifically focused on the ipsilateral activation issue based on the observation that in right-handers ipsilateral activation is characteristic of non-preferred (left) hand movements as opposed to preferred hand movement.	0.389487
Singh a kol. (1998) zistili, že praváci vykazovali väčšiu aktiváciu v senzomotorickej oblasti ipsilaterálnej hemisféry pri pohyboch nepreferovanej ľavej ruky v porovnaní s aktiváciou ipsilaterálnej hemisféry pri pohyboch preferovanej pravej ruky. ~~~ V prípade ľavákov sa takáto asymetria nevyskytla.	Singh and coauthors (1998) reported that right handers showed greater activation of the ipsilateral hemisphere in the sensorimotor region for non-preferred (left) hand movements compared to ipsilateral hemisphere activation for preferred (right) hand movements; whereas, in left- handers, such asymmetry was not present.	0.0508929
V súlade s týmito zisteniami Gut a kol. (2007) spozorovali u pravákov výhodu ispilaterálnej aktivácie pri pohyboch ľavej ruky v porovnaní s pohybmi pravej ruky.	In line with those findings Gut and coworkers (2007) found in right-handed participants the advantage of ipsilateral activation during the left hand movements compared to the right hand movements.	0.460696
Kawashima a iní (1997) zaznamenali ipsilaterálnu aktiváciu tiež u ľavákov, nie však v motorickej, ale v premotorickej kôrovej oblasti a nie v ľavej, ale v pravej hemisfére.	Ipsilateral activation was also registered in lefthanded individuals by Kawashima and others (1997), but the effects were present in the premotor and not the motor cortex and in the right and not the left hemisphere.	0.333673
Bohužiaľ, tieto údaje nemožno porovnávať s údajmi o pravákoch, keďže počas výskumu nebola prítomná žiadna kontrolná skupina.	Unfortunately, these data could not be contrasted with data from right-handers, as no appropriate control group was involved.	0.3
Ďalšie dve štúdie poukazujú na podobnú motorickú kontrolu u ľavákov aj pravákov: obe skupiny preukázali väčšiu ipsilaterálnu aktiváciu v motorickej kôrovej oblasti ľavej hemisféry v porovnaní s hemisférou pravou.	Two other studies pointed to similarities in the motor control of left- and right- handers: bothgroups had stronger ipsilateral activations in the motor cortex of the left hemisphere compared to the right hemisphere.	0.3
Jediný rozdiel (ktorý zistil Verstynen a kol. , 2005) je, že u ľavákov bola funkčná asymetria hemisfér menej badateľná.	The only difference (revealed by Verstynenand coworkers in 2005) was that, in left-handers, the hemispheric asymmetries were less pronounced.	0.385294
Ak berieme do úvahy typ pohybových činností, ktoré vykonávali osoby zúčastnené na týchto výskumoch, odchýlka získaných výsledkov sa zvyšuje.	The divergence of the obtained results increases if one takes into account the type of motor tasks performed by the subjects in these studies.	0.2925
Nie je celkom jednoznačné, či rozdiely medzi ľavákmi a pravákmi existujú pri motorickej činnosti vo všeobecnosti, alebo či sú prevažne späté s komplexnejšími motorickými úlohami zahŕňajúcimi sekvenčnú zložku.	Specifically, it is not clear whether differences between left- and right-handers apply to motor behavior in general or are predominantly linked to more complex motor tasks involving sequential component in the movements.	0.285165
Solodkin a kol. (2001) a Verstynen a kol. (2005) objavili počas testovania jednoduchých a komplexných pohybov rozdiely súvisiace s preferenciou ruky iba pri komplexných pohyboch. Volkman a kol. (1998) a Klöppel a kol. (2007) však takéto rozdiely spozorovali aj pri relatívne jednoduchých činnostiach.	Using simple and complex movements, Solodkin and coauthors (2001) and Verstynen and colleagues (2005) found handedness-related differences only for complex tasks, however, differences have also been reported for relatively simple tasks (Volkman et al. 1998, Klöppel et al. 2007).	0.653926
Tieto zistenia poukazujú na dôležitosť kontroly komplexnosti úloh v budúcich štúdiách.	These findings points to the importance of controlling for task complexity in future studies.	0.284416
V prípade vynúteného praváctva sú otázky súvisiace s mozgovými korelátmi motorickej kontroly ďalším zaujímavým problémom, ktorý sa týka vlyvu preferencie jednej z rúk na organizáciu motorických funkcií v mozgu.	Questions about the brain correlates of motor control in case of forced right-handedness are another interesting issue concerning the effect of hand-preference on the organization of motor function in the brain.	0.298352
Väčšina ľavákov, obzvlášť staršia generácia, bola k preučeniu z ľavej ruky na pravú prinútená.	Many individuals, especially in older generation, report that they had experienced considerable pressure to switch their hand preference from left toright.	0.102439
Pokusy o preučenie môžu prebiehať takmer bez problémov a viesť u dieťaťa k zmene preferovanej ruky pri vykonávaní rôznych každodenných činností vrátane písania. V opačnom prípade môžu byť sprevádzané rôznymi neželanými ťažkosťami a viesť k preferovaniu opačnej ruky len pri určitých činnostiach.	Switch attempts may proceed either nearly free of problems and lead to a change in the child’s hand preference for a wide range of everyday activities, including writing; or switch attempts may bring much difficulty and result in a switch of preferences for only few activities.	0.412612
Pravdepodobne pôjde o činnosti, ako sú napr. písanie, kreslenie alebo jedenie, teda tie, kvôli ktorým bolo dieťa prinútené začať používať pravú ruku.	These specific activities are likely to include the specific targets of forced right-handednes such as writing, drawing or eating.	0.257522
Ak zvážime všetky tieto fakty, vzniká otázka, či skoré preučenie rodených ľavákov vedie k zmenám v organizácii mozgu, a teda mení sa viac na mozog "pravácky", alebo ostáva naďalej "ľaváckym".	Taken these facts together, the question follows whether early changes of hand preference behaviors due to environmental pressure exerted upon originally left-handed individuals lead to changes in brain organization toward a more right-handed” brain, or do these people still preserve left handed” brain features.	0.198001
Prihliadajúc na mnohé štúdie o plasticite mozgu, ktoré dokazujú, že ľudský mozog je schopný značnej reorganizácie v dôsledku skúseností a senzomotorických cvičení, pravdepodobnejšia je prvá možnosť.	The first possibility seems more plausible in light of many brain plasticity studies showing that the human brain is capable of substantial reorganization due to experience, and sensorimotor training.	0.298266
Druhú možnosť však nemožno vylúčiť, pretože lateralizácia mozgu je silne geneticky podmienená, a teda do veľkej miery závislá od vrodených faktorov.	However, the latter possibility cannot be excluded because the lateralization of brain function seems to be strongly genetically driven and, thus, heavily dependent on innate factors.	0.230233
Je tiež veľmi zaujímavé, či efektívnosť procesu preučenia z ľavej ruky na pravú nejakým spôsobom súvisí s tým, čo sa deje v mozgu.	Whether the effectiveness of a hand-preference conversion process is somehow related to what happens in the brain is also extremely interesting.	0.255963
Môžeme predpokladať, že jednotlivci odolnejší voči pokusom o preučenie, boli v porovnaní s úspešne preučenými jednotlivcami taktiež odolnejší voči reorganizácii mozgu.	It could be predicted that individuals who were more resistant to the alteration of hand preference were also more resistant to reorganization of their brains as compared with the individuals who switched more successfully.	0.212838
Otázkou teda je, či sa zmeny v profile behaviorálnych preferencií odrážajú v modeloch funkčnej organizácie mozgu.	In other words, the question is whether changes in the profile of behavioral preferences are reflected in the brain’s functional organization patterns.	0.379501
Skúmanie preučených ľavákov a následné porovnávanie týchto jednotlivcov s rodenými pravákmi a ľavákmi predstavuje jedinečnú príležitosť, ako získať lepší pohľad dovnútra mechanizmov, ktoré určujú lateralizáciu funkcií a podieľajú sa na plasticite mozgu.	Studying individuals who underwent attempts to switch toward right handedness and comparing them with consistent left- and right-handers presents an unusual opportunity to gain a better insight into the mechanisms that, on the one side, determine the lateralization of function and, on the other side, are involved in brain plasticity.	0.30481
Pri zmene preferencie ruky sa neurálnymi korelátmi zaoberalo niekoľko funkčných a štrukturálnych štúdií založených na neurozobrazovaní.	There are few functional or structural neuroimaging studies that investigated the neural correlates of switching handedness.	0.27
Siebner a iní (2002) v fMRI štúdii skúmali participantov počas písania ich dominantnou rukou, čiže rukou, ktorou bežne píšu.	Siebner and coworkers (2002), performed fMRI study during writing with the dominant hand (i. e. the hand normally used for writing by the tested subjects).	0.529907
U pravákov bola spozorovaná väčšia aktivácia v premotorickej a parietálnej kôre ľavej hemisféry, zatiaľ čo u preučených ľavákov bola aktivácia viac bilaterálna, s určitými aktivačnými ložiskami v pravej hemisfére, predovšetkým v premotorickej, v parietálnej a temporálnej oblasti.	The results showed the predominance of activation in left parietal and premotor regions in right-handers, and more bilateral activation with some activation foci in the right hemisphere (particularly in premotor, parietal and temporal areas) in switched left-handers.	0.28319
Taktiež sa zistilo, že existuje vzťah medzi stupňom dominancie ľavej ruky a cerebrálnym prietokom krvi v týchto oblastiach pravej hemisféry.	Moreover, there was a relationship between the degree of left hand dominance and cerebral blood flow in these right hemisphere regions.	0.42734
Siebner a kol. (2002) v tej istej štúdii skúmali model aktivácie mozgu aj u rodených ľavákov, pričom v tomto prípade bola charakteristická jasná dominancia pravej hemisféry.	In the same research the brain activation pattern was also studied in consistent lefthanders; this pattern was characterized by a clear right hemisphere dominance (Siebner et al. 2002).	0.390977
Autori dospeli k záveru, že u preučených ľavákov je aktivácia v pravej hemisfére výsledkom neúplnej premeny ľaváka na praváka, pričom pravá hemisféra istým spôsobom stále riadi určité motorické funkcie.	The authors concluded that the presence of right-hemisphere activation in converted left- handers is there flection of not complete left-to right shift in handedness and still present motor control exerted by the right hemisphere.	0.260571
Nevýhodou tejto experimentálnej koncepcie bolo, že autori nielenže neboli schopní porovnať aktivitu mozgu počas pohybov vykonávaných dominantnou a nedominantnou rukou (ktoré sú podľa vyššie spomenutých záznamov rozhodujúce pri zisťovaní rozdielov súvisiacich s preferenciou ruky), ale tiež nedokázali priamo porovnať písanie ľaváka a praváka, keďže snímanie bolo v oboch skupinách vykonané pre iné ruky.	The disadvantages of this experimental design were that the authors were neither able to compare brain activity during dominant and nondominant hand movements (which, according to the previously mentioned papers, is critical for detecting hand preference-related differences), nor to make direct comparison between left- and right-hand writers as scanning in the two groups was performed for different hands.	0.3
V novšej štúdii Klöppel a kol. (2007) skúmali pomocou fMRI lokalizáciu aktivity vyvolanej vykonávaním pohybových činností.	In a more recent study Klöppel and colleagues (2007) studied the localization of movement related activity with fMRI while converted left-handers and age-matched groups of consistent left handers and righthanders pressed a button with their right, left or both hands depending on which of three symbolic visual cues was presented.	0.522549
Výskum prebiehal takým spôsobom, že preučení ľaváci a skupiny rodených ľavákov a pravákov rovnakej vekovej kategórie stláčali tlačidlo buď svojou pravou či ľavou rukou, alebo oboma rukami – v závislosti od toho, ktoré z troch symbolických vizuálnych podnetov im bolo práve prezentované.	The authors have found two regions of increased activity in converted left-handers as compared to either consistent left-handers or righthanders: one in sensorimotor and premotor cortex in the left hemisphere and the other in inferior parietal cortex of the right hemisphere.	0.287288
V porovnaní s rodenými ľavákmi a pravákmi autori spozorovali u preučených ľavákov dve oblasti so zvýšenou aktivitou.	The increased activation in the left hemisphere was interpreted as a consequence of educationally induced high daily practice in right hand writing of that originally left- handed group.	0.291419
Prvá v senzomotorickej kôre a premotorickej kôre v ľavej hemisfére a druhá v inferiórnej časti parietálnej kôry pravej hemisféry. ~~~ Zvýšená aktivácia ľavej hemisféry pri skupine preučených ľavákov bola odôvodnená ako dôsledok ťažkého každodenného tréningu písania pravou rukou.	The persisting activity in their right inferior parietal cortex was taken as en evidence that the involvement of higher order associative areas in the originally dominant hemisphere is invariant and cannot be switched to the opposite hemisphere due to educational training.	-0.00512821
Pretrvávajúca aktivita v inferiórnej časti parietálnej kôry pravej hemisféry sa považovala za dôkaz toho, že aktívne zapojenie vyšších asociačných kôrových oblastí v pôvodne dominantnej hemisfére je invariantné, a teda nemožno ho praktickým tréningom "preniesť" na druhú hemisféru.	Importantly enough, this study did not consider the possible relationship between the ipsi- vs. contralateral activations and the handedness factor, neither it directly compared the activations in the two hemispheres elicited by either hand.	0.24689
Dôležité však je, že táto štúdia nebrala do úvahy možnú existenciu vzťahu medzi ipsilaterálnymi a kontralaterálnymi aktiváciami a faktorom preferencie ruky, ani priamo neporovnávala aktivácie v oboch hemisférach vyvolané činnosťou konkrétnej ruky.	Moreover, due to simplicity of the movement (just pressing a button), the task focused more on taking a decision which hand should be used, than on movement execution control itself.	0.370821
Navyše z dôvodu jednoduchosti pohybu (stláčanie tlačidla) sa výskum viac zameral na samotné rozhodovanie o tom, ktorá ruka sa má na vykonanie pohybu použiť, než na samotnú kontrolu vykonania pohybu.		-0.3
To môže vyžadovať zapojenie úplne odlišných nervových obvodov než činnosti skúmané v predchádzajúcich štúdiách, a to poklepávanie prstami či písanie.	And this might require quite different neural circuits than finger tapping or writing used in previous studies.	0.190625
Tento krátky prehľad štúdií dokazuje, že existujúce údaje spájajúce preferenciu ruky s funkčnou architektúrou mozgu zodpovedajúcou za motorické funkcie sú veľmi nekonzistentné.	This short review of the literature demonstrates that the existing data relating the functional brain architecture of motor function to handedness is highly inconsistent.	0.283784
Neschopnosť dosiahnuť v týchto štúdiách relevantné zistenia možno pripísať niekoľkým faktorom, pričom heterogénnosť v skupinách ľavákov, nízky počet participantov a tiež výber rôznorodých pohybových úloh sú najpravdepodobnejšími zdrojmi zmätku.	The failure to obtain consistent findings in these studies can be attributed to several factors, with the heterogeneity of the left-handed groups, the low numbers of participating individuals and the selection of divergent motor tasks being the most likely sources of confusion.	0.270968
V súčasnej štúdii sme použili dva druhy pohybových úloh, jednoduchú a komplexnú, ktoré skúmaní participanti dosiaľ neprecvičovali. ~~~ Tieto úlohy boli najčastejšie použité v predchádzajúcich výskumoch o mozgovej reprezentácii motorických funkcií a môžu byť vykonávané oboma rukami.	In the present study we used two different unpracticed motor tasks, one simple and one complex, that have been most commonly used in previous research on the brain’s representation of motor function and can be performed with either hand.	-0.0345
Toto nám umožnilo nasledovné: 1) spájať naše údaje s už existujúcimi údajmi o riadení motoriky, 2) poskytnúť údaje o dominantnej aj nedominantnej ruke a 3) odhadnúť vplyv náročnosti úlohy na rozdiely súvisiace s preferenciou ruky v modeloch aktivácie.	This enabled us: (1) to relate our data to the existing literature on motor control, (2) to provide data for both preferred and nonpreferred hand, and (3) to estimate the effect of task complexity on handedness-related differences in activation patterns.	0.298605
Porovnávali sme mieru aktivácie ipsilaterálnej a kontralaterálnej hemisféry u rodených a preučených ľavákov s údajmi získanými o rodených pravákoch, ktorí sa podrobili rovnakému výskumu v našej predchádzajúcej štúdii (Gut et al. , 2007).	The volumes of activation in ipsilateral and contralateral hemispheres obtained in left-handers as well as converted left- handers were compared to those obtained in right-handers who were tested in our previous study (Gut et al. 2007) using the same procedure and scanner.	0.525385
V aktuálnej štúdii sa zaoberáme týmito otázkami: 1) aké sú rozdiely v organizácii motorickej kontroly v mozgu medzi ľavákmi a pravákmi, 2) či náročnosť pohybových úloh nejakým spôsobom ovplyvňuje tieto rozdiely, 3) či nútené skoré preučenie vedie k dlhodobým zmenám v organizácii mozgu a 4) či organizácia modelov motorických funkcií v mozgu odráža preferenciu ruky a jej výkon?	The present study addressed the following questions: (1) what are the differences in the organization of motor control in the brain between left-and righthanders, (2) does motor task complexity influence those differences, (3) do early switch of hand preference, due to social pressure, leads to long-lasting changes in brain organization, and (4) does the organization of motor function patterns in the brain reflect handedness preference and performance?	0.235714
Tieto otázky sú zaujímavé nielen z teoretického hľadiska, ale sú tiež prínosom pre klinickú prax.	These issues are interesting not only from theoretical point of view, but they also have clinical value.	0.282143
Získané poznatky o modeloch mozgovej aktivity, ktoré možno rozdeliť do podskupín na základe preferovanej ruky, môžu pomôcť pri rozhodovaní o tom, ktorá ruka by mala byť zvolená na písanie v určitých špecifických prípadoch, kedy preferencia konkrétnej ruky nie je zrejmá. ~~~ Rovnako môžu pomôcť v prípadoch, kedy jednotlivec dlhodobo používal pôvodne nepreferovanú ruku následkom zranenia pôvodne preferovanej ruky.	The knowledge on brain activation patterns in subgroups that differ in hand preference might help to make proper decisions as to which hand should be chosen forwriting in individual cases in which the preference is not obvious and in those who have used the non-preferred hand for a long time after injury of the originally preferred hand.	-0.0336207
Výskumu sa podrobilo 52 zdravých jednotlivcov, z toho 24 mužov a 28 žien vo veku od 17 do 36 rokov, pričom vekový priemer bol 22,1 rokov a štandardná odchýlka 5,3.	Fifty-two healthy subjects (24 males and 28 females) between 17 and 36 years of age (mean = 22.1 years; SD= 5. 3) participated in the study.	0.584195
Všetkých participantov sme informovali o účele štúdie pred poskytnutím ich písomného súhlasu.	All participants were informed about the purpose of the study before giving their written consent.	0.292771
Žiadny z participantov nemal kontraindikácie na vyšetrenia magnetickou rezonanciou.	None of the participants had any contraindications to MRI.	0.152941
Žiadny z participantov nenahlásil žiadne neurologické alebo psychiatrické ochorenia, poruchy učenia, ťažkosti na základnej škole či klaustrofóbiu.	No participants reported neurological or psychiatric illnesses, learning disabilities, failures in elementary school or claustrophobia.	0.277869
Protokol štúdie schválila Etická komisia Jagelovskej univerzity.	The study protocol was approved by the Ethics Committee of Jagiellonian University.	0.228814
Posúdenie preferencie ruky	Handedness assessment	0.242857
Na posúdenie individuálnych profilov preferencie ruky sme merali smer a stupeň preferencie ruky u všetkých participantov.	To assess individual profiles of handedness we measured the direction and degree of hand preference in all subjects.	0.279
Participanti vyplnili 10-bodový Edinburghský dotazník (Oldfield, 1971).	For this purpose subjects completed the 10-point Edinburgh Handedness Inventory (Oldfield 1971).	0.584091
Každému participantovi sme vypočítali Hand Preference Index (HPI – index preferencie ruky) v rozmedzí od +100 pre maximálnych pravákov do -100 pre maximálnych ľavákov.	For each subject, a Handedness Preference Index (HPI) ranging from +100 for extreme righthanders to −100 for extreme left-handers was calculated.	0.663853
Participanti boli rozdelení do štyroch skupín: rodení praváci (P, n=12), rodení ľaváci (Ľ, n=17), úspešne preučení (ÚP, n=11) a neúspešne preučení (NP, n=2).	The participants were divided into four groups: consistent right-handers (RH, n=12), consistent left-handers (LH, n=17), switched successfully (SS, n=11) and switched unsuccessfully (SU, n=2).	0.725
Prvé dve skupiny (Ľ a P) tvorili účastníci, ktorí uviedli stálu preferenciu jednej z rúk počas celého života. ~~~ Ľaváci neuviedli žiadne skoré pokusy o preučenie na pravú ruku.	The former two groups (LH and RH) consisted of subjects who reported consistent left- or right-hand preferences across their lives and no attempts at rightward shifts during childhood.	-0.0090604
Všetci participanti v skupine rodených ľavákov používali na písanie ľavú ruku a ich index preferencie ruky bol menší ako 20 (HPI<20).	All individuals in the group of consistent left-handers used their left hand for writing and had a handedness preference index (HPI)<20.	0.564833
Účastníci v skupine rodených pravákov používali na písanie pravú ruku a ich index preferencie ruky bol naopak väčší ako 20 (HPI>20).	Individuals in the group of consistent right-handers used their right hand for writing and had a HPI>20.	0.385768
Všetci participanti zvyšných dvoch skupín (ÚP a NP) boli v detstve nútení preučiť sa z ľavej ruky na pravú, čo automaticky viedlo k používaniu pravej ruky pri písaní.	The two latter groups (SS and SU) consisted of subjects who had been forced in childhood to switch their original lefthand preferences toward the right side resulting in the use of their right hands for writing.	0.220714
Individuálne rozhovory s takýmito participantmi nám poskytli detailné informácie o procese preučenia.	In all cases interviews provided detailed information about the conversion process.	0.231081
Nepresné prípady sme nebrali do úvahy.	All unclear cases were excluded.	0.248276
Participanti boli do týchto dvoch skupín vybratí na základe ich profilu preferencie ruky.	The selection of subjects for either the SS or the SU group was based on their hand preference profile.	0.269231
Jednotlivci s HPI>20 (ako v skupine P) boli zaradení do skupiny ÚP a jednotlivci s HPI<20 (ako v skupine Ľ) boli zaradení do skupiny NP.	Individuals showing the HPI>20 (as in the RH group) were selected for the SS group, whereas the individuals showing the HPI<20 (as in the LH group) were selected for the SU group.	0.435194
Na základe iných štúdií (Annett, 2002) sme použili HPI hodnotu 20 ako hranicu medzi ľavorukosťou a pravorukosťou. ~~~ Predpokladá sa totiž, že organizácia mozgu u jednotlivcov len s miernou preferenciou pravej ruky je viac podobná organizácii mozgu u ľavákov než pravákov.	Following other studies (Annett 2002), we used the HPI score of 20 as the demarcation line between left- and right-handedness because it is thought that the brain organization of individuals with slight preferences toward the right side resembles that typical for left- handers rather than for right-handers.	0.747449
Ľudia s miernou pravostrannou preferenciou sa preto do istej miery považujú za ľavákov, ktorí svoje správanie prispôsobili požiadavkám "praváckeho" sveta.	Thus, people with slight right preferences are, to some extent, considered to be left-handers who adapted their behavior to the demands of the right-shifted environment.	0.277941
Zobrazovanie mozgu Experimentálna paradigma pozostávala z dvoch experimentálnych cyklov, z ktorých každý obsahoval 10 striedajúcich sa blokov s 3 úlohami: (A) jednoduchá pohybová úloha (flexia/ohýbanie ukazováka), (B) komplexná pohybová úloha (sekvenčné vyvíjanie tlaku palcom na končeky zvyšných prstov v nasledujúcom poradí: 5, 4, 3, 2, 5, 4) oddychový čas, počas ktorého museli účastníci ostať v pokoji.	Brain imaging The experimental paradigm consisted of two experimental runs that each contained 10 alternating blocks of 3 conditions: (A) a simple movement task (flexion/extension of the index finger), (B) a complex movements task (sequential opposition of the thumb to tips of other fingers in the order: 5, 4, 3, 2, 5, 4 and so on), and (C) a rest period (during which the subjects were required to remain still).	0.769361
V rámci každého cyklu sa bloky opakovali v sekvencii CABCABCABC.	Within each run, the blocks were repeated in the sequence CABCABCABC.	0.551299
Celková dĺžka jedného cyklu bola 2 minúty 30 sekúnd, pričom jednotlivé bloky trvali 15 sekúnd.	Each block lasted 15 s for a total 2 min 30 s per run.	2.62143
Participanti vykonávali úlohy v jednotlivých cykloch buď pravou, alebo ľavou rukou.	Within each run the tasks were performed either with the right or the left hand.	0.268657
Poradie používania ľavej a pravej ruky pre jednotlivé cykly sme participantom pridelili náhodne.	The order of left and right hand runs was randomized across subjects.	0.167797
Tempo vykonávania pohybov si participanti zvolili sami, išlo približne o hodnotu 2 Hz.	Movements were self-paced at a rate of approximately 2 Hz, which was comfortable for subjects and easy to control.	2.56914
Táto hodnota im vyhovovala a umožňovala im mať svoje pohyby pod kontrolou.	All subjects practiced the two tasks prior to scanning to ensure similar task execution.	0.24375
Aby sme zaistili približne rovnaké zvládnutie daných úloh, participanti si tieto úlohy precvičili ešte pred samotným snímaním. ~~~ Začiatok každej z úloh bol signalizovaný zobrazením jedného z troch farebne odlíšených štvorcov na zadnej obrazovke viditeľnej vďaka zrkadlovému systému, ktorý bol súčasťou skenera.	The onset of each of the different tasks was signaled by the presentation of one of three differently colored squares presented on a rear-projection screen visible to subjects through a system of mirrors mounted in the scanner.	-0.0311321
Biely štvorec indikoval stav pokoja, červený jednoduchú pohybovú úlohu a modrý komplexnú pohybovú úlohu.	A white square indicated the rest condition, a red square indicated the simple movement condition and a blue square indicated the complex movement condition.	0.359783
Štvorce boli zobrazené počas vykonávania každej z úloh.	The squares remained visible during each condition.	0.280435
Participantov sme pred skenovaním poučili, ako majú reagovať na zobrazenie jednotlivých stimulov.	Before scanning the subjects were instructed how to react to each stimulus type that they would see on the screen.	0.268966
Stimuly boli premietané multimediálnym LCD projektorom na obrazovke umiestnenej približne 3 metre od magnetického prístroja.	Stimuli were back-projected from a multi-media projector on a screen located approximately 3 meters away from the magnet.	2.34536
Na tento výskum bol použitý prístroj MRI typu 1. 5 T Signa Horizon.	The study was performed using a 1.5 T Signa Horizon MR system.	0.738462
Funkčné snímky sme získali použitím rýchlej gradientnej echo-planárnej sekvencie (EPI), citlivej na BOLD kontrast (blood oxygenation level dependent) s nasledujúcimi parametrami: 3000/60 (čas opakovania v ms/ čas echa v ms), 90° rotácia, pozorované pole (FOV – field of view) 18 x 13 cm, veľkosť matice 96 x 64 a počet excitácií rovnajúci sa číslu jeden.	The functional MRI images were acquired using an interleaved gradient-echo echoplanar (EPI) sequence sensitive to the blood oxygenation level dependent (BOLD) contrast with the following parameters: 3 000/60 (repetition time ms/echo time ms), a 90º flip angle, a 18 × 13 cm field ofview (FOV), a 96 × 64 matrix, and the number of excitations equal to one.	0.833708
Rozlíšenie roviny bolo 1,41 x 1,41 mm.	In plane resolution was 1.41 × 1.41mm.	0.3
Počas každého funkčného skenovania sme získali 50 sád po 10 susediacich transverzálnych rezov s hrúbkou 7-10 mm bez medzier.	During each functional scanning session 50 sets of 10 contiguous, 7 to 10-mm-thick oblique sections were acquired, without any gap.	0.583178
V prípade všetkých participantov boli rezy umiestnené rovnobežne s osou spájajúcou commissura anterior a zadný povrch tonsilla cerebelli a rozšírené priamo do stredu zadnej hranice temenného laloka.	For each subject, all sections were set parallel to the axis connecting the anterior commissure and the caudal surface of the cerebellar tonsil and extended right up to the posterior midline boundary of the parietal lobe.	0.382865
Vybraná hrúbka rezu bola upravená podľa mozgového objemu každého zúčastneného.	The selected slice-thickness was adjusted to each subject’s brain volume.	0.276923
Koplanárne, štrukturálne MR snímky s vysokým rozlíšením vykonané pre rovnaké oblasti ako funkčné snímky, boli získané technikou spoiled gradient-echo (SPGR) s nasledujúcimi parametrami: 50/6 (čas opakovania v ms/ čas echa v ms), 60º rotácia, pozorované pole (FOV) 18 x 13 cm, veľkosť matice 256 x 256 a počet excitácií rovnajúci sa číslu dva.	Coplanar, high-resolution structural MRI images were acquired for the same locations as the functional images using a SPoiled GRadient-echo (SPGR) sequence with the following parameters: 50/6 (repetition time ms/echo time ms), a 60º flip angle, a 18 × 13cm FOV, a 256 × 256 matrix, and the number of excitations equal to two.	0.725831
Rozlíšenie roviny bolo 0,86 x 0,86 mm.	In plane resolution was 0.86× 0.86 mm.	0.675
Prihliadajúc na jednotlivých participantov sme získali desať 7-10 mm hrubých transverzálnych rezov bez medzier.	Depending on the subject, ten 7- to 10-mm-thick oblique sections were acquired, without any gap.	0.242169
Naším cieľom bolo vytvoriť čo najväčšie pohodlie, ktoré by participantom uľahčilo minimalizovať pohyb hlavy.	We made every effort to ensure subjects were as comfortable as possible to reduce head motion.	0.24
Participantov sme požiadali, aby sa zdržali akýchkoľvek pohybov, nijakým spôsobom nenaťahovali svoje svaly (výnimkou boli vyžadované motorické cvičenia) a na nič nemysleli, obzvlášť pri ležaní v skeneri.	Subjects were asked to refrain from any movements, not to strain their muscles in any special way (except during the required motor tasks) and not to think about anything in particular while lying in the scanner.	0.3
Na obmedzenie pohybu hlavy sme použili štandardnú hlavovú RF cievku s penovou výplňou.	A standard radio-frequency (RF) head coil with foam padding to restrict head motion was used.	0.28
Pred vykonaním fMRI experimentu participanti trénovali motorické cvičenia.	The fMRI experiment was preceded by training ofthe subjects’ on the motor task.	0.633333
Obzvlášť sme kládli dôraz na to, aby sa participanti naučili bez akéhokoľvek podnetu vykonávať pohyb približne dvakrát za sekundu.	Special attention was given to teaching the subjects to pace their movements at approximately twice a second without any preceding cues.	0.289381
Úlohu preto vykonávali automaticky už pred začiatkom procesu skenovania.	Thus, the task was highly automated before the start of the scanning procedure.	0.286154
Obrazy boli najskôr prevedené na formát programu Analyze použitím internetovej stránky.	The images were first converted to the Analyze format with xmedcon.	0.446552
Na zobrazení vo formáte Analyze bola lebka následne odstránená použitím anizotropnej difúzie a viacúrovňového algoritmu watershed.	The skull was then removed on the anatomical Analyze images with a probabilistic anisotropic diffusion and multi-scale watershed algorithm.	0.637424
Na zhotovenie štatistických analýz sme použili program FSL 3. 1 (FMRIB softvérová knižnica) (Smith et al. , 2004).	Statistical analyses were performed with FSL 3. 1 (FMRIB Software Library)(Smitch et al. 2004).	3.64578
Vo fáze predspracovania sme koregistrovali funkčné snímky k snímkam anatomickým.	In the pre-processing step, the functional images were coregistered to the anatomical image.	0.2625
Za účelom odstránenia nízkofrekvenčných artefaktov sme na funkčné snímky aplikovali vysokofrekvenčný časový filter, pričom sme použili priamu inštaláciu uzávierky nastavenej na 45 s.	To remove low frequency artifacts, a high-pass temporal filter was applied to the functional images by using a straight line fitting with a cutoff at 45 s.	1.72846
Na redukciu šumu sme na funkčných snímkach vykonali Gaussovo priestorové vyhladzovanie s 8 mm FWHM jadrom.	Gaussian spatial smoothing with an FWHM kernel of 8 mm was carried out on the functional images to reduce noise.	2.5876
Ako predbežný krok k analýzam vyššej úrovne sme v štatistickej analýze vypočítali dĺžkové rozdiely medzi podmienkami na úrovni participanta v jeho prirodzenom prostredí.	In the statistical analysis, linear contrasts on between conditions at the subject level were calculated in native subject space as a pre-step to the higher-level analyses.	0.3
Skupinové analýzy na vyššej úrovni sme vykonali takým spôsobom, že sme najprv registrovali rozdielne snímky participanta k referenčnému mozgu v Talairachovom štandardnom priestore (Roland a Zilles, 1994). Potom sme použili FLAME (FMRIB’S Local Analysis of Mixed Effects) na rozdielne snímky k odhadu náhodného efektu medzi participantmi.	Higher level group analyses were performed by first registering the subject-level contrast images to a reference brain in Talairach standard space (Roland andZilles 1994); next FLAME (FMRIB’s Local Analysis of Mixed Effects) was used on the contrast images to estimate the inter-subject random-effects.	0.808673
Odchýlku medzi účastníkmi jednotlivých skupín sme zisťovali jednotlivo.	Each group’scross-subject variance was estimated separately.	0.251786
Aby sme získali rozvetvenia, štatistické Z-obrazy zo skupinovej analýzy sme prahovali pri hodnote z=3.3.	The statistical Z-images from the group analysis were thresholded at z=3.3 to obtain clusters.	0.263415
Za dôležité sme považovali všetky zhluky s hodnotou P≤005.	All clusters with a P≤0.05 were considered significant.	0.287755
Posledným krokom bolo vypočítanie priesečníkov medzi dôležitými zhlukmi a cytoarchitektonicky definovanými oblasťami.	As a final step, the intersection volumes between significant clusters and cytoarchitectonically defined regions were calculated.	0.508339
Predchádzajúce štúdie naznačujú, že lokalizácia konkrétnych oblastí mozgu spojených s motorickou funkciou sa môže u pozorovaných jednotlivcov líšiť. ~~~ Tiež naznačujú, že tieto mozgové oblasti nemusia byť rovnako veľké v ľavej aj pravej hemisfére, a to najmä vtedy, keď sa výskumná vzorka líši profilom preferencie ruky.	Previous reports suggest that the localization of particular brain areas associated with motor function may vary across subjects and that the particular regions need not to be the same size in the left and right hemispheres, especially when the sample varies in handedness profile.	-0.0232218
Vzhľadom na túto odchýlku sme sa rozhodli hodnotiť predovšetkým všeobecné postavenie ľavej alebo pravej hemisféry v motorickej kontrole tým, že sme vypočítali celkový objem aktivovaných oblastí v ľavej/pravej – kontralaterálnej/ipsilaterálnej hemisfére.	Taking this variation into consideration, we decided rather to assess the general roles of left or right hemisphere in motor control by calculating the total volume of the activated areas in the left/right – contralateral/ipsilateral hemispheres.	0.376769
Našou stratégiou teda bolo kvantifikovať hemisferické asymetrie v priestorovom rozsahu reprezentácie ruky, a to výpočtom objemu všetkých dôležitých aktivovaných voxelov v každej hemisfére.	Thus, our strategy was to quantify hemispheric asymmetries in the spatial extent of hand representation by computing the volume of all significantly activated voxels in either hemisphere.	0.415741
Tieto analýzy sme vykonávali v prirodzenom prostredí pre participanta.	These analyses were run in native subject space.	0.15
VÝSLEDKY	RESULTS	0.2625
Behaviorálne údaje	Behavioral data Mean	0.283333
Pre každú skupinu participantov sme vypočítali priemerný index preferencie ruky (HPI), ktorý je uvedený v tabuľke 1. ~~~ Participanti v skupine rodených pravákov (RH) a úspešne preučených ľavákov (SS) dosiahli jasné pozitívne hodnoty HPI, čo naznačuje preferenciu pravej ruky pri rôznych druhoch aktivít.	Handedness Preference Index (HPI) was calculated for each group of subjects and the mean index of handedness are presented in Table I. Noticeably, both the consistent right-handed (RH) and the successfully switched (SS) groups had clearly positive HPI values indicating right-hand preferences in a large range of activities.	0.074173
Nižšie hodnoty HPI v skupine SS v porovnaní so skupinou RH ukazujú, že preučenie nebolo celkom dokončené, pričom pretrvávali niektoré skryté znaky ľavorukosti.	Lower values of the index in the SS compared to the RH group indicate that the hand preference alteration was not complete, and some features of covert left- handedness persisted.	0.521739
V skupine rodených ľavákov (Ľ) a neúspešne preučených ľavákov (NP) bolo priemerné HPI negatívne, čo značí preferenciu ľavej ruky pri väčšine činností a tiež neúspešné preučenie v skupine NP.	In both consistent left handed (LH) and unsuccessfully switched (SU) groups, the mean HPIs were negative, indicating the predominance of left-hand preferences for the majority of activities and thus an unsuccessful handedness switch in the SU group.	0.206135
Zobrazovanie údajov	Imaging data	0.125
Lokalizácia aktivácie	Localization of activation	0.242857
Snímky funkčnej magnetickej rezonancie ukázali niekoľko oblastí, ktoré boli aktivované po celú dobu vykonávania pohybu rukami.	The fMRI scans revealed a number of areas that were consistently activated during hand movements used in the study.	0.257143
Na obrázku 1 môžeme vidieť lokalizáciu významných aktivácii pre jednoduché a komplexné pohyby vykonávané pravou alebo ľavou rukou vo všetkých štyroch skupinách výskumnej vzorky.	Figure 1 illustrates the localization of significant activations in the four groups of subjects for simple and complex movements performed with the right or left hand.	1.59483
Významné skupinové aktivácie pri vykonávaní jednoduchých pohybov sme detegovali v gyrus precentralis, gyrus postcentralis, gyrus supramarginalis, gyrus parietalis superior a gyrus parietalis inferior, všetky výlučne v hemisfére kontralaterálnej k pohybujúcej sa ruke.	Significant group activations during simple movements were found in: precentral, postcentral, parietal superior, parietal inferior and supramarginal gyri, all exclusive to the hemisphere contralateral to the moving hand.	0.233505
Pri komplexných pohyboch vykonávaných buď pravou alebo ľavou rukou pokrývali aktivácie oveľa širšie oblasti zahŕňajúc mozgovú kôru (gyrus precentralis, gyrus postcentralis, doplnková motorická oblasť, insula, cingulum, parientálny lalok, gyrus supramarginalis, gyrus temporalis superior a gyrus temporalis medius), subkortikálne oblasti (putamen, pallidum, thalamus), v kontralaterálnych a ipsilaterálnych hemisférach.	For complex movements, activation covered much broader areas including the cerebral cortex (precentral gyrus, postcentral gyrus, supplementary motor area, insula, cingulum, parietal lobuli, supramarginal, superior and medial temporal gyri), subcortical areas (putamen, pallidum, the thalamus) in both the contralateral and ipsilateral hemispheres for either hand.	0.576399
Okrem toho boli zaznamenané aj mozočkové aktivácie, najmä ipsilaterálne.	In addition, cerebellar activations (mainly ipsilateral) were registered.	0.290769
Objem hemisferických aktivácií v súvislosti s preferenciou ruky a komplexnosťou cvičení	Volumes of hemispheric activation in relation to handedness and task complexity	0.265714
Cieľom štúdie bolo určiť, či motorické dráhy ipsilaterálnej a kontralaterálnej hemisféry zodpovedné za riadenie pohybu jednotlivých rúk boli asymetricky aktivované, a či tento jav závisel od preferencie ruky a komplexnosti cvičení. ~~~ Údaje sme preto podrobili analýze rozptylu, v ktorej jednotlivé skupiny participantov (P, Ľ, NP a ÚP), úroveň pohybu (jednoduchý/komplexný), hemisféra (ipsilaterálna/ kontralaterálna) a ruka (ľavá/pravá) predstavovali hlavné faktory a množstvo aktivácií závislú premennú.	Because the aim of the study was to determine whether the motor networks responsible for controlling left and right hand movements in the ipsilateraland contralateral hemispheres were asymmetrically activated and whether this effect depended on the hand preference and complexity of the task, the data were subjected to analysis of variance (ANOVA) that used group (RH, LH, SU and SS), movement complexity (simple/complex), hemisphere (ipsilateral/contralateral) and hand (left/right) as the main factors and the volume of activation as the dependent variable.	-0.0128668
Analýza odhalila hlavné významné vplyvy komplexnosti pohybu (F1, 48=116.59; P<0. 01) a hemisféry (F1, 48=101.54; P<0. 01).	This analysis revealed significant main effects of movement complexity (F1, 48=116.59; P<0.01)and hemisphere (F1, 48=101.54; P<0.01).	0.972237
Výsledok t-testov ukázal väčšiu aktiváciu počas vykonávania komplexného pohybu než počas vykonávania jednoduchého pohybu (t51=11.2; P<0. 01) a väčšiu aktiváciu v kontralaterálnej hemisfére v porovnaní s hemisférou ipsilaterálnou (t51=10.08; P<0. 01).	The result of t-tests indicated a larger volume of activation during complex than simple movement task (t51=11. 2; P<0. 01) and a larger volume of activation in the contralateral, compared to the ipsilateral hemisphere (t51=10. 08;P<0. 01).	0.651585
Okrem toho analýza odhalila tri dôležité interakcie: komplexnosť pohybu × hemisféra (F1, 48=12.42; P<0. 01), ruka × hemisféra × skupina (F3, 48=4.1; P<0. 01) a komplexnosť pohybu × hemisféra × skupina × ruka (F3, 48=5. 06; P<0. 01).	Moreover, the analysis revealed three significant interactions: movement complexity × hemisphere (F1, 48=12. 42; P<0. 01), hand × hemisphere × group (F3, 48=4. 61; P<0. 01) and movement complexity × hemisphere × group × hand (F3, 48=5. 06; P<0. 01).	1.58473
Na preskúmanie týchto interakcií sme vykonali dve samostatné analýzy rozptylu, oddelene pre jednoduché a komplexné pohybové úlohy, pričom hlavnými faktormi boli hemisféra (ipsilaterálna/kontralaterálna), daná skupina participantov (P/Ľ/ÚP/NP) a ruka vykonávajúca pohyb (ľavá/pravá).	To investigate these interactions, two analyses of variance, separately for simple and complex tasks, using hemisphere (ipsilateral/contralateral), group (RH/LH/SS/US) and moving hand (left/right) as the main factors were conducted.	0.23122
Analýza jednoduchých pohybových úloh ukázala významné pôsobenie hemisféry (F1, 48=86.23; P<0. 01), pričom sme zaznamenali väčšiu aktiváciu v kontralaterálnej hemisfére v porovnaní s ipsilaterálnou hemisférou.	Analysis of the simple movement task data revealed a significant effect of hemisphere (F1, 48=86.23; P<0. 01), indicating larger activation in the contralateral, compared to the ipsilateral, hemisphere.	0.746198
Žiadne iné faktory alebo interakcie nedosiahli podobný význam.	No other factors or interactions reached significance.	0.257143
Rovnaká analýza, ktorú sme vykonali pre komplexné pohybové úlohy, ukázala podstatné pôsobenie hemisféry (F1, 48 =74.94; P<0. 01, s väčšími kontralaterálnymi aktiváciami) a významné interakcie v prípade skupina x ruka x hemisféra (F3, 48 =6. 34; P<0. 01).	The same analysis performed for complex task showed a significant main effects of hemisphere (F1, 48 =74.94; P<0.01, with larger contralateral activations) and a significant interaction of group × hand × hemisphere(F3, 48 =6. 34; P<0. 01).	1.77941
Ako ukazuje obrázok 2, v skupine RH sme počas vykonávania komplexnej pohybovej úlohy zaznamenali väčšie kontralaterálne aktivácie vyvolané pohybmi pravej (preferovanej) ruky než pohybmi ľavej (nepreferovanej) ruky (t11=2, 24, P<0, 05), zatiaľ čo väčšie ipsilaterálne aktivácie boli vyvolané pohybmi ľavej (nepreferovanej) ruky v porovnaní s pravou (preferovanou) rukou (t11=2, 87; P<0, 05). ~~~ Oba prípady viedli k väčšej celkovej aktivácii ľavej hemisféry.	As illustratedin Figure 2, during the complex movement task in the RH group, larger contralateral activations were elicited by right (preferred) hand movements than left (non- preferred) hand movements (t11=2. 24; P<0. 05), whereas larger ipsilateral activations were elicited by left (non-preferred) hand movements than the right hand movements (t11=2. 87; P<0. 05), both leading to greater total activation in the left hemisphere.	0.0995311
Opačný model aktivácie sa objavil v skupine Ľ, kedy väčšie kontralaterálne aktivácie boli vyvolané pohybmi ľavej (preferovanej) ruky a väčšie ipsilaterálne aktivácie pohybmi pravej (nepreferovanej) ruky. Oba prípady viedli k väčšej celkovej aktivácii pravej hemisféry aj napriek tomu, že rozdiely medzi rukami neboli podstatné pre objem aktivácií kontralaterálnej alebo ipsilaterálnej hemisféry.	The reverse pattern of activation emerged in the LH group: larger contralateral activations were elicited by the left (preferred) hand, and larger ipsilateral activations were elicited by the right (non- preferred) hand (both leading to larger total activation in the right hemisphere, however the differences between hands were not significant for contralateral or ipsilateral activation volumes).	0.298256
V skupinách s preučenými ľavákmi (ÚP a NP) bol model ipsilaterálnych aktivácií podobný tomu v skupine P a Ľ, pričom kontralaterálne aktivácie oboch rúk sa navzájom nelíšili.	In the two switched (SS and SU) groups the pattern of ipsilateral activations resembled those found in the RH and LH groups, respectively; whereas the contralateral activations for either hand did not differ from each other.	0.214865
Na analýzu možného vzťahu medzi modelom aktivácie mozgu a modelom lateralizovaného správania sme celkové objemy aktivácie v oboch hemisférach korelovali s indexom HPI, ktorý sme zhotovili na základe Oldfieldovho Edinburghského dotazníka.	To analyze a possible relationship between brain activation patterns and behavioral lateralization patterns, total volumes of activation in each hemisphere were correlated with HPI index (assessed by the Oldfield Inventory).	0.378407
Pearsonov korelačný koeficient ukázal v prípade celej výskumnej vzorky (počiatočné údaje o všetkých jednotlivcoch z každej skupiny) významnú pozitívnu koreláciu (r=0, 31, P<0, 05) medzi indexom HPI a celkovým množstvom aktivácií v ľavej hemisfére.	Pearson correlation procedures for the entire sample of subjects (raw data from individual subjects from all four groups) revealed a significant positive correlation (r=0.31, P<0. 05) between the HPI and the total amount of activation in the left hemisphere.	0.548771
Pri pravej hemisfére sme takúto spojitosť nespozorovali.	No such relationship was found for the right hemisphere.	0.287755
Vyššie hodnoty HPI (t. j. silnejšia preferencia pravej ruky) sme asiciovali s väčšou aktiváciou v ľavej hemisfére.	Higher HPIs (i. e. stronger right hand preference) were associated with larger volume of activation in the left hemisphere.	0.278788
Analýzy, ktoré sme vykonali samostatne pre jednoduché a komplexné pohybové úlohy ukázali, že takáto korelácia bola príznačná len pre komplexné pohybové úlohy (r=0, 34, P<0, 05).	Separate analyses for the simple and complex movements revealed that this correlation was only significant for complex movements(r=0. 34, P<0. 05).	0.514134
DISKUSIA	DISCUSSION	0.233333
Táto štúdia skúmala objem aktivácií v ľavej a pravej hemisfére počas rukami vykonávaných pohybov v prípade pravákov, ľavákov a preučených jednotlivcov, ktorí boli v detstve nútení k preučeniu sa z ľavej ruky na pravú.	This study examined the volume of left and right hemisphere activations during hand movements in right-handers, left-handers and originally left-handed individuals who, during their childhood, received pressure to switch hand preference toward the right side.	0.233514
Naším cieľom bolo objasniť otázky súvisiace s mechanizmami mozgu zodpovednými za preferenciu konkrétnej ruky, no predovšetkým skúmať, ako dokáže zmena preferencie ruky ovplyvniť organizáciu motorickej kontroly v mozgu.	Our goal was to clarify issues related to the brain mechanisms of hand preference and, specifically, to investigate the effect of switching hand preferences on the organization of motor control in the brain.	0.272727
Na rozdiel od predchádzajúcich štúdií sme počas toho, ako výskumná vzorka vykonávala manuálne úlohy, kontrolovali potenciálne vplyvy niekoľkých faktorov, o ktorých sa predpokladá, že zohrávajú určitú úlohu v modeli mozgových aktivácií. ~~~ Išlo o tieto faktory: typ pohybu (jednoduchý vs. komplexný), ruka vykonávajúca pohyb (preferovaná vs. nepreferovaná) a aktivovaná hemisféra (ipsilaterálna vs. kontralaterálna).	In contrast to previous studies, we controlled for the potential influences of several factors that are suspected to play a role in the brain activation pattern while subjects perform manual tasks: type of movement (simple vs. complex), hand performing the movement (preferred vs. non-preferred) and the activated hemisphere (ipsilateral vs. contralateral).	0.12846
Najzrejmejším zistením našej štúdie bolo, že nezávisle od toho, ktorá ruka vykonávala ktorú úlohu, aktivácie v kontralaterálnej hemisfére boli vždy väčšie než aktivácie v ipsilaterálnej hemisfére, a to vo všetkých skupinách výskumnej vzorky.	The most obvious finding of our study was that, for both hands and tasks, the contralateral activations were larger than the ipsilateral activations in all groups.	0.146763
Toto zistenie je v súlade s niekoľkými predchádzajúcimi štúdiami a mohlo by tiež súvisieť so skutočnosťou, že väčšina motorických vlákien sa kríži vnútri pyramídovej dráhy.	This concords with several previous studies and could be related to the fact that most ofthe motor fibers cross within the pyramidal tract.	0.221186
Čo sa týka hlavnej otázky vplyvu preferencie ruky na funkčnú asymetriu hemisfér naša štúdia dokázala, že pohyby vykonávané preferovanou rukou u pravákov aj ľavákov vyvolali väčšie kontralaterálne aktivácie než pohyby vykonávané nepreferovanou rukou.	Regarding the main question of the effect of hand preference on hemispheric asymmetry, our study revealed that both in left-handers and right-handers, movements of the preferred hand (right in RH and left in LH) produced larger contralateral activations than movements of the non-preferred hand.	0.251835
Pohyby nepreferovanej ruky viedli naopak k väčším ipsilaterálnym aktiváciám.	In contrast to this, movement of the non-preferred hand, led to larger ipsilateral activations.	0.23913
U pravákov sme zaznamenali všeobecnú prevahu aktivácie ľavej hemisféry, zatiaľ čo u ľavákov prevažovala aktivácia pravej hemisféry. V druhom prípade však bola táto asymetria menšia.	Consequently, in right-handers there was a general predominance of left-hemisphere activation, whereas in left-handers there was a predominance of right-hemisphere activation; although in the latter case, the asymmetry was smaller.	0.214557
Treba však spomenúť, že tieto javy boli príznačné skôr pre komplexné pohybové úlohy, pretože počas vykonávania jednoduchých pohybov aktivácie vyvolané pohybom jednotlivých rúk boli podobné.	Notably, these effects were specific to complex rather than simple tasks (during simple tasks the activations elicited by either hand were similar).	0.210938
To sa zhoduje s predchádzajúcimi pozorovaniami Solodkina a kol. (2001) a Verstynena a iných (2005), ktorí obajavili rozdiely súvisiace s preferenciou ruky tiež len pri komplexných pohybových úlohách.	This concords with the previous observations by Solodkin and coauthors (2001) and Verstynen and others (2005) who also found handedness-related differences onlyfor complex tasks.	0.387308
Zistenie Klöppela a kol. (2007), že kortikálna senzomotorická reprezentácia môže závisieť od preferencie ruky pri jednoduchých pohyboch, ako je stláčanie tlačidla, by mohlo byť asociované s experimentálnym postupom, ktorý sa výrazne líšil od postupu použitého v iných štúdiách.	Finding by Klöppel and colleagues (2007) that the cortical sensorimotor representation may depend on hand preference in simple bar pressing movements could be associated with the experimental procedure which differed considerably from that usedin other studies.	0.362579
Pri paradigme voľby reakčného času sme od participantov očakávali reakciu buď ich ľavej, či pravej ruky, alebo oboch rúk v závislosti od toho, ktorý z troch možných vizuálnych podnetov sa zobrazí.	In this choice reaction time paradigm the subjects were expected to react with their left, right, or both hands depending on a presentation of one of three possible visual cues.	0.263758
Kvôli ťažkostiam s odlíšením ľavej a pravej strany môže byť táto úloha obzvlášť náročná pre ľavákov.	This task might present special difficulty for the left-handers due to their problems with discrimination between the left and right directions.	0.163953
Preto je pravdepodobné, že výsledky, ktoré získali Klöppel a kol. (2007) súvisia skôr s rozhodovaním týkajúcim sa výberu ruky, než s monitorovaním vykonania automatického pohybu – stlačenie tlačidla.	It seems plausible therefore, that the results obtained by Klöppel and coauthors (2007) are related to decisions regarding the hand choice rather than to monitoring the execution of an automatically performed bar pressing.	0.475683
Zistenie, že v prípade skupiny pravákov aj ľavákov došlo pri vykonávaní pohybov preferovanou rukou k väčšej kontralaterálnej aktivácii a pri vykonávaní pohybov nepreferovanou rukou k väčšej ipsilaterálnej aktivácii, poukazuje na existenciu spoločného mechanizmu pre motorickú kontrolu.	The finding that, in both the RH and LH groups, movements of the preferred hand lead to greater contralateral activation and movements of the non-preferred hand lead to greater ipsilateral activation implicates the existence of a common mechanism for motor control.	0.347895
To môže spočívať v tom, že dominantná hemisféra riadi motorické funkcie nielen kontralaterálnej, preferovanej ruky, ale tiež ipsilaterálnej, nepreferovanej ruky.	It may consist in exerting the motor control by the dominant hemisphere not only over the contralateral (preferred) hand but also over the ipsilateral (nonpreferred) hand.	0.291608
Nedominantná hemisféra je naopak zapojená najmä do motorickej kontroly kontralaterálnej, nepreferovanej ruky.	In contrast, the non-dominant hemisphere is involved mainly in the motor control of the contralateral (non-preferred) hand.	0.272727
Inak povedané, preferovanú ruku podľa všetkého riadi najmä dominantná hemisféra, zatiaľ čo na riadení nepreferovanej ruky sa podieľajú obe hemisféry, čo tiež dokázal Baraldi a iní (1999).	In other words the preferred hand seems to be controlled mainly by the dominant hemisphere, while the non-preferred hand is controlled by both the dominant and non-dominant hemispheres as has already been suggested by Baraldi and others (1999).	0.429101
Zo záveru vyplýva, že ľavá hemisféra zohráva u pravákov dominantnú úlohu v motorických funkciách. ~~~ Toto tvrdenie je v súlade s klinickými dôkazmi, podľa ktorých je apraxia končatín častejšia skôr pri poškodení ľavej ako pravej hemisféry, pričom negatívne ovplyvňuje motorické zručnosti dokonca aj vtedy, keď pacienti začnú používať ľavú, ipsilaterálnu ruku.	The conclusion that in the right-handers the left hemisphere plays a dominant role in motor control is consistent with clinical evidence demonstrating that limb apraxia is more common after left hemisphere damage than after right hemisphere damage and disrupts motor skills even when the left, ipsilesional hand is used by the patients.	-0.000977317
Záver tiež zodpovedá anatomickým údajom preukazujúcim štrukturálne asymetrie v sulcus centralis (väčšie plochy dorzolaterálnej motorickej kôry v dominantnej hemisfére) u pravákov aj ľavákov.	This conclusion also conforms the anatomical data showing structural asymmetries in the central sulcus (larger surfaces of dorsolateral motor cortex in the dominant hemisphere) in right-handers and left-handers.	0.396598
Nedávna klinická štúdia (Rinehart et al. , 2009) zaoberajúca sa pravákmi, ktorí utrpeli jednostrannú paretickú mozgovú príhodu, priniesla ďalšie poznatky presne zodpovedajúce našim zisteniam.	Interestingly, recent clinical study on right-handed patients with unilateral paretic stroke (Rinehart et al. 2009) provided further observation, which perfectly matches our findings.	0.787037
V tejto štúdii sa autori snažili použitím zápästných akcelerometrov posúdiť relatívnu mieru využívania samostatne pravej a ľavej ruky a tiež oboch rúk naraz.	In this study the authors assessed the relative use of the right, left and both arms with wrist accelerometers.	0.165957
Štúdia preukázala, že používanie ipsilaterálnej, ale nie kontralaterálnej končatiny, po utrpení jednostrannej mozgovej príhody bolo ovplyvnené pôvodnou preferenciou ruky: pacienti s poškodenou pravou hemisférou používali ich ipsilaterálnu, a teda preferovanú pravú končatinu viac ako zdraví praváci a viac ako pacienti s poškodenou ľavou hemisférou používali ich ipsilaterálnu, a teda nepreferovanú ľavú končatinu.	The study demonstrated that the use of the ipsilateral but not contralateral limb after unilateral stroke was influenced by hand preference: the right hemisphere damaged patients used their ipsilateral, right (preferred) limb more than the left-hemisphere damaged patients used their ipsilateral, left(non-preferred) limb and more than healthy righthanders.	0.248875
Inak povedané, pri poškodení ľavej hemisféry boli motorické schopnosti ľavej ruky narušené viac ako motorické schopnosti pravej ruky pri poškodení pravej hemisféry.	In other words the damage to the left hemisphere impaired the motor abilities of the left hand more than the damage to the right hemisphere impaired the motor abilities of the right hand.	0.275
To by mohlo naznačovať, že u pravákov je účasť ľavej, dominantnej hemisféry na riadení motoriky ipsilaterálnej, ľavej ruky väčšia, ako je účasť pravej hemisféry na riadení motoriky ipsilaterálnej, pravej ruky.	This might suggest that in right-handers the involvement of the left (dominant) hemisphere in ipsilateral (left hand) motor control is greater than the involvement of the right hemisphere in the ipsilateral (right hand) motor control.	0.266851
Toto potvrdzuje naše zistenie, že ľavá hemisféra sa v prípade pravákov podieľa na riadení motoriky kontralaterálnej aj ipsilaterálnej ruky.	This nicely concords our findings which showed the involvement of the left hemisphere in both the contralateral and ipsilateral motor control in right-handers.	0.260656
Tieto zistenia sa tiež zhodujú s našim záverom, že u pravákov sa pravá hemisféra podieľa najmä na riadení motoriky kontralaterálnej, ľavej ruky. Poškodenie tejto hemisféry tak nemá nepriaznivý vplyv na motoriku pravej ruky ako v prípade poškodenia ľavej hemisféry, ktoré má nepriaznivý vplyv na motoriku ľavej ruky.	Those findings also agree to our conclusion that the right hemisphere in right-handers is mainly involved inthe contralateral (left hand) control and thus, damage to this hemisphere does not have so much negative impact on the use of the right hand as does the damage to the left hemisphere on the use of the left hand.	0.29434
Tieto údaje tiež zodpovedajú všeobecnému záveru o tom, že ľavá hemisféra zohráva dominantnú úlohu v riadení motoriky pravákov.	Those data also conform the general conclusion regarding the dominance of the left hemisphere in motor control in right-handers.	0.297273
Aký význam by mohol mať relatívne väčší objem aktivácií v hemisfére kontralaterálnej k preferovanej ruke?	What could be the functional significance of relatively greater volume of activation in the hemisphere contralateral to the preferred hand?	0.205435
Je rozumné predpokladať, že zväčšenie objemu nervového tkaniva podieľajúceho sa na motorickom správaní by mohlo dopomôcť k jeho správnej realizácii.	It is reasonable to assume that an increase in the volume of neural tissue engaged in a motor behavior may support the correct execution of that behavior.	0.297674
Rozšírenie motorickej kôry zodpovedajúcej za motoriku ruky v hemisfére kontralaterálnej k preferovanej ruke môže poskytnúť neurálny substrát na vykonávanie komplexných motorických činností touto rukou.	The expansion of hand motor cortex in the hemisphere contralateral to the dominant hand may thus provide the neural substrate for the more efficient execution of the complex motor activities performed by this hand.	0.294972
Vysoká zdatnosť v riadení motoriky hemisférou kontralaterálnou k preferovanej ruke môže byť potom využitá pri vykonávaní pohybových činností nielen preferovanou rukou, ale tiež nepreferovanou.	The high proficiency in motor control of the hemisphere contralateral to the preferred hand may then be utilized during the execution of motor tasks not only by the preferred hand but also by the non-preferred one.	0.282353
Nájdenie väčších objemov aktivácie v hemisfére kontralaterálnej k preferovanej ruke u pravákov aj ľavákov je tiež v súlade s niekoľkými ďalšími štúdiami využívajúcimi funkčné zobrazovacie metódy pri skúmaní mozgu pravákov a ľavákov.	The finding of higher volumes of activation in the hemisphere contralateral to the preferred hand in both right- and left-handers agrees with a few other functional imaging studies of right- and left-handers.	0.35046
V tejto štúdii sme tiež skúmali organizáciu mozgu participantov, ktorí boli pôvodne ľaváci, no v siedmom roku života boli nútení k preučeniu z ľavej ruky na pravú.	In the present study we also investigated the brain organization patterns of subjects who were originally left-handed, but at the age of 7, were switched to righthandedness.	0.278261
Výsledky ukázali, že títo participanti mali spoločné vlastnosti s ľavákmi aj pravákmi.	The results showed that switched participants shared features of both left-handers and righthanders.	0.248684
Môžeme preto predpokladať, že mozgy pôvodných ľavákov prešli plastickými zmenami, ktoré spočívali v reorganizácii ich motorických funkcií podľa vzoru mozgu praváka.	Therefore, it could be speculated that the brains of the originally left-handed subjects underwent plastic changes that consisted in reorganization of their motor function toward the right-handed” brain.	0.233793
Táto reorganizácia však nebola stopercentná, keďže mozog stále preukazoval určité pôvodné znaky mozgu ľaváka.	This reorganization, however, was not complete and showed persisting features of the left-handed” brain.	0.283696
Zaujímavé je, že existuje zhoda medzi mierou predpokladanej reorganizácie mozgu a mierou, do akej jednotlivci zmenili preferenciu na pravú ruku.	Interestingly, there was a correspondence between the amount of supposed brain reorganization and the degree to which the individuals changed their hand preferences toward the right side.	0.357143
Aj keď rozdiely v aktivácii mozgu v prípade oboch skupín preučených participantov (NP a ÚP) neboli štatisticky významné, je potrebné poznamenať, že modely aktivácie ich mozgov odrážali rozdiely spozorované na úrovni správania: skupina ÚP bola podobnejšia skupine P, zatiaľ čo skupina NP viac pripomínala skupinu Ľ (minimálne vtedy, keď sme brali do úvahy model ipsilaterálnych aktivácií).	Although the differences in brain activation in the two switched (SU and SS) groups were not statistically significant, it is worth noting that the activation patterns of their brains reflected the differences observed at the behavioral level: the SS group was more similar to the RH group, while the SU group resembled the LH group (at least when the pattern of ipsilateral activations was considered).	0.294611
V oboch skupinách preučených ľavákov však bola organizácia mozgu viac symetrická ako vo zvyšných dvoch skupinách.	In both groups of converted left-handers, however, the brain organization was more symmetrical than in the two consistent handedness groups.	0.230303
Otázkou ostáva, či je asymetria hemisfér v kôrovej organizácii motorických funkcií dôsledkom alebo príčinou preferencie jednej z rúk.	It is a matter of debate whether the hemispheric asymmetry in cortical organization of motor function is a consequence of, or a cause of hand preferences.	0.266667
Existujú dve protichodné vysvetlenia, ktoré by sa mali brať do úvahy. ~~~ Rôzna preferencia rúk môže viesť k rôznemu rozvíjaniu ľavej a pravej ruky, a teda k rôznej kortikálnej reprezentácii jednotlivých rúk.	There are two contradictory explanations that should both be considered; different hand preferences may lead to differences in the amount of left and right hand training and, consequently, to differences in the cortical representation of each hand.	-0.0305085
Dalo by sa polemizovať o tom, že práve to je hlavný rozdiel v organizácii mozgu, ktorý predstavuje príčinný faktor podmieňujúci preferenciu konkrétnej ruky.	It could also be argued that it is the primary difference in brain organization that constitutes the causal factor driving human handedness.	0.2625
Skupiny NP a ÚP participantov sa v skorom veku mohli líšiť profilom svojej preferovanej ruky.	The two groups of SU and SS subjects might have been different from an early age as to their hand preference profiles.	0.2325
Ich súčasné modely organizácie mozgu by teda mohli byť dôsledkom týchto skorých rozdielov (Harris, 1990).	Their present brain organization patterns could, therefore, be a consequence of those early differences (Harris 1990).	0.44837
Riešenie tohto nejasného problému sme sa rozhodli prenechať budúcim výskumom. ~~~ Musíme však podotknúť, že ani jedna skupina preučených participantov (dokonca ani skupina ÚP) sa nebola schopná úplne adaptovať svetu prispôsobenému pre pravákov či kompletne zmeniť preferenciu ruky.	Leaving the solution of this chicken and egg problem to future research, we want to note that neither of the two switched groups (even the SS group) was able to conform fully to environmental demands and completely change their hand preferences to full right- handedness.	-0.0105263
V dôsledku toho bolo ich HPI výrazne nižšie než v skupine rodených pravákov.	Consequently, their HPIs were significantly lower than those of the group of consistent right-handers.	0.184615
Tento rozdiel môže odrážať dôležitosť zdedených faktorov pri formovaní funkčnej architektúry mozgu, ktorý môže prechádzať zmenami a prestavbou len v obmedzenej miere.	This difference may reflect the importance of inherited factors in shaping brain architecture, which can only undergo plastic changes to a limited extent.	0.401111
K podobnému záveru dospeli autori dvoch predchádzajúcich štúdií, ktorí pomocou funkčnej magnetickej rezonancie skúmali preučených ľavákov.	Similar conclusion was drawn by the authors of two previous studies performed on converted left-handers, using functional MRI.	0.261818
Výhoda našej štúdie spočíva v testovaní účinkov preferencie ruky na modely mozgovej aktivácie, a to použitím samostatných záznamov pre ruku a hemisféru (ipsilaterálnu alebo kontralaterálnu k ruke vykonávajúcej pohyb).	The advantage of our study consists in testing the effects of handedness on brain activation pattern using separate recordings for hand and hemisphere (ipsilateral or contralateral to the moving hand).	0.37052
V predchádzajúcich fMRI štúdiách autori použili buď paradigmu, ktorá neumožňovala vykonať takéto porovnanie (Siebner et al. , 2002), alebo jednoducho ignorovali tieto faktory (Klöppel et al. , 2007). Zamerali sa na identifikáciu tých oblastí mozgu, kde preučení ľaváci preukazovali stály rozdiel BOLD signálu v úlohe týkajúcej sa podmienených mechanizmov a rúk.	In theprevious fMRi studies the authors either used the paradigm which did not allow for making such comparison (Siebner et al. 2002) or simply disregarded those factors (Klöppel et al. 2007) focusing on identification of brain regions where converted left-handers showed a consistent difference in task related BOLD signal across all movement conditions and hands.	0.761538
Takýto prístup im neumožnil sústrediť sa na mechanizmy, ktoré môžu byť odlišné v prípade ipsilaterálnych a kontralaterálnych modelov aktivácie.	Such approach did not allow them to focus on the mechanisms which, as we have shown, may differ for ipsilateral vs contralateral activation patterns.	0.297619
V oboch preučených skupinách (ÚP a NP) sme spozorovali, že práve modely ipsilaterálnych aktivácií sa podobali aktiváciám nájdeným v skupine rodených pravákov a ľavákov. To by mohlo naznačovať, že motorické zastúpenie v ipsilaterálnej hemisfére má v porovnaní s kontralaterálnou hemisférou väčšiu tendenciu k reorganizácii v dôsledku vzdelávacieho tréningu.	The observation that in the two switched (SS and SU) groups it was the patterns of ipsilateral and not contralateral activation which resembled that found in the RH and LH groups might suggest that the ipsilateral motor representation is more prone to undergo reorganization due to educational training than the contralateral one.	0.267857
Testovanie tohto tvrdenia si však vyžaduje ďalší hĺbkový výskum.	Testing this interesting possibility, however, requires more specific further investigation.	0.157895
Je všeobecne známe, že jednotlivci, či už praváci alebo ľaváci, sa značne líšia špecifickým modelom preferencie ruky.	It is widely known that individual subjects, whether they are right- or left-handed, differ considerably as to their specific pattern of handedness.	0.223529
V tejto štúdii sme sa pokúsili priamo spojiť behaviorálne rozdiely (individuálne profily preferencie ruky) s individuálnymi modelmi aktivácií v oboch hemisférach.	In this study, we attempted to directly relate behavioral differences (individual profiles of hand preference) to individual patterns of activation in the two hemispheres.	0.287413
Otázkou teda bolo, či individuálne modely organizácie motorickej kontroly v mozgu predstavujú kontinuum, ktoré priamo zodpovedá kontinuu individuálnych modelov preferencie ruky.	In other words the question was whether individual patterns of organization of motor control in the brain constitute a continuum that corresponds directly with a continuum of individual patterns of hand preferences.	0.248734
Naše údaje objavili významnú koreláciu medzi celkovou aktiváciou v ľavej hemisfére a indexom preferencie ruky (HPI), čo naznačuje, že čím väčšia je preferencia pravej ruky, tým väčšia je celková aktivácia ľavej hemisféry.	Our data revealed a significant correlation between total activation in the left hemisphere and the handedness preference index (HPI) that indicates that the stronger the right hand preference, the larger the total volume of activation in the left hemisphere.	0.342218
Podobný vzťah medzi indexom preferencie ruky a anatomickými parametrami ukázali Amunts a kol. (1996, 2000) v primárnej senzomotorickej kôre a Klöppel a iní (2010) v strede ľavého putamenu.	A similar relationship between hand preference index and the anatomical parameters has been demonstrated by Amunts and coauthors (1996, 2000) in the primary sensorimotor and by Klöppel and others (2010) in the left middle putamen.	0.752427
ZÁVER	CONCLUSIONS	0
V prípade ľavákov aj pravákov je preferovaná ruka riadená predovšetkým kontralaterálnou hemisférou, zatiaľ čo nepreferovaná ruka je riadená oboma hemisférami.	To sum up, in both left- and right-handed subjects, the preferred hand is controlled mainly by the hemisphere contralateral to that hand, whereas the nonpreferred hand is controlled by both hemispheres.	0.229286
Pokiaľ ide o motorickú kontrolu a profily preferencie ruky, preučení jednotlivci zdieľajú vlastnosti ľavákov aj pravákov.	The switched individuals share features of both left- handersand right-handers regarding their motor control architecture and hand preference profiles.	0.224299
Zvyšovanie úrovne pohybových aktivít viedlo k zvýšenému objemu stále aktivovaných oblastí a navyše k zapojeniu aj ipsilaterálnych aktivácií ku kontralaterálnym aktiváciám, a to najmä v dominantnej hemisfére.	Increasing levels of complexity of motor activity results in an increase in the volume of consistently activated areas and the involvement of the ipsilateral in addition to contralateral activations, especially in the dominant hemisphere.	0.367582
POĎAKOVANIE	ACKNOWLEDGEMENTS	0.175
Týmto by sme sa chceli poďakovať profesorovi Terrencovi Hinesovi za cenné pripomienky k prvému konceptu štúdie a tiež Barbare Sobieckej a Justyne Kozubovej za technickú pomoc.	The authors thank prof. Terrence Hines for his valuable comments on the first draft of this paper and Barbara Sobiecka and Justyna Kozub for technical assistance.	0.271739
Štúdia bola podporená grantom Poľského štátneho výboru pre vedu a výskum č. 1 H01F 056 27 a grantom Ministerstva vedy a vysokého školstva Poľskej republiky č. 2011/03/B/HS6/05161.	This study was supported by a grant no. 1 H01F056 27 from the Polish State Committee for Scientific Research and grant no. 2011/03/B/HS6/05161 from the Polish Ministry of Science and Higher Education.	0.59026
Kto bola Juliana z Norwichu?	Who was Julian of Norwich?	0.273913
Aby sme pochopili osobnosť a odkaz tejto mimoriadnej stredovekej anglickej mystičky žijúcej v druhej polovici štrnásteho a na začiatku pätnásteho storočia, musíme sa stručne pozrieť aj na historické obdobie, v ktorom pôsobila.	In order to understand the figure and the message of this extraordinary English medieval mystic of the late fourteenth and early fifteenth century we have to glimpse briefly the historical background in which she lived.	0.283871
V štrnástom storočí žilo mnoho významných mystikov či svätcov, napríklad Angela z Foligna, Getrúda Veľká, Kristína zo Stommelnu, Ramon Lull, Margita Ebnerová, Henrich Suso, Lidwina zo Schiedamu, Katarína Sienská či Brigita Švédska, ktorí sa usilovali o cirkevnú a pápežskú reformu.	The fourteenth century was a period of many great mystics and saints, like Angela of Foligno, Gertrude the Great, Christina of Stommeln, Raymond Lull, Margaret Ebner, Henry Suso, Lidwina of Schiedam, also Catherine of Sienna and Bridget of Sweden who struggled for the Reform of the Church and the Papacy.	0.64857
Boli to veľmi ťažké časy.	At the same time it was an unusually tumultuous age.	0
Epidémia čiernej smrti, veľká schizma a Storočná vojna medzi francúzskym a anglickým kráľom spôsobili, že toto obdobie považujeme za jedno z najtemnejších v histórii Cirkvi.	The plague of the Black Death, the Great Schism and the Hundred Years’ War between the kings of France and England made of this period one of the darkest moments of the world and Church history.	0.28
Utrpenie a zmätok poznačili nielen európsky kontinent, ale hlboko zasiahli aj Anglicko.	This general situation of suffering and confusion was present not only on the continent, but was deeply felt in England as well.	0.179221
V roku 1348 sa prvá vlna čiernej smrti rozšírila z kontinentu do Británie.	The first wave of the Black Death came to Britain from the continent in 1348 when Julian was about six years old.	2.51429
V tom čase mala Juliana asi šesť rokov. ~~~ Dve ďalšie udreli v rokoch 1361 a 1369.	Two further onslaughts followed in 1361 and 1369 when she was nineteen and twenty-six years old.	-0.0335821
Vtedy mala devätnásť a dvadsaťšesť rokov. ~~~ Takmer každý, kto prišiel do styku s chorými, sa nakazil a zomrel.	The disease was so violent and contagious that nearly anyone who touched the sick became infected and died.	-0.00494505
Kronikár tohto obdobia uvádza, že kňazov starajúcich sa o umierajúcich pochovávali do hrobu spolu s ich kajúcnikmi.	A chronicler of that period reports that the priests who ministered to the dying, were put into the same grave with their penitents.	0.267
Odhaduje sa, že choroba vyhubila takmer tretinu populácie.	It is estimated that more than a third of the population perished.	0.276923
Mnohí považovali epidémiu za eschatologické znamenie Božieho trestu.	There were many who considered the plague an eschatological sign of divine retribution.	0.232258
Historicky najdlhšia vojna trvajúca od roku 1337 do 1453 iba upevňovala dojem, že apokalypsa je za dverami.	The impression that apocalyptic times were at the doors was strengthened by the longest conflict in the history of warfare, lasting from 1337 to 1453.	0.352536
Bol to spor o francúzsky trón medzi kráľovskou dynastiou Valoisovcov a dynastiou Anjouovcov z Anglicka, ktorá si nárokovala súčasne na anglický aj francúzsky trón, pretože pochádzala z francúzskych grófstiev Anjou a Normandia.	It was a conflict for the French throne between the royal house of Valois who claimed the title of King of France, and the house of Anjou from England, who claimed to be both Kings of England and of France, since they had their roots in the French regions of Anjou and Normandy.	0.525278
V prvej fáze vojny sa Angličanom darilo viac. Keď sa však do boja zapojila Jana z Arku a princa Karola VII. korunovali v Reims za francúzskeho kráľa, stratili takmer všetko z toho, čo predtým získali.	The English invasion was initially very successful in gaining new territories and much plunder, but after the involvement of St. Joan of Orleans in the battle and the solemn crowning of Charles VII as king of France at Reims, they lost eventually much of what had been gained.	0.186826
Aj keď sa boj odohrával zväčša na kontinente, nekončiace utrpenie uvrhlo obe krajiny do hlbokej hospodárskej krízy a chudoby.	And though the war was fought mostly on the continent, the continuous suffering and the casualties flung both countries into deeper depression and privation.	0.225
CHYBA TEXT Moravcová)	1 Cf. C. Creighton, A History of Epidemics in Britain, vol. 1, New York 1965 2 , 121.	-0.435
Situácia v Anglicku sa zhoršila ešte viac po povstaní roľníkov proti šľachte, mešťanom a duchovenstvu.	The situation in England was further aggravated by the peasants’ rebellion against the lords, secular and ecclesiastical.	0.242697
Roľníci sa valili krajinou a rabovali zámky, kostoly a kláštory.	The peasants rampaged across the country pillaging castles, churches and monasteries.	0.192857
Povstanie však bolo nakoniec kruto potlačené.	When the revolt and plundering were finally stopped, it ended in cruel reprisals.	0.0878049
Jedného z vodcov, Geoffreyho Litstera, nechal norwichský biskup Henry Despenser obesiť neďaleko Julianinej cely.	One of its leaders, Geoffrey Litster was sentenced to death by the bishop of Norwich, Henry Despenser, at the gallows not far from Julian’s cell.	0.434
Veľká schizma trvajúca od roku 1378 do 1415 takisto priniesla jednu z najväčších kríz Cirkvi i stredovekej spoločnosti.	Finally, the Great Schism of 1378-1415 brought one of the greatest spiritual crisis for the Church and medieval society.	0.3
Spor o pravého pápeža medzi uchádzačom z Ríma a Avignonu otriasol jej základmi.	The quarrel for the true pope between the claimants of Rome and Avignon shook the Church in its very foundations.	0.180882
Urban VI., rímsky žiadateľ, zašiel v boji proti svojmu protivníkovi Klementovi až tak ďaleko, že zorganizoval vojenské ťaženie.	Urban VI, the roman claimant to the papacy, went so far in his opposition to his rival, Clement, as to organize a crusade against him.	0.457895
Vedenie zveril do rúk biskupa Despensera. ~~~ Ten sľúbil odpustky všetkým, ktorí túto záležitosť podporili vojensky alebo finančne.	He entrusted the leadership and responsibility to bishop Despenser who promised indulgences to those who would support the cause in a military or financial way.	-0.0302632
Všetko sa však skončilo katastrofou.	Naturally, it ended in disaster.	0.258621
Niektorých vojakov zabili, iných zajali a zvyšných, vrátane biskupa, s potupou poslali domov.	Some of the crusaders were killed, some were captured, and the rest, including the bishop, returned home in disgrace.	0.234146
Zlyhanie pápežstva, korupcia cirkevných hodnostárov, zneužívanie odpustkov či samotná výprava vzbudili všeobecnú nedôveru k Cirkvi nielen medzi veriacimi na kontinente, ale aj v Anglicku a pripravili pôdu pre hlásateľov reformácie.	The failure of the papacy, the corruption of the ecclesial hierarchy, the abuse of indulgences and the crusade itself provoked general distrust in the visible institution of the Church among the faithful on the continent as well as in England, and prepared the ground for the precursors of the Reformation.	0.218719
V štrnástom storočí hlásal Ján Viklef cirkevnú reformu v Anglicku.	The XIV century England saw John Wyclif preaching a reform of the Church.	0.27931
Odsudzoval zneužívanie odpustkov, cirkevných hodnostárov kritizoval za honbu po moci a bohatstve a usiloval sa o návrat cirkvi k prvotnej jednoduchosti ohlasovania evanjelia.	He attacked the misuse of indulgences, criticized the ecclesiastical hierarchy for seeking power and wealth, and desired that the Church return to the primitive simplicity of the Gospel.	0.286275
Snažil sa o preklad Biblie do angličtiny, aby jej rozumeli aj obyčajní ľudia.	Besides, he supported the translations of the Bible into the English vernacular so that common people could understand it.	0.122727
V roku 1396, ani nie desať rokov po Viklefovej smrti, vydal pápež Bonifác IX. bulu proti jeho nasledovateľom, tzv. lolardom.	Scarcely a decade after Wyclif’s death a bull was issued by Boniface IX, 1396, against Wyclif’s followers, called the Lollards.	0.434367
V Anglicku ich kruto prenasledovali, vyvrcholenie nastalo v rokoch 1407 – 1408. Vtedy arcibiskup z Canterbury a kancelár Anglicka Thomas Arundel vydal články, v ktorých ich označil za zradcov a kacírov.	In England they started to be fiercely persecuted and this culminated in the Constitutions (1407-1408) of the Archbishop of Canterbury and Chancellor of England, Thomas Arundel, who labelled them as traitors and heretics.	0.45802
Tie však bohužiaľ zakazovali kazateľom používať anglický preklad Biblie či iných teologických diel, pretože v nich videli spojenie s Viklefovým kacírstvom.	Unfortunately, this Constitution prohibited also the use of the Bible and theological writings in English by lay people, seeing in it an association with the heresy of Wyclif.	0.271324
Viklefovi odporcovia podporovaní bojachtivým biskupom Despenserom sa usadili aj v Norwichi. ~~~ Ten sa zaprisahal, že popraví ohňom či sťatím všetkých, ktorí sa pokúsia kázať v jeho diecéze.	The anti-Wycliffite persecutions took place also in Norwich, supported by the warlike bishop Despenser who swore to put to death by flame or by decapitation any of the dissenters who might presume to preach in his diocese.	-0.0220859
Juliana možno bola tichým svedkom ich popravy na mieste zvanom Lollard Pit.	Julian might have been a silent witness of their execution at a place known as the Lollard Pit.	0.696923
Mesto Norwich vybudované na rieke Wensum v grófstve Norfolk blízko pobrežia Východného Anglicka bolo za Julianiných čias významným prístavným mestom a druhým najväčším mestom v Anglicku. Malo približne 10 000 obyvateľov.	The city of Norwich, built around the River Wensum and located in the county of Norfolk near the coast of East Anglia, was an important port and England’s second largest city boasting 10, 000-12, 000 inhabitants in Julian’s time.	0.579679
Obchod a náboženský život v meste prekvitali, čo priťahovalo množstvo cirkevných rádov a hnutí vrátane lolardov, ktorí sa tu usadili.	It was a flourishing centre of trade and religious life, attracting a number of religious orders and movements, including Lollards, who set up their houses there.	0.525714
Tento anglický Rím, ako zvykli v stredoveku Norwich nazývať, sa pýšil 57 kostolmi. Tridsaťjeden z nich stojí dodnes.	This Rome of England, as Norwich used to be called in the medieval times, had 57 churches inside the city wall, of which 31 still exist today.	0.564789
Platilo tu heslo: Kostol na každý týždeň, krčma na každý deň.	It confirms a popular saying that the city had: A church for every week and a pub for every day.	0.15
V tých časoch obdaroval Boh Julianu neobyčajnými zjaveniami Jeho lásky k ľuďom.	It is in this historical context that Julian of Norwich receives extraordinary visions on God’s love towards all people.	0.152174
Uprostred všetkých pohrôm zúriacich naokolo musela mať jej Kniha zjavení, či Zjavenia ako ju sama zvykla nazývať, silný kultúrny a revolučný vplyv.	Amidst all the calamities raging around, her book of revelations, or Showings, as she herself often calls them, must have had a counter-cultural and revolutionary impact.	0.385553
S detskou jednoduchosťou a neochvejnou nádejou nám zvestovala, že Boh nás miluje a urobí i nemožné, aby sa všetko obrátilo na dobré.	With childlike simplicity and unwavering hope she comes to tell us that despite all evils God loves us and will make all things well again.	0.289286
Vďaka tomu úspešne vyvrátila presvedčenie tých čias, že všetky katastrofy a vojny pochádzajú od Boha, ktorého nahnevali naše hriechy, a tak posiela na svet svoj trest.	In this way she succeeds in undermining the wide-spread belief of the time, namely, that disasters and wars come from God who, enraged by our sins, sends chastisements upon the world.	0.276923
Julianine vízie stáli v úplnom protiklade s teológiou Božieho hnevu, pripomínajúc nám základnú pravdu biblického zjavenia: Boh je láska (1 Jn 4, 16).	Julian’s visions stand in complete opposition to this theology of God’s anger, reminding us of the basic truth of the biblical Revelation: God is love (1 Jn 4, 16).	0.778906
Niet pochýb, že Juliana patrí k tradičnej mystickej teológii, ktorá začína svätým Dionýzom Areopagitom a končí neznámym autorom knihy Oblak nepoznania.	There is no doubt that Julian can be inserted into the long tradition of mystical theology that goes from St. Dionysius the Areopagite up to the unknown author of The Cloud of Unknowing.	0.247727
Často ju porovnávajú s významnými stredovekými mystikmi, najmä Brigitou Švédskou. ~~~ Tá tiež napísala knihu s názvom Zjavenia.	She is often compared to great medieval mystics, and in particular to St. Bridget of Sweden, the author of her own Revelations.	-0.00420561
Zarážajúcu podobnosť nájdeme aj medzi Julianinou knihou Zjavenia a knihou Vnútorný hrad od sv. Terézie z Avily: obe prirovnávajú ľudskú dušu k pevnosti či hradu, v ktorom prebýva samotný Boh.	There are also striking similarities between Julian’s Showings and the Interior Castle of St. Theresa of Avila: both of them speak of the human soul as a citadel or a castle in the centre of which God himself dwells.	0.367326
Toto je dôvod, prečo môžeme Julianu považovať za jednu z najväčších pilierov západného mysticizmu.	That is the reason why Julian can be regarded as one of the great pillars of western mysticism.	0.273418
Thomas Merton považuje Julianu a Johna Henryho Newmana, blahorečených Benediktom XVI. dňa 19. septembra 2010, za najväčších anglických teológov.	Thomas Merton considers Julian and John Henry Newman, beatified by Benedict XVI on 19 September 2010, the greatest English theologians.	0.724359
Juliana sama o sebe tvrdila, že nemá vzdelanie. Merton v nej však aj napriek tomu vidí pravú teologičku, pretože to, čo videla, nepodávala iba jednoduchým spôsobom, ale obsah svojich vízií rozpracovala aj teologicky.	Though Julian considers herself unlearned, Merton sees in her a true theologian, since she does not simply transmit what she experienced, but elaborates theologically the content of her visions.	0.367665
Vďaka knihe Zjavenie Božej lásky, kde nám odhaľuje Božie zmilovanie a zľutovanie so svetom, pokladáme Julianu za predchodkyňu sv. Faustíny Kowalskej, známej zvestovateľky Božieho milosrdenstva v 20. storočí.	Finally, with her Showings of Love, as far as it unveils God’s motherly operation of mercy and compassion for the world, Julian can be seen as a fourteenth century precursor of St. Faustina Kowalska, the great harbinger of the Divine Mercy in the XX century.	0.347095
Hoci žila Juliana skrytý samotársky život, jej cela v Norwichi sa stala zdrojom duchovnej osvety a útechy v ťažkých časoch nielen pre ňu, ale aj pre nás.	Though Julian lived the hidden life of a recluse, her cell in Norwich has become a source of spiritual enlightenment and comfort for our tormented times as well as for hers.	0.369643
Dnes ju považujeme za jednu z najvýznamnejších osobností západného špiritualizmu. ~~~ Jej diela majú všeobecnú a trvalú hodnotu.	Today she is considered one of the giants of western spirituality whose writings possess universal and permanent value.	-0.0116505
Stala sa skutočnou duchovnou matkou Anglicka, tak ako ju nazval aj benediktínsky otec Severus Cressy, prvý vydavateľ jej knihy Zjavenia.	She is truly the spiritual Mother of England, as the first editor of her Showings, the Benedictine Father Serenus Cressy, called her.	0.429583
CHYBA TEXT otvorene uznáva Julianu spoločne so sv. Katarínou Sienskou a sv. Thomasom Morom za svätcov, ktorí boli svedkami pravdy: Tým, čo milujú Boha, všetko slúži na dobré (Rim 8, 28) a cituje nasledujúcu pasáž z jej knihy Zjavenia: Z milosti Božej som sa naučila, že musím vytrvať vo viere a nie menej pevne veriť, že všetko sa na dobré obráti A uvidíš, že všetko bude dobré (DV 233).	Despite the fact that Julian has not been officially canonised by the Catholic Church – the Anglican Church venerates her as blessed on May 8 –, the new Catechism of the Catholic Church explicitly acknowledges her holiness as it presents her, along with St. Catherine of Siena and St. Thomas More, as those saints who witness to the truth that God works with those who love him and turns everything to their good (Rm 8, 28) and quotes the following passage from her Showings: And in this way I was taught by the grace of God that I ought to keep myself steadfastly in the faith and that I should stand firm and believe firmly that every kind of thing will be well… You will see yourself that every kind of thing will be well (LT 233).	0.167009
Najväčšie uznanie katolíckej cirkvi vzdal matke Juliane Svätý otec Benedikt XVI.	The greatest acknowledgment, though, on the part of the Catholic Church was granted to Mother Julian by the present Holy Father, Benedict XVI.	0.338732
Pápež rozprával o tejto anglickej mystičke na audiencii v stredu 1. decembra 2010 v Aule Pavla VI.	Continuing with his series on great women of the Church, the Pontiff gave a catechesis on the figure of this English mystic in his Wednesday audience on December 1, 2010, held in the Paul VI Hall.	0.0144578
Poukázal predovšetkým na jej poslanie duchovnej matky pre všetkých, ktorí žiadali o radu či na nesmierny optimizmus vyžarujúci z jej odkazu o nežnosti materinskej Božej lásky.	He pointed out, above all, her vocation as a spiritual mother to the many people who sought her counsel, and the immeasurable optimism that irradiates from her message on the tender and motherly love of God.	0.256291
Poznáme dve verzie knihy zjavení sv. Juliany, známe ako Kratšie vydanie a Dlhšie vydanie.	St. Julian made an account of her Revelations in two writings, known as the Short Text and the Long Text.	0.261039
Odteraz budeme Dlhšie vydanie označovať ako DV a kratšie ako KV.	Henceforth, the Long Text will be referred to throughout the book as LT, and the Short Text as ST.	0.158182
Citácie budeme čerpať z modernej verzie Julianiných zjavení, založenej na kritickom texte E. Colledge – J. Walsh, Julian of Norwich.	Throughout the text the quotations will be taken from the modern version of Julian’s Revelations, based on the critical text, by E. Colledge – J. Walsh, Julian of Norwich.	1.36391
Niekoľko ľudí jej ako pustovníčke v Kostole sv. Juliána v Norwichi odkázalo vo svojich testamentoch peniaze na živobytie.	There are some bequests in wills that were probably made to her to support her living as an anchoress at St. Julian’s Church in Norwich.	0.277143
V jednom z nich, z marca 1393, farár Kostola sv. Michala Coslanyho v Norwichi Roger Reed odkázal Juliane pustovníčke dva šilingy.	In one of these, dated March 1393, it is said that the rector of St. Michael’s Church at Coslany in Norwich, Roger Reed, left two shillings to Julian anakorite.	0.51
V závete z roku 1415 zanechal John Plumpton, občan z Norwichu, 40 pencí ankress in ecclesia santi Juliani de Conesford in Norwice (anachoréte v Kostole svätého Juliána z Conesforde v Norwichi) a po 12 pencí pre jej vtedajšiu slúžku a bývalú slúžku Alice.	In the will of 1415 it is said that John Plumpton, a citizen of Norwich, left forty pence to the ankress in ecclesia santi Juliani de Conesford in Norwice and twelve pence each to her serving maid and to her former maid Alice.	1.20914
O rok neskôr, v roku 1416, odkázala grófka zo Suffolku Izabela Uffordová Juliane dvadsať šilingov.	A year later, in 1416, the Countess of Suffolk, Isabel Ufford, left a bequest of twenty shillings to Julian.	0.466324
Posledný závet bol spísaný v roku 1429 a potvrdený v 1432 Robertom Baxterom, občanom a obchodníkom z Norwichu.	Finally, the last bequest was made in 1429 and confirmed in 1432 by Robert Baxter, a citizen and merchant of Norwich, who left three shillings and four pence to the anchorite at St. Julian’s church in Conisford 5 .	0.508791
Ten zanechal 3 šilingy a 4 pence pustovníčke pri Kostole sv. Juliána z Conesforde 5 .	The evidence of these wills clearly demonstrates that Julian must have been a highly esteemed personality in her town.	0.34971
Tieto závety jasne dokazujú, že Julianu si v meste vysoko vážili. ~~~ Francis Blomfied, norfolský starožitník píše, že v 18. storočí už Julianino útočisko neexistovalo.	Francis Blomfield, the Norfolk antiquarian, leaves us a report that in the 18th century Julian’s anchorhold did not exist anymore, but was razed to the ground during the dissolution of monasteries.	-0.025
Počas rušenia kláštorov ho zrovnali so zemou. ~~~ Vo svojej knihe Dejiny Norwichu nám však podáva vzácne informácie o samotnej pustovníčke: Vo východnej časti cintorína (pri kostole) stála pustovňa, v ktorej pustovníčka prebývala až do jej zničenia. I keď dom zničili, jeho základy zostali.	Besides, in his History of Norwich, he gives us some precious information about the anchoress herself: In the east part of this Church-yard stood an Anchorage, in which an Ankress or Recluse dwelt ’til the Dissolution, when the house was demolished, tho’ the Foundations may still be seen.	-0.00246914
Lady Juliana Pustovníčka žila v roku 1393 v úplnej samote. ~~~ Mala len dve slúžky, ktoré ju v starobe opatrovali, a to až do roku 1443.	In 1393, Lady Julian the Ankress here, was a strict Recluse, and had 2 servants to attend her in her old age, A o 1443.	0.19125
V tých časoch ju uznávali za jednu z najväčších svätíc.	This woman in those Days was esteemed one of the Greatest Holynesse.	0.229787
Rok 1443, ktorý uvádza Blomfield, sa nám však môže zdať prekvapujúcim.	The date of 1443, furnished by Blomfield, seems surprising.	0.848077
Naznačuje, že Juliana narodená v roku 1342 žila viac ako 100 rokov.	It would imply that Julian who was born in 1342 lived for more than a hundred years.	0.467611
Julianini učenci zväčša nepovažujú túto informáciu za dôveryhodnú. ~~~ Tvrdia, že si ju pomýlil s inou pustovníčkou, ktorá žila na tom istom mieste po tom, čo Juliana zomrela a tiež prebrala meno po patrónovi kostola, sv. Juliánovi.	Julian scholars usually discard this information as not very trustworthy, and explain that he confused our Julian with another recluse that lived here after Julian had died and who took the same name after the patron saint of the Church, St. Julian.	-0.00994898
Blomfieldove informácie však nemôžeme s istotou označiť za nepravdivé.	Yet, Blomfield’s information is not thoroughly impossible.	0.243396
Neexistuje spoľahlivý dôkaz popierajúci Julianin vysoký vek a v Blomfieldovom texte sa nenašli žiadne iné nejasnosti signalizujúce, že si Julianu považovanú za svätú osobu pomýlil s inou pustovníčkou, ktorá nasledovala jej život.	First of all, we do not have any solid contrary proofs against Julian’s old age and, secondly, Blomfield’s text does not exhibit any confusion of Julian, who was considered a person of great holiness, with another recluse who may have followed her way of life.	0.363773
Existuje aj iné svedectvo o Julianinej historickej osobe podané jej súčasníčkou Margery Kempe z King's Lynn.	There is another important witness to Julian’s historicity, given by her contemporary, Margery Kempe of King’s Lynn.	0.807071
Tiež bola mystičkou, ale s úplne inou povahou.	She was also a mystic, but of a totally different cast of mind.	0.21
Na rozdiel do Juliany, ktorá chcela zostať v skrytosti a zabudnutí, Margery bola egocentrickou ženou vždy pripravenou chváliť samu seba a príliš zaujatou mimoriadnymi prejavmi mystického života.	Unlike Julian, who wanted to remain hidden and forgotten, Margery was a self- centred woman, always ready to extol her own personality, and too much preoccupied with extraordinary manifestations of the mystical life.	0.485883
Vo svojej autobiografii rozpráva o tom, ako v roku 1412 alebo 1413 vyhľadala Julianu v jej cele a žiadala o radu, lebo sa šírili chýry, že je výbornou duchovnou vodkyňou.	She tells us in her autobiography that she sought Julian out for advice in her cell, in about 1412 or 1413, since she was enjoying the fame of a well-known expert in spiritual guidance and discernment.	0.440731
Margery síce vôbec nespomína Julianinu knihu Zjavenia, ale rozhovor z nej nápadne pripomína Julianinu teológiu lásky.	Margery makes no mention of Julian’s book of Showings, yet the conversation that she recorded in her book reflects strikingly Julian’s theology of love.	0.39783
Obchod s vypchatými zvieratami v Texase vystavuje čerstvú žirafiu trofej.	A Texas taxidermy shop displays a fresh giraffe trophy.	0.19375
Kartónové krúžky a špendlíky fixujú žirafiu kožu, až kým vyschne, koža je pripevnená na polystyrénovú formu v tvare žirafej hlavy.	Cardboard strips and pins hold the skin in place while it dries on a giraffe-shaped styrofoam form.	0.366667
Počet žiráf sa za 30 rokov znížil o 40 %, vo voľnej prírode žije už len okolo 110 000 jedincov.	Giraffe numbers have dropped by 40 percent in 30 years, to about 110, 000 in the wild.	0.774648
Veterinárny lekár pre voľne žijúce zvieratá, Pete Morkel, odchytil počas svojej kariéry množstvo veľkých afrických cicavcov, akými sú napr. levy, lesné slony a biele nosorožce. Spomedzi všetkých týchto zvierat patria žirafy medzi najviac vystresovaný druh.	Of all the large African mammals that wildlife veterinarian Pete Morkel has had to capture over his career—lions, forest elephants, white rhinos—giraffes are the most stressful.	0.273856
Pokiaľ ide o iné zvieratá, na ich znehybnenie stačí malé množstvo anestetika, no žirafy musíme absolútne predávkovať a tým ich úplne odrovnať, vysvetľuje mi starší 59-ročný opálený chlapík, kým pozoruje dvojročnú žirafu pri Nigerskom pralese, ktorý sa nachádza 100 kilometrov východne od hlavného mesta Nigérie, Niamey.	With other animals, you’re trying to give just enough anesthetic to immobilize them, but with a giraffe, we use a total overdose to chemically knock them off their feet, the sun-leathered 59-year-old tells me as I stalk him stalking a two- year-old female giraffe somewhere in the Nigerien bush, about 60 miles east of Niamey, Niger’s capital.	0.349648
Na hlave má maskáčový klobúk a roztrhané fialové boxerky s károvaným vzorom, ktoré nosil namiesto šortiek už niekoľko dní.	He is wearing a camo hat and a pair of torn, purple- checkered boxers that he’s been wearing as shorts for the past several days.	0.447143
Morkel práve nabil svoju uspávaciu pištoľ dávkou etorfínu, čo je opiát, približne 6 000 krát silnejší ako morfium.	Morkel has loaded his dart gun with a dose of etorphine, an opioid about 6, 000 times more powerful than morphine.	0.606316
Hneď ako etorfín prenikne pod kožu žirafy, čas hrá proti nim. ~~~ Za tento krátky čas musia zviera dolapiť, chytiť ho a následne mu do krku vstreknúť protilátku, aby nezahynulo.	Once it penetrates the giraffe’s skin, he and his team will have just minutes to chase down the animal, tackle her, and inject her neck with an antidote to keep her from dying.	-0.00310345
Ak žirafu úspešne odchytia a prežije viac ako 800 kilometrový transport cez Nigériu, stane sa jedným zo zakladateľov novej populácie najvzácnejších divokých cicavcov na svete.	If she can be successfully captured and survive a 500-mile translocation across Niger, she’ll become one of eight founding Adams and Eves of a new population of one of the world’s rarest wild mammals.	0.383806
Osirotená žirafa v Sarara Camp v severnej Keni sa túli k svojmu opatrovateľovi.	An orphaned giraffe nuzzles a caregiver at Sarara Camp in northern Kenya.	0.737729
Keď pastieri hovädzieho dobytka z kmeňa Samburu našli opustené teliatko, upozornili naň Sararu, ktorá sa stará o osirelé cicavce a vracia ich naspäť do ich prirodzeného prostredia.	Samburu cattle herders found the abandoned calf and alerted Sarara—known for raising orphaned stmammals and returning them to their habitat.	0.36171
Mladá žirafa teraz žije s divokým stádom.	The young giraffe now lives with a wild herd.	0.283333
Žirafy, ktoré sme týždeň pozorovali, sú potomkami približne 50 zvierat, ktoré sa koncom osemdesiatych rokov dostali do Nigérie, krajiny na západe Afriky. Z ich domova ich vyhnala vojna a sucho v susediacom štáte Mali na západe krajiny.	The giraffes we have chased for a week are the descendants of some 50 animals that made their way to the West African country of Niger in the late 1980s, when drought and war pushed them from their habitat in neighboring Mali.	1.22479
Prešli juhovýchodným smerom cez pásmo stepí a saván zvaných Sahel, pozdĺž rieky Niger. ~~~ Niamey obkľúčili ešte predtým, ako sa usadili v oblasti Koure, na suchej a prašnej plošine.	They walked south-southeast across the Sahel, along the Niger River, and skirted Niamey before settling in the Koure region, on a dry and dusty plateau.	0.15843
Amadou Hama je 76-ročný pastier z národa Fulani. ~~~ V spomienkach sa vracia o 10 rokov späť, keď pri opatrovaní svojho dobytka prvýkrát uvidel žirafu.	A Fulani herder named Amadou Hama, 76, recalled what it was like decades ago when he first encountered one of these giraffes one evening while tending his cattle.	-0.0106299
Keď sme ju prvýkrát uvideli, mysleli sme si, že je to diabol ‒ pre jej dlhánsky krk a rohy.	We thought it was the devil, because of that neck and those horns.	0.196364
Ľudia mi rozprávali o rôznych nebezpečných zvieratách akými sú napr. levy, ale nikto mi nikdy nespomenul žirafy.	People had told me about dangerous animals like lions, but nobody had ever told me about the giraffe.	0.257647
Tieto nevídané obry sú poslednými, ktoré prežili z kedysi obrovskej populácie bielych žiráf. Na prelome minulého storočia bola ich teritóriom celá západná Afrika, od pobrežia Senegalu až po Nigériu.	These newly arrived giants were the last survivors of a once vast population of white giraffes whose range at the turn of the last century spanned all of West Africa, from the coast of Senegal to Nigeria.	0.29645
Zachytené nad obzorom hlavného mesta Nairobi. ~~~ Žirafy sa potulujú národným parkom Nairobi, 6 kilometrov od centra rozľahlého hlavného mesta Keňa.	Framed against the Nairobi skyline, giraffes roam Nairobi National Park, four miles from the center of Kenya’s sprawling capital.	-0.0214286
V parku s rozlohou 45 kilometrov štvorcových žije viac ako 100 druhov cicavcov, avšak rozmach Nairobi toto prostredie ohrozuje.	More than 100 mammal species live in the 45-square-mile park, but Nairobi’s expansion threatens this habitat.	0.429102
V roku 2016 tím vedcov nadobudol o žirafách nové poznatky.	In 2016 a team of scientists came to an epiphany (if still contentious) about giraffes.	3.156
Dovtedy zastávali názor, že všetky žirafy patria do jedného druhu Giraffa camelopardalis.	Until then, the conventional view held that all giraffes belonged to a single species, Giraffa camelopardalis.	0.696981
Na základe genetickej analýzy sa však zdá, že existujú až štyri druhy žiráf, ktoré sa od seba odlišujú, a to viac ako hnedý medveď od polárneho.	But genetic analysis now suggests that giraffes are in fact four distinct species, actually more different from each other than the brown bear is from the polar bear.	0.25
Tieto štyri druhy žiráf sa klasifikujú do ďalších piatich poddruhov, ktoré zahrňujú aj vzácny západoafrický druh Giraffa camelopardalis peralta. ~~~ Týchto bledých, fľakatých utečencov možno nájsť len v Nigérii, v oblasti Koure.	And those four species can be further classified into five subspecies, including the rare West African Giraffa camelopardalis peralta, the pale, spotted refugees now found only in the Koure region of Niger.	0.092126
Nová klasifikácia by znamenala, že všetky druhy - až na dva poddruhy - považujeme za zraniteľné, ohrozené alebo kriticky ohrozené. V celej Afrike sa počet žiráf za posledné tri desaťročia znížil takmer o 40 %, dnes je na svete odhadom len 110 000 žiráf.	Based on this new taxonomy, all but two subspecies would be considered vulnerable, endangered, or critically endangered, and across Africa, populations have declined by almost 40 percent over the past three decades, leaving an estimated 110, 000 giraffes in the world.	0.488693
Asistent riaditeľa nadácie pre zachovanie žiráf, Julian Fennessy, označil túto skutočnosť za tiché vymieranie. ~~~ Kvôli veľkej pozornosti upriamenej na vymieranie slonov a veľkých opíc si väčšina ľudí myslí, že žirafám sa vo voľnej prírode darí celkom dobre. Možno je to práve pre nadmerný počet žiráf v zoologických záhradách alebo pre vysoký počet vypchatých žiráf.	Julian Fennessy, co-director of the Giraffe Conservation Foundation (GCF), calls this the silent extinction, because unlike the attention lavished on the disappearance of elephants and great apes, most people assume that giraffes are doing just fine in the wild, perhaps because of their abundance in zoos and as stuffed animals.	-0.0176157
ŽIRAFY V OHROZENÍ	GIRAFFES IN DANGER	0.28125
Z milióna žiráf, ktoré žili okolo roku 1700, sa dnes po Afrike potuluje už len 110 000.	Some 110, 000 giraffes roam throughout Africa, down from a million in the 1700s.	0.282353
Nový výskum v oblasti DNA vyvrátil to, čomu vedci dlhé roky verili.	Scientists had long believed that all giraffes belonged to a single species, but new DNA research has identified four distinct species.	0.220243
Boli presvedčení, že existuje len jeden druh, do ktorého patria všetky žirafy na svete.	Top threats to giraffes include habitat fragmentation, deforestation, war, and poaching.	0.284
Výskum však identifikoval až štyri odlišné druhy.		-0.3
Pre žirafy predstavuje najväčšiu hrozbu fragmentácia biotopu, odlesňovanie, vojna a v neposlednom rade pytliactvo.		-0.3
ŽIRAFA SEVERNÁ NÚBIJSKÁ (Giraffa camelopardalis) – najviac ohrozené poddruhy severných žiráf sú Korfodan a Nubian.	The Kordofan and Nubian, subspecies of northern giraffes, are most threatened, living mainly in war-torn countries.	0.3
Je to primárne preto, že žijú v krajinách zničených vojnou.	Northern giraffes lack spots on the lower legs.	0.226829
Severné žirafy sú charakteristické tým, že na dolných končatinách nemajú škvrny.	Reticulated giraffes get their name from their clearly defined patches.	0.261905
ŽIRAFA SIEŤOVANÁ (Giraffa reticulata) – žirafy sieťované dostali svoje meno podľa presne definovaných škvŕn.	There is some evidence that their numbers— although low—are stabilizing in Kenya.	0.194366
Dôkazy potvrdzujú, že ich nízky počet sa v Keni pomerne stabilizuje.	Of the four main species, Masai giraffes have the darkest complexion.	0.294915
ŽIRAFA MASAJSKÁ (Giraffa tippelskirchi) – zo všetkých štyroch druhov má žirafa masajská najtmavšiu kožu.		-0.3
Tento druh žiráf bol pred 30 rokmi najpopulárnejší, no odvtedy sa ich počet zredukoval na polovicu.	Thirty years ago this species was the most populous, but it’s since been reduced by half.	0.26
ŽIRAFA JUHOAFRICKÁ (Giraffa giraffa) – žirafa juhoafrická je zo všetkých druhov najmenej ohrozená.	The southern giraffe is at the least risk.	-0.125
